date,buy_orders,buy_volume,average_buy_order_volume,sell_orders,sell_volume,average_sell_order_volume,net_volume,ticker
2024-09-12,1256,3206900,2553.26,1142,5063200,4434,-1856300,aaa
2024-09-11,2209,5318800,2407.79,1038,6579900,6339,-1261100,aaa
2024-09-10,1714,5607800,3271.76,1186,7907800,6668,-2300000,aaa
2024-09-09,2709,7849400,2897.53,1255,7610300,6064,239100,aaa
2024-09-06,4089,12094900,2957.91,1697,13173800,7763,-1078900,aaa
2024-09-05,1748,8843400,5059.15,1925,10629500,5522,-1786100,aaa
2024-09-04,2207,11305400,5122.52,1444,9167600,6349,2137800,aaa
2024-08-30,1890,8463700,4478.15,1383,7464000,5397,999700,aaa
2024-08-29,2123,6872800,3237.31,1330,8884200,6680,-2011400,aaa
2024-08-28,2416,10380000,4296.36,1707,9463200,5544,916800,aaa
2024-08-27,2737,12763600,4663.35,1687,8154000,4833,4609600,aaa
2024-08-26,6083,24887600,4091.34,2138,20565700,9619,4321900,aaa
2024-08-23,7185,30972400,4310.7,2469,25128100,10177,5844300,aaa
2024-08-22,2581,13052700,5057.23,1422,13959500,9817,-906800,aaa
2024-08-21,2457,11962400,4868.7,1526,11518600,7548,443800,aaa
2024-08-20,2367,14413000,6089.14,2405,14209100,5908,203900,aaa
2024-08-19,1614,11295800,6998.64,2050,14606400,7125,-3310600,aaa
2024-08-16,2308,14970100,6486.18,2392,11631700,4863,3338400,aaa
2024-08-15,2678,11371600,4246.3,1397,9799100,7014,1572500,aaa
2024-08-14,1519,7231000,4760.37,1603,10366300,6467,-3135300,aaa
2024-08-13,1607,9138500,5686.68,1861,11842900,6364,-2704400,aaa
2024-08-12,2620,12671000,4836.26,1259,13366400,10617,-695400,aaa
2024-08-08,5190,22104700,4259.09,1494,22496600,15058,-391900,aaa
2024-08-07,3344,23031800,6887.5,1365,13154600,9637,9877200,aaa
2024-08-06,1681,9347400,5560.62,1546,8064200,5216,1283200,aaa
2024-08-05,3421,12353900,3611.2,1765,17507200,9919,-5153300,aaa
2024-08-02,2286,10425600,4560.63,1436,16116600,11223,-5691000,aaa
2024-08-01,3970,21293400,5363.58,2031,30232500,14886,-8939100,aaa
2024-07-31,2677,19081900,7128.09,2008,23023100,11466,-3941200,aaa
2024-07-30,3499,40707500,11634.04,4854,35930300,7402,4777200,aaa
2024-07-29,1109,6550700,5906.85,1754,7532100,4294,-981400,aaa
2024-07-26,1398,7686300,5498.07,1361,7317900,5377,368400,aaa
2024-07-25,2647,9798300,3701.66,1304,10970400,8413,-1172100,aaa
2024-07-24,2167,14397200,6643.84,1510,9810000,6497,4587200,aaa
2024-07-22,2622,15081300,5751.83,1972,12854200,6518,2227100,aaa
2024-07-19,2024,11766700,5813.59,1583,9984500,6307,1782200,aaa
2024-07-18,2471,17766400,7189.96,1717,21487600,12515,-3721200,aaa
2024-07-17,3167,20441800,6454.63,3088,19326900,6259,1114900,aaa
2024-07-16,2011,14401300,7161.26,3114,16355500,5252,-1954200,aaa
2024-07-15,2448,26991300,11025.86,4659,18041600,3872,8949700,aaa
2024-07-12,1875,14867400,7929.28,4257,18137300,4261,-3269900,aaa
2024-07-11,2338,30910800,13221.04,4587,25382500,5534,5528300,aaa
2024-07-10,1583,6924000,4373.97,2334,13547200,5804,-6623200,aaa
2024-07-09,2715,20364100,7500.59,4193,21910500,5225,-1546400,aaa
2024-07-08,1701,9616400,5653.38,2558,13623900,5326,-4007500,aaa
2024-07-05,3308,26392300,7978.33,5063,29739100,5874,-3346800,aaa
2024-07-04,1392,6784900,4874.21,2010,8819900,4388,-2035000,aaa
2024-07-03,1511,8978300,5941.96,2151,9911500,4608,-933200,aaa
2024-07-02,1548,11345100,7328.88,1850,11012400,5953,332700,aaa
2024-07-01,1307,6489100,4964.88,1088,4518600,4153,1970500,aaa
2024-06-28,3556,12706200,3573.17,1853,15522000,8377,-2815800,aaa
2024-06-27,1663,6644400,3995.43,1847,11087700,6003,-4443300,aaa
2024-06-26,4751,31309400,6590.07,4659,32119200,6894,-809800,aaa
2024-06-25,1389,9856000,7095.75,1914,14113900,7374,-4257900,aaa
2024-06-24,1904,7463700,3920.01,2326,11134600,4787,-3670900,aaa
2024-06-21,2211,17716000,8012.66,2971,16582700,5582,1133300,aaa
2024-06-20,1793,7053600,3933.97,1576,12782500,8111,-5728900,aaa
2024-06-19,1752,7393400,4219.98,1366,5920600,4334,1472800,aaa
2024-06-18,2006,6913800,3446.56,1511,7100100,4699,-186300,aaa
2024-06-17,2445,9757500,3990.8,1473,10538200,7154,-780700,aaa
2024-06-14,3178,13185500,4148.99,1931,15580400,8069,-2394900,aaa
2024-06-13,2304,6467200,2806.94,1723,10479600,6082,-4012400,aaa
2024-06-12,2392,10719600,4481.44,1589,9418300,5927,1301300,aaa
2024-06-11,5461,20631200,3777.92,3343,21768700,6512,-1137500,aaa
2024-06-10,3449,13942900,4042.59,2291,16983100,7413,-3040200,aaa
2024-06-07,2478,8534000,3443.91,2147,13995100,6518,-5461100,aaa
2024-06-06,2894,15097500,5216.83,3302,17481100,5294,-2383600,aaa
2024-06-05,3329,16944000,5089.82,2705,18897100,6986,-1953100,aaa
2024-06-04,2272,11932100,5251.8,3329,18976000,5700,-7043900,aaa
2024-06-03,2416,10565400,4373.1,2447,13430200,5488,-2864800,aaa
2024-05-31,3172,11463900,3614.09,3018,16602700,5501,-5138800,aaa
2024-05-30,4036,15341100,3801.07,3059,15223900,4977,117200,aaa
2024-05-29,6754,41190900,6098.74,6449,31545400,4892,9645500,aaa
2024-05-28,3280,26212800,7991.71,4566,21598500,4730,4614300,aaa
2024-05-27,1492,10655200,7141.55,1158,6155600,5316,4499600,aaa
2024-05-24,5245,27418000,5227.45,3443,30638600,8899,-3220600,aaa
2024-05-23,2143,16252500,7583.99,1624,10500900,6466,5751600,aaa
2024-05-22,2262,9220600,4076.3,2458,14282500,5811,-5061900,aaa
2024-05-21,3419,18593100,5438.17,2762,16304100,5903,2289000,aaa
2024-05-20,2136,8478000,3969.1,2990,13479800,4508,-5001800,aaa
2024-05-17,3401,22352700,6572.39,3940,17800300,4518,4552400,aaa
2024-05-16,1510,8476600,5613.64,2062,9923800,4813,-1447200,aaa
2024-05-15,1230,9594700,7800.57,2069,9031400,4365,563300,aaa
2024-05-14,900,6592200,7324.67,1800,8688400,4827,-2096200,aaa
2024-05-13,1421,12070000,8494.02,3206,14127200,4406,-2057200,aaa
2024-05-10,1785,14550500,8151.54,3097,14144600,4567,405900,aaa
2024-05-09,888,4325800,4871.4,1418,6655800,4694,-2330000,aaa
2024-05-08,1292,8650700,6695.59,1315,6429700,4890,2221000,aaa
2024-05-07,1448,9618000,6642.27,2578,10938800,4243,-1320800,aaa
2024-05-06,1145,7036000,6144.98,1222,4332600,3545,2703400,aaa
2024-05-03,992,3900600,3932.06,1080,5298900,4906,-1398300,aaa
2024-05-02,1107,5818200,5255.83,1526,5657800,3708,160400,aaa
2024-04-26,890,4182800,4699.78,819,3452700,4216,730100,aaa
2024-04-25,923,2621500,2840.2,679,2579600,3799,41900,aaa
2024-04-24,1165,5668500,4865.67,1194,3348400,2804,2320100,aaa
2024-04-23,1500,4201500,2801.0,612,4215000,6887,-13500,aaa
2024-04-22,1617,5642400,3489.42,920,4580000,4978,1062400,aaa
2024-04-19,2076,5420300,2610.93,1046,5694200,5444,-273900,aaa
2024-04-17,1440,5093000,3536.81,1157,4605200,3980,487800,aaa
2024-04-16,2980,10291800,3453.62,1419,9662400,6809,629400,aaa
2024-04-15,2723,8301200,3048.55,1323,10670900,8066,-2369700,aaa
2024-04-12,2288,8295900,3625.83,1147,9677000,8437,-1381100,aaa
2024-04-11,2537,11162400,4399.84,1295,12792000,9878,-1629600,aaa
2024-04-10,1076,7559400,7025.46,1389,6847300,4930,712100,aaa
2024-04-09,1706,6324100,3706.98,950,5488500,5777,835600,aaa
2024-04-08,1485,6832700,4601.14,1328,8523300,6418,-1690600,aaa
2024-04-05,2677,19412500,7251.59,3152,13870900,4401,5541600,aaa
2024-04-04,2205,8748800,3967.71,1789,9244300,5167,-495500,aaa
2024-04-03,2588,20760300,8021.75,3888,19283100,4960,1477200,aaa
2024-04-02,1726,8323700,4822.54,1255,6698100,5337,1625600,aaa
2024-04-01,1646,5492500,3336.88,1658,7357600,4438,-1865100,aaa
2024-03-29,2213,14094700,6369.05,3567,14214900,3985,-120200,aaa
2024-03-28,1044,7094400,6795.4,1521,9067000,5961,-1972600,aaa
2024-03-27,1197,5974400,4991.14,1717,8131300,4736,-2156900,aaa
2024-03-26,1462,10968400,7502.33,1818,8723600,4798,2244800,aaa
2024-03-25,1529,7055600,4614.52,1688,7763300,4599,-707700,aaa
2024-03-22,1808,7192900,3978.37,2202,11055700,5021,-3862800,aaa
2024-03-21,2332,18387600,7884.91,3206,15084400,4705,3303200,aaa
2024-03-20,1386,5760100,4155.92,1047,6299900,6017,-539800,aaa
2024-03-19,1450,6298400,4343.72,981,4853800,4948,1444600,aaa
2024-03-18,2736,9763800,3568.64,1529,10242700,6699,-478900,aaa
2024-03-15,1915,6383500,3333.42,1157,7019200,6067,-635700,aaa
2024-03-14,1833,6493200,3542.39,1499,9060200,6044,-2567000,aaa
2024-03-13,1297,6357600,4901.77,1061,6400900,6033,-43300,aaa
2024-03-12,1993,9473800,4753.54,1194,6511000,5453,2962800,aaa
2024-03-11,2019,6518900,3228.78,1122,7119800,6346,-600900,aaa
2024-03-08,2424,7552400,3115.68,1403,9207100,6562,-1654700,aaa
2024-03-07,1460,5510200,3774.11,1295,7009200,5413,-1499000,aaa
2024-03-06,1552,6233400,4016.37,1510,7403100,4903,-1169700,aaa
2024-03-05,2163,13187900,6097.04,2847,13768400,4836,-580500,aaa
2024-03-04,1778,7639100,4296.46,1992,10190800,5116,-2551700,aaa
2024-03-01,1725,7765400,4501.68,1783,9950600,5581,-2185200,aaa
2024-02-29,2695,12673800,4702.71,1939,11566900,5965,1106900,aaa
2024-02-28,1869,8621800,4613.06,2627,13635100,5190,-5013300,aaa
2024-02-27,1702,6654800,3909.99,2346,10470100,4463,-3815300,aaa
2024-02-26,2668,14251200,5341.53,2854,13530800,4741,720400,aaa
2024-02-23,2614,12715700,4864.46,2282,15023000,6583,-2307300,aaa
2024-02-22,1594,10124300,6351.51,2285,10624800,4650,-500500,aaa
2024-02-21,3175,23908200,7530.14,4677,19811800,4236,4096400,aaa
2024-02-20,1756,8387500,4776.48,1681,8237700,4900,149800,aaa
2024-02-19,2473,9086800,3674.4,1746,10731900,6147,-1645100,aaa
2024-02-16,1849,7420800,4013.41,1966,8874900,4514,-1454100,aaa
2024-02-15,2119,9413700,4442.52,2576,11971400,4647,-2557700,aaa
2024-02-07,0,0,0.0,0,0,0,0,aaa
2024-02-06,1237,5319800,4300.57,1633,7718900,4727,-2399100,aaa
2024-02-05,1516,7550400,4980.47,2431,11030600,4537,-3480200,aaa
2024-02-02,1536,7986200,5199.35,2815,9748000,3463,-1761800,aaa
2024-02-01,2552,18542500,7265.87,3004,12078100,4021,6464400,aaa
2024-01-31,2238,8300400,3708.85,1818,10568100,5813,-2267700,aaa
2024-01-30,1627,10858200,6673.76,2463,10852800,4406,5400,aaa
2024-01-29,2623,12951900,4937.82,3417,14595100,4271,-1643200,aaa
2024-01-26,1804,7394300,4098.84,2404,11163300,4644,-3769000,aaa
2024-01-25,3280,17738000,5407.93,4624,19516500,4221,-1778500,aaa
2024-01-24,931,2964300,3184.0,884,3607700,4081,-643400,aaa
2024-01-23,838,2887600,3445.82,956,3618200,3785,-730600,aaa
2024-01-22,940,4025800,4282.77,1263,4156400,3291,-130600,aaa
2024-01-19,1013,3635700,3589.04,900,4396900,4885,-761200,aaa
2024-01-18,1074,2967800,2763.31,755,3274700,4337,-306900,aaa
2024-01-17,902,2947300,3267.52,979,4433000,4528,-1485700,aaa
2024-01-16,971,2472200,2546.04,653,2506400,3838,-34200,aaa
2024-01-15,1388,3933700,2834.08,845,4905400,5805,-971700,aaa
2024-01-12,2477,6258700,2526.73,1081,6512300,6024,-253600,aaa
2024-01-11,1459,4905900,3362.51,1897,6981900,3680,-2076000,aaa
2024-01-10,0,0,0.0,0,0,0,0,aaa
2024-01-09,1295,4740000,3660.23,1783,6404000,3592,-1664000,aaa
2024-01-08,1399,7738100,5531.17,1989,7472600,3757,265500,aaa
2024-01-05,1422,3675000,2584.39,1149,4916500,4279,-1241500,aaa
2024-01-04,1155,3551700,3075.06,1450,6271400,4325,-2719700,aaa
2024-01-03,1282,5159900,4024.88,1760,6212300,3530,-1052400,aaa
2024-01-02,1102,3180200,2885.84,1024,4092700,3997,-912500,aaa
2024-09-12,30,32700,1090.0,17,5700,335,27000,aam
2024-09-11,23,24300,1056.52,44,28600,650,-4300,aam
2024-09-10,27,11900,440.74,14,7500,536,4400,aam
2024-09-09,48,20500,427.08,14,16000,1143,4500,aam
2024-09-06,23,10000,434.78,17,9700,571,300,aam
2024-09-05,36,11000,305.56,32,17600,550,-6600,aam
2024-09-04,28,7700,275.0,26,8000,308,-300,aam
2024-08-30,26,14900,573.08,24,8500,354,6400,aam
2024-08-29,21,7900,376.19,17,11500,676,-3600,aam
2024-08-28,26,13000,500.0,25,9400,376,3600,aam
2024-08-27,20,7700,385.0,12,9100,758,-1400,aam
2024-08-26,17,6400,376.47,16,10100,631,-3700,aam
2024-08-23,23,8000,347.83,22,12100,550,-4100,aam
2024-08-22,41,17600,429.27,24,13000,542,4600,aam
2024-08-21,42,41600,990.48,46,21400,465,20200,aam
2024-08-20,23,12900,560.87,25,20800,832,-7900,aam
2024-08-19,89,57600,647.19,45,45500,1011,12100,aam
2024-08-16,41,13300,324.39,51,29200,573,-15900,aam
2024-08-15,20,5900,295.0,44,16400,373,-10500,aam
2024-08-14,26,37900,1457.69,36,12200,339,25700,aam
2024-08-13,32,8500,265.62,24,7000,292,1500,aam
2024-08-12,42,28400,676.19,26,16000,615,12400,aam
2024-08-08,13,5300,407.69,12,6700,558,-1400,aam
2024-08-07,15,5500,366.67,14,11500,821,-6000,aam
2024-08-06,16,5500,343.75,12,5600,467,-100,aam
2024-08-05,22,10800,490.91,14,15900,1136,-5100,aam
2024-08-02,35,9900,282.86,19,18800,989,-8900,aam
2024-08-01,20,13000,650.0,15,23400,1560,-10400,aam
2024-07-31,15,2800,186.67,10,27300,2730,-24500,aam
2024-07-30,33,24600,745.45,14,26700,1907,-2100,aam
2024-07-29,27,18700,692.59,17,26300,1547,-7600,aam
2024-07-26,31,15500,500.0,19,49400,2600,-33900,aam
2024-07-25,16,7900,493.75,21,50000,2381,-42100,aam
2024-07-24,19,9400,494.74,29,46200,1593,-36800,aam
2024-07-22,18,6200,344.44,12,3300,275,2900,aam
2024-07-19,54,130300,2412.96,30,80900,2697,49400,aam
2024-07-18,36,58200,1616.67,38,46400,1221,11800,aam
2024-07-17,35,69600,1988.57,50,84200,1684,-14600,aam
2024-07-16,29,14400,496.55,13,14600,1123,-200,aam
2024-07-15,30,8900,296.67,24,10600,442,-1700,aam
2024-07-12,24,5600,233.33,22,8200,373,-2600,aam
2024-07-11,23,15200,660.87,38,13000,342,2200,aam
2024-07-10,40,29800,745.0,33,15300,464,14500,aam
2024-07-09,43,44400,1032.56,53,27700,523,16700,aam
2024-07-08,35,23400,668.57,30,36400,1213,-13000,aam
2024-07-05,19,14000,736.84,23,8000,348,6000,aam
2024-07-04,45,38300,851.11,29,14900,514,23400,aam
2024-07-03,45,13300,295.56,15,12900,860,400,aam
2024-07-02,40,12700,317.5,23,14700,639,-2000,aam
2024-07-01,23,9400,408.7,19,8700,458,700,aam
2024-06-28,35,15700,448.57,26,14200,546,1500,aam
2024-06-27,35,12900,368.57,27,15400,570,-2500,aam
2024-06-26,51,19600,384.31,23,14500,630,5100,aam
2024-06-25,39,11800,302.56,27,22200,822,-10400,aam
2024-06-24,65,32000,492.31,38,35000,921,-3000,aam
2024-06-21,31,9200,296.77,23,21500,935,-12300,aam
2024-06-20,27,14100,522.22,20,20500,1025,-6400,aam
2024-06-19,40,11800,295.0,24,14900,621,-3100,aam
2024-06-18,56,17800,317.86,30,11400,380,6400,aam
2024-06-17,21,9000,428.57,26,22700,873,-13700,aam
2024-06-14,40,16700,417.5,29,23700,817,-7000,aam
2024-06-13,32,20100,628.12,31,34900,1126,-14800,aam
2024-06-12,33,12100,366.67,23,12600,548,-500,aam
2024-06-11,46,25300,550.0,21,13400,638,11900,aam
2024-06-10,38,18500,486.84,26,20000,769,-1500,aam
2024-06-07,44,17100,388.64,35,23200,663,-6100,aam
2024-06-06,30,20000,666.67,26,22800,877,-2800,aam
2024-06-05,32,38700,1209.38,28,38200,1364,500,aam
2024-06-04,41,17100,417.07,19,30800,1621,-13700,aam
2024-06-03,60,29000,483.33,13,14400,1108,14600,aam
2024-05-31,31,24200,780.65,23,23500,1022,700,aam
2024-05-30,35,15900,454.29,32,27000,844,-11100,aam
2024-05-29,36,13400,372.22,22,27600,1255,-14200,aam
2024-05-28,39,20900,535.9,25,24700,988,-3800,aam
2024-05-27,19,11900,626.32,23,31700,1378,-19800,aam
2024-05-24,37,15800,427.03,31,45300,1461,-29500,aam
2024-05-23,19,3700,194.74,42,39400,938,-35700,aam
2024-05-22,28,10200,364.29,34,18400,541,-8200,aam
2024-05-21,37,14600,394.59,36,16400,456,-1800,aam
2024-05-20,19,5800,305.26,39,15000,385,-9200,aam
2024-05-17,43,22100,513.95,33,8700,264,13400,aam
2024-05-16,55,26300,478.18,25,12600,504,13700,aam
2024-05-15,26,17000,653.85,34,12100,356,4900,aam
2024-05-14,13,9900,761.54,24,11400,475,-1500,aam
2024-05-13,14,3400,242.86,22,9200,418,-5800,aam
2024-05-10,57,23000,403.51,18,8500,472,14500,aam
2024-05-09,46,37200,808.7,23,10200,443,27000,aam
2024-05-08,19,6400,336.84,23,17500,761,-11100,aam
2024-05-07,11,3800,345.45,21,13700,652,-9900,aam
2024-05-06,28,19800,707.14,28,26100,932,-6300,aam
2024-05-03,12,4300,358.33,17,12100,712,-7800,aam
2024-05-02,14,4900,350.0,18,11100,617,-6200,aam
2024-04-26,20,11400,570.0,19,11200,589,200,aam
2024-04-25,16,4100,256.25,18,9200,511,-5100,aam
2024-04-24,36,16500,458.33,36,38300,1064,-21800,aam
2024-04-23,11,11700,1063.64,23,10400,452,1300,aam
2024-04-22,21,14700,700.0,16,7900,494,6800,aam
2024-04-19,14,9900,707.14,19,11300,595,-1400,aam
2024-04-17,20,10000,500.0,16,17800,1112,-7800,aam
2024-04-16,17,8900,523.53,33,20300,615,-11400,aam
2024-04-15,53,19600,369.81,20,15000,750,4600,aam
2024-04-12,21,10200,485.71,26,19200,738,-9000,aam
2024-04-11,29,13800,475.86,25,25700,1028,-11900,aam
2024-04-10,19,7400,389.47,24,23000,958,-15600,aam
2024-04-09,20,6600,330.0,19,11500,605,-4900,aam
2024-04-08,19,8800,463.16,28,10500,375,-1700,aam
2024-04-05,17,9300,547.06,28,12400,443,-3100,aam
2024-04-04,33,12700,384.85,22,25300,1150,-12600,aam
2024-04-03,42,16200,385.71,24,11800,492,4400,aam
2024-04-02,34,8800,258.82,17,10100,594,-1300,aam
2024-04-01,29,21400,737.93,24,14400,600,7000,aam
2024-03-29,27,14900,551.85,28,21700,775,-6800,aam
2024-03-28,71,36500,514.08,37,29200,789,7300,aam
2024-03-27,30,14200,473.33,27,24100,893,-9900,aam
2024-03-26,21,13100,623.81,28,10000,357,3100,aam
2024-03-25,28,14100,503.57,31,17800,574,-3700,aam
2024-03-22,33,14200,430.3,43,19600,456,-5400,aam
2024-03-21,38,20400,536.84,23,13400,583,7000,aam
2024-03-20,31,39300,1267.74,41,20100,490,19200,aam
2024-03-19,26,48400,1861.54,17,8400,494,40000,aam
2024-03-18,55,26800,487.27,33,16700,506,10100,aam
2024-03-15,34,19900,585.29,19,9900,521,10000,aam
2024-03-14,28,16100,575.0,28,23100,825,-7000,aam
2024-03-13,35,19000,542.86,29,12900,445,6100,aam
2024-03-12,22,12400,563.64,35,15100,431,-2700,aam
2024-03-11,37,22100,597.3,42,32500,774,-10400,aam
2024-03-08,46,27600,600.0,43,26800,623,800,aam
2024-03-07,72,19000,263.89,27,13000,481,6000,aam
2024-03-06,75,35100,468.0,29,27300,941,7800,aam
2024-03-05,45,21300,473.33,24,13100,546,8200,aam
2024-03-04,64,22500,351.56,45,26600,591,-4100,aam
2024-03-01,47,26000,553.19,38,20800,547,5200,aam
2024-02-29,43,20200,469.77,37,25300,684,-5100,aam
2024-02-28,60,33300,555.0,41,28100,685,5200,aam
2024-02-27,36,23000,638.89,45,28000,622,-5000,aam
2024-02-26,69,69100,1001.45,30,22800,760,46300,aam
2024-02-23,42,19800,471.43,40,23300,582,-3500,aam
2024-02-22,79,56000,708.86,35,24300,694,31700,aam
2024-02-21,23,8700,378.26,9,4500,500,4200,aam
2024-02-20,48,18700,389.58,32,17500,547,1200,aam
2024-02-19,50,41000,820.0,22,14200,645,26800,aam
2024-02-16,27,7900,292.59,14,10100,721,-2200,aam
2024-02-15,37,19600,529.73,35,21200,606,-1600,aam
2024-02-07,0,0,0.0,0,0,0,0,aam
2024-02-06,68,25900,380.88,23,10800,470,15100,aam
2024-02-05,31,9100,293.55,27,11700,433,-2600,aam
2024-02-02,22,4800,218.18,14,6100,436,-1300,aam
2024-02-01,24,12900,537.5,14,3800,271,9100,aam
2024-01-31,20,8600,430.0,24,10700,446,-2100,aam
2024-01-30,18,6500,361.11,17,8600,506,-2100,aam
2024-01-29,32,15100,471.88,30,16700,557,-1600,aam
2024-01-26,26,11300,434.62,18,11600,644,-300,aam
2024-01-25,18,8200,455.56,15,7400,493,800,aam
2024-01-24,43,24000,558.14,28,21600,771,2400,aam
2024-01-23,8,5200,650.0,29,18200,628,-13000,aam
2024-01-22,19,5100,268.42,10,10500,1050,-5400,aam
2024-01-19,39,31200,800.0,16,12500,781,18700,aam
2024-01-18,26,9300,357.69,18,16600,922,-7300,aam
2024-01-17,18,6100,338.89,12,9400,783,-3300,aam
2024-01-16,23,11800,513.04,27,38000,1407,-26200,aam
2024-01-15,12,6800,566.67,15,12500,833,-5700,aam
2024-01-12,14,6200,442.86,24,14200,592,-8000,aam
2024-01-11,19,10300,542.11,25,22400,896,-12100,aam
2024-01-10,0,0,0.0,0,0,0,0,aam
2024-01-09,54,154300,2857.41,31,20200,652,134100,aam
2024-01-08,19,6000,315.79,20,18500,925,-12500,aam
2024-01-05,18,5300,294.44,17,14200,835,-8900,aam
2024-01-04,29,12700,437.93,34,17300,509,-4600,aam
2024-01-03,72,36200,502.78,19,14900,784,21300,aam
2024-01-02,25,6900,276.0,22,17700,805,-10800,aam
2024-09-12,151,380400,2519.21,165,571300,3462,-190900,aas
2024-09-11,190,210500,1107.89,136,605500,4452,-395000,aas
2024-09-10,121,388600,3211.57,234,842600,3601,-454000,aas
2024-09-09,171,434100,2538.6,189,690200,3652,-256100,aas
2024-09-06,153,408100,2667.32,188,550500,2928,-142400,aas
2024-09-05,171,402000,2350.88,201,655600,3262,-253600,aas
2024-09-04,241,526800,2185.89,186,608600,3272,-81800,aas
2024-08-30,171,805600,4711.11,268,1006700,3756,-201100,aas
2024-08-29,173,972800,5623.12,326,1239900,3803,-267100,aas
2024-08-28,160,752800,4705.0,292,954800,3270,-202000,aas
2024-08-27,156,386400,2476.92,288,809300,2810,-422900,aas
2024-08-26,171,621900,3636.84,266,854300,3212,-232400,aas
2024-08-23,198,805000,4065.66,330,1132200,3431,-327200,aas
2024-08-22,142,548600,3863.38,299,777200,2599,-228600,aas
2024-08-21,201,483500,2405.47,290,1099400,3791,-615900,aas
2024-08-20,207,950300,4590.82,354,902200,2549,48100,aas
2024-08-19,210,915900,4361.43,387,1108000,2863,-192100,aas
2024-08-16,295,1793300,6078.98,449,1044200,2326,749100,aas
2024-08-15,258,418400,1621.71,211,635600,3012,-217200,aas
2024-08-14,229,680200,2970.31,231,657400,2846,22800,aas
2024-08-13,297,638500,2149.83,204,563900,2764,74600,aas
2024-08-12,201,373200,1856.72,213,511900,2403,-138700,aas
2024-08-09,353,1241700,3517.56,390,947100,2428,294600,aas
2024-08-08,335,594500,1774.63,272,651400,2395,-56900,aas
2024-08-07,428,1106700,2585.75,284,776800,2735,329900,aas
2024-08-06,433,896600,2070.67,239,1026800,4296,-130200,aas
2024-08-05,595,1357900,2282.18,306,1347700,4404,10200,aas
2024-08-02,468,1412200,3017.52,290,1110600,3830,301600,aas
2024-08-01,489,872300,1783.84,316,1115000,3528,-242700,aas
2024-07-31,211,428600,2031.28,239,971100,4063,-542500,aas
2024-07-30,451,716800,1589.36,245,1270900,5187,-554100,aas
2024-07-29,258,516100,2000.39,305,1379500,4523,-863400,aas
2024-07-26,294,602100,2047.96,283,1565700,5533,-963600,aas
2024-07-25,355,1235000,3478.87,390,1474300,3780,-239300,aas
2024-07-24,583,1494800,2563.98,324,1407000,4343,87800,aas
2024-07-23,586,1292500,2205.63,281,1868500,6649,-576000,aas
2024-07-22,799,1581500,1979.35,358,2530900,7070,-949400,aas
2024-07-19,408,774200,1897.55,390,1413400,3624,-639200,aas
2024-07-18,372,764500,2055.11,305,986200,3233,-221700,aas
2024-07-17,400,1705700,4264.25,546,2165100,3965,-459400,aas
2024-07-16,291,772500,2654.64,331,1351600,4083,-579100,aas
2024-07-15,355,628500,1770.42,358,1137100,3176,-508600,aas
2024-07-12,368,667900,1814.95,390,1076600,2761,-408700,aas
2024-07-11,412,717200,1740.78,364,1233500,3389,-516300,aas
2024-07-10,349,992400,2843.55,383,1472400,3844,-480000,aas
2024-07-09,364,917700,2521.15,403,1325000,3288,-407300,aas
2024-07-08,401,673500,1679.55,344,1085200,3155,-411700,aas
2024-07-05,361,714800,1980.06,332,920200,2772,-205400,aas
2024-07-04,411,849600,2067.15,317,1256500,3964,-406900,aas
2024-07-03,346,658100,1902.02,257,1096600,4267,-438500,aas
2024-07-02,359,802400,2235.1,262,809800,3091,-7400,aas
2024-07-01,522,826500,1583.33,291,1141300,3922,-314800,aas
2024-06-28,542,1046900,1931.55,319,1407100,4411,-360200,aas
2024-06-27,346,802100,2318.21,272,1091300,4012,-289200,aas
2024-06-26,592,1059400,1789.53,383,1227500,3205,-168100,aas
2024-06-25,417,1163200,2789.45,377,1222400,3242,-59200,aas
2024-06-24,793,1659100,2092.18,542,2446000,4513,-786900,aas
2024-06-21,579,1367400,2361.66,430,2577000,5993,-1209600,aas
2024-06-20,551,1093700,1984.94,423,1827600,4321,-733900,aas
2024-06-19,472,1300800,2755.93,554,2228800,4023,-928000,aas
2024-06-18,556,1298000,2334.53,521,1654400,3175,-356400,aas
2024-06-17,928,1883400,2029.53,465,2190800,4711,-307400,aas
2024-06-14,850,2414600,2840.71,1002,4336900,4328,-1922300,aas
2024-06-13,504,1617200,3208.73,1018,4188100,4114,-2570900,aas
2024-06-12,1349,5701400,4226.39,1731,6469600,3737,-768200,aas
2024-06-11,658,1759200,2673.56,447,2443000,5465,-683800,aas
2024-06-10,489,1216100,2486.91,503,2584600,5138,-1368500,aas
2024-06-07,529,1163500,2199.43,446,1972100,4422,-808600,aas
2024-06-06,628,1251700,1993.15,530,2179700,4113,-928000,aas
2024-06-05,521,1330700,2554.13,621,2055400,3310,-724700,aas
2024-06-04,353,1119800,3172.24,614,2077200,3383,-957400,aas
2024-06-03,603,2028200,3363.52,687,2616700,3809,-588500,aas
2024-05-31,434,1181500,2722.35,482,1604700,3329,-423200,aas
2024-05-30,643,1387700,2158.16,367,1718300,4682,-330600,aas
2024-05-29,442,895500,2026.02,608,1824100,3000,-928600,aas
2024-05-28,400,1125700,2814.25,454,1865600,4109,-739900,aas
2024-05-27,570,1148400,2014.74,513,1959200,3819,-810800,aas
2024-05-24,709,1696200,2392.38,685,2755100,4022,-1058900,aas
2024-05-23,550,1461000,2656.36,611,2418300,3958,-957300,aas
2024-05-22,579,1719200,2969.26,867,3015600,3478,-1296400,aas
2024-05-21,465,1765400,3796.56,775,2565200,3310,-799800,aas
2024-05-20,424,1512800,3567.92,808,2289400,2833,-776600,aas
2024-05-17,739,1724600,2333.69,715,2688500,3760,-963900,aas
2024-05-16,450,1290500,2867.78,797,2249800,2823,-959300,aas
2024-05-15,651,2023100,3107.68,550,2341800,4258,-318700,aas
2024-05-14,428,1003500,2344.63,640,1968100,3075,-964600,aas
2024-05-13,615,1782500,2898.37,812,2463700,3034,-681200,aas
2024-05-10,444,1662400,3744.14,446,1817600,4075,-155200,aas
2024-05-09,486,1265000,2602.88,488,1763400,3614,-498400,aas
2024-05-08,604,1449000,2399.01,674,1920600,2850,-471600,aas
2024-05-07,480,1156300,2408.96,527,1897300,3600,-741000,aas
2024-05-06,606,1797200,2965.68,565,2077200,3676,-280000,aas
2024-05-03,396,1062100,2682.07,491,1858800,3786,-796700,aas
2024-05-02,393,740500,1884.22,392,1120100,2857,-379600,aas
2024-04-26,608,1263200,2077.63,423,2257100,5336,-993900,aas
2024-04-25,468,1560700,3334.83,490,1618500,3303,-57800,aas
2024-04-24,522,1393400,2669.35,608,2416000,3974,-1022600,aas
2024-04-23,411,1076800,2619.95,469,2213600,4720,-1136800,aas
2024-04-22,820,3064500,3737.2,713,3482000,4884,-417500,aas
2024-04-19,981,2564700,2614.37,789,3046300,3861,-481600,aas
2024-04-17,498,2120200,4257.43,597,2753700,4613,-633500,aas
2024-04-16,1255,2542100,2025.58,809,2875600,3555,-333500,aas
2024-04-15,824,1656300,2010.07,865,2945600,3405,-1289300,aas
2024-04-12,660,1976900,2995.3,602,2287500,3800,-310600,aas
2024-04-11,906,2178600,2404.64,589,2233800,3793,-55200,aas
2024-04-10,444,963400,2169.82,691,2424900,3509,-1461500,aas
2024-04-09,860,2408600,2800.7,470,1797000,3823,611600,aas
2024-04-08,777,1737000,2235.52,681,2265900,3327,-528900,aas
2024-04-05,1031,2803200,2718.91,1054,2922000,2772,-118800,aas
2024-04-04,858,2093100,2439.51,667,3108500,4660,-1015400,aas
2024-04-03,761,1955600,2569.78,768,2981600,3882,-1026000,aas
2024-04-02,951,2540100,2670.98,599,2991800,4995,-451700,aas
2024-04-01,889,2475400,2784.48,712,2800800,3934,-325400,aas
2024-03-29,673,1772800,2634.18,828,3324000,4014,-1551200,aas
2024-03-28,1099,2595100,2361.33,936,3052500,3261,-457400,aas
2024-03-27,1122,4690400,4180.39,1229,3961500,3223,728900,aas
2024-03-26,762,1990400,2612.07,567,2812500,4960,-822100,aas
2024-03-25,709,2791000,3936.53,979,4482400,4579,-1691400,aas
2024-03-22,873,3103000,3554.41,1174,5091300,4337,-1988300,aas
2024-03-21,804,2828200,3517.66,1119,4740500,4236,-1912300,aas
2024-03-20,743,2546700,3427.59,592,2814500,4754,-267800,aas
2024-03-19,729,2163200,2967.35,526,2527400,4805,-364200,aas
2024-03-18,1434,4401000,3069.04,959,4654400,4853,-253400,aas
2024-03-15,866,2680400,3095.15,749,3542500,4730,-862100,aas
2024-03-14,867,2922500,3370.82,1227,5073700,4135,-2151200,aas
2024-03-13,841,2719300,3233.41,928,3409000,3673,-689700,aas
2024-03-12,894,2298200,2570.69,627,2552600,4071,-254400,aas
2024-03-11,1018,2923100,2871.41,791,4104800,5189,-1181700,aas
2024-03-08,1081,3714500,3436.17,1378,4752100,3449,-1037600,aas
2024-03-07,1451,6049500,4169.19,2083,6722400,3227,-672900,aas
2024-03-06,992,2982100,3006.15,1019,4105500,4029,-1123400,aas
2024-03-05,1028,2872800,2794.55,974,3791500,3893,-918700,aas
2024-03-04,955,3396800,3556.86,1390,4235000,3047,-838200,aas
2024-03-01,1422,6885400,4842.05,1851,7724900,4173,-839500,aas
2024-02-29,931,2830400,3040.17,1054,4303100,4083,-1472700,aas
2024-02-28,673,1869200,2777.41,1012,3809700,3765,-1940500,aas
2024-02-27,714,3106000,4350.14,1154,4128700,3578,-1022700,aas
2024-02-26,763,2835200,3715.86,602,2872100,4771,-36900,aas
2024-02-23,703,2216900,3153.49,720,3826100,5314,-1609200,aas
2024-02-22,650,1841400,2832.92,867,3547800,4092,-1706400,aas
2024-02-21,632,2495800,3949.05,809,3121800,3859,-626000,aas
2024-02-20,1017,4887900,4806.19,1366,4775800,3496,112100,aas
2024-02-19,556,1624100,2921.04,532,2450400,4606,-826300,aas
2024-02-16,588,1417100,2410.03,540,2644600,4897,-1227500,aas
2024-02-15,522,1394600,2671.65,455,1724600,3790,-330000,aas
2024-02-07,366,960300,2623.77,460,1847100,4015,-886800,aas
2024-02-06,436,1086000,2490.83,524,1958700,3738,-872700,aas
2024-02-05,587,1313900,2238.33,380,1849400,4867,-535500,aas
2024-02-02,613,1576200,2571.29,440,2029000,4611,-452800,aas
2024-02-01,444,1230800,2772.07,383,1774700,4634,-543900,aas
2024-01-31,386,972100,2518.39,560,2157100,3852,-1185000,aas
2024-01-30,393,1180200,3003.05,380,1588800,4181,-408600,aas
2024-01-29,719,1570200,2183.87,434,2080600,4794,-510400,aas
2024-01-26,606,1523800,2514.52,443,2564300,5788,-1040500,aas
2024-01-25,481,1160600,2412.89,430,2414700,5616,-1254100,aas
2024-01-24,686,2189500,3191.69,458,2971900,6489,-782400,aas
2024-01-23,457,1511400,3307.22,503,2403100,4778,-891700,aas
2024-01-22,668,1832200,2742.81,506,3162200,6249,-1330000,aas
2024-01-19,396,1329800,3358.08,672,2700000,4018,-1370200,aas
2024-01-18,407,1262700,3102.46,583,2728800,4681,-1466100,aas
2024-01-17,467,1919500,4110.28,871,3463800,3977,-1544300,aas
2024-01-16,611,1735000,2839.61,378,1939200,5130,-204200,aas
2024-01-15,456,1183300,2594.96,461,1978700,4292,-795400,aas
2024-01-12,712,1846100,2592.84,591,2668000,4514,-821900,aas
2024-01-11,511,1552900,3038.94,595,2732400,4592,-1179500,aas
2024-01-10,635,1792100,2822.2,601,3192600,5312,-1400500,aas
2024-01-09,555,1582200,2850.81,748,3314500,4431,-1732300,aas
2024-01-08,544,2086700,3835.85,936,3236500,3458,-1149800,aas
2024-01-05,469,2006000,4277.19,698,2980800,4270,-974800,aas
2024-01-04,751,3456400,4602.4,1123,4661900,4151,-1205500,aas
2024-01-03,468,1781600,3806.84,627,2615800,4172,-834200,aas
2024-01-02,600,1222300,2037.17,598,2546000,4258,-1323700,aas
2024-09-12,454,3042700,6701.98,469,2358300,5028,684400,abb
2024-09-11,588,4412000,7503.4,468,3146100,6722,1265900,abb
2024-09-10,676,1774900,2625.59,468,3082100,6586,-1307200,abb
2024-09-09,675,2983400,4419.85,539,3350400,6216,-367000,abb
2024-09-06,597,2112000,3537.69,540,2990300,5538,-878300,abb
2024-09-05,542,2573700,4748.52,542,3450100,6365,-876400,abb
2024-09-04,480,1277200,2660.83,513,2599400,5067,-1322200,abb
2024-08-30,434,2029900,4677.19,604,3049800,5049,-1019900,abb
2024-08-29,555,1989000,3583.78,755,3234400,4284,-1245400,abb
2024-08-28,496,4795700,9668.75,689,3361400,4879,1434300,abb
2024-08-27,610,2037700,3340.49,714,2956100,4140,-918400,abb
2024-08-26,655,4059000,6196.95,762,3994300,5242,64700,abb
2024-08-23,584,2030300,3476.54,696,3419600,4913,-1389300,abb
2024-08-22,720,3557700,4941.25,1040,4232200,4069,-674500,abb
2024-08-21,657,2388900,3636.07,753,3759000,4992,-1370100,abb
2024-08-20,557,1879600,3374.51,722,3425200,4744,-1545600,abb
2024-08-19,553,1605600,2903.44,650,3156600,4856,-1551000,abb
2024-08-16,712,6296700,8843.68,754,3064700,4065,3232000,abb
2024-08-15,436,4774300,10950.23,565,2554000,4520,2220300,abb
2024-08-14,453,1291000,2849.89,553,2603700,4708,-1312700,abb
2024-08-13,610,1429600,2343.61,471,2415300,5128,-985700,abb
2024-08-12,519,1412600,2721.77,556,3315000,5962,-1902400,abb
2024-08-09,556,1342800,2415.11,485,2561300,5281,-1218500,abb
2024-08-08,747,1905000,2550.2,565,3103000,5492,-1198000,abb
2024-08-07,574,1666000,2902.44,503,2522000,5014,-856000,abb
2024-08-06,843,2954200,3504.39,459,2712000,5908,242200,abb
2024-08-05,1232,3596000,2918.83,667,5004300,7503,-1408300,abb
2024-08-02,1135,4326800,3812.16,517,4082400,7896,244400,abb
2024-08-01,808,3232400,4000.5,852,4500700,5283,-1268300,abb
2024-07-31,606,1683200,2777.56,663,3756200,5665,-2073000,abb
2024-07-30,485,1541600,3178.56,604,2768600,4584,-1227000,abb
2024-07-29,585,1780800,3044.1,590,3186200,5400,-1405400,abb
2024-07-26,888,2423900,2729.62,569,3203400,5630,-779500,abb
2024-07-25,881,2903600,3295.8,494,3311900,6704,-408300,abb
2024-07-24,1039,3026600,2912.99,632,3003900,4753,22700,abb
2024-07-23,918,1982600,2159.69,746,3478500,4663,-1495900,abb
2024-07-22,1093,3234000,2958.83,867,4634400,5345,-1400400,abb
2024-07-19,933,2732100,2928.3,937,5160400,5507,-2428300,abb
2024-07-18,734,2248900,3063.9,892,4582900,5138,-2334000,abb
2024-07-17,1457,5803700,3983.32,2018,9355600,4636,-3551900,abb
2024-07-16,712,2050700,2880.2,804,3491600,4343,-1440900,abb
2024-07-15,766,1757700,2294.65,631,3087700,4893,-1330000,abb
2024-07-12,757,1627200,2149.54,573,2297200,4009,-670000,abb
2024-07-11,562,1540400,2740.93,740,3344900,4520,-1804500,abb
2024-07-10,567,1545200,2725.22,739,2967100,4015,-1421900,abb
2024-07-09,582,1850700,3179.9,807,3093700,3834,-1243000,abb
2024-07-08,605,1789700,2958.18,676,2479700,3668,-690000,abb
2024-07-05,677,1788400,2641.65,636,2878500,4526,-1090100,abb
2024-07-04,571,1654100,2896.85,735,2983700,4059,-1329600,abb
2024-07-03,588,2252700,3831.12,657,2895700,4407,-643000,abb
2024-07-02,782,2176000,2782.61,586,3137600,5354,-961600,abb
2024-07-01,875,2356300,2692.91,509,2919400,5736,-563100,abb
2024-06-28,817,2252300,2756.79,616,3069800,4983,-817500,abb
2024-06-27,811,2578100,3178.91,562,2525700,4494,52400,abb
2024-06-26,1162,2735200,2353.87,690,3161500,4582,-426300,abb
2024-06-25,853,2397800,2811.02,638,3147300,4933,-749500,abb
2024-06-24,1177,2778900,2361.0,882,4649700,5272,-1870800,abb
2024-06-21,806,2255000,2797.77,954,3995100,4188,-1740100,abb
2024-06-20,1048,2511200,2396.18,860,3968600,4615,-1457400,abb
2024-06-19,1010,2224500,2202.48,940,4466800,4752,-2242300,abb
2024-06-18,916,2632800,2874.24,960,4541000,4730,-1908200,abb
2024-06-17,1438,3037500,2112.31,960,5111100,5324,-2073600,abb
2024-06-14,1253,4066800,3245.65,1400,7641800,5458,-3575000,abb
2024-06-13,1260,3972300,3152.62,1526,6757200,4428,-2784900,abb
2024-06-12,1326,7579300,5715.91,1253,5953300,4751,1626000,abb
2024-06-11,1150,3717200,3232.35,1267,6506400,5135,-2789200,abb
2024-06-10,1353,4623100,3416.93,1825,7206100,3949,-2583000,abb
2024-06-07,1395,4972600,3564.59,1344,5974500,4445,-1001900,abb
2024-06-06,1635,4166600,2548.38,1227,5842100,4761,-1675500,abb
2024-06-05,1269,3508800,2765.01,1462,6697300,4581,-3188500,abb
2024-06-04,1251,4169000,3332.53,1432,6695000,4675,-2526000,abb
2024-06-03,1344,4839100,3600.52,1530,6774500,4428,-1935400,abb
2024-05-31,1176,3655000,3107.99,1186,5768900,4864,-2113900,abb
2024-05-30,1363,4523800,3319.0,1448,5829600,4026,-1305800,abb
2024-05-29,2008,9942300,4951.34,3623,13319600,3676,-3377300,abb
2024-05-28,1787,5613100,3141.07,1360,6466500,4755,-853400,abb
2024-05-27,1573,4273800,2716.97,1329,5750100,4327,-1476300,abb
2024-05-24,2555,8135000,3183.95,2166,10366400,4786,-2231400,abb
2024-05-23,3915,12086100,3087.13,1448,11439000,7900,647100,abb
2024-05-22,3697,17038800,4608.82,2418,25324400,10473,-8285600,abb
2024-05-21,2984,71540700,23974.77,4755,79738600,16769,-8197900,abb
2024-05-20,988,13579000,13743.93,1337,16176100,12099,-2597100,abb
2024-05-17,800,2577300,3221.62,842,4182000,4967,-1604700,abb
2024-05-16,1007,3643700,3618.37,756,4811400,6364,-1167700,abb
2024-05-15,1047,2098800,2004.58,614,3737900,6088,-1639100,abb
2024-05-14,929,2102900,2263.62,505,2689900,5327,-587000,abb
2024-05-13,825,1922500,2330.3,608,3198700,5261,-1276200,abb
2024-05-10,565,1992100,3525.84,817,4157400,5089,-2165300,abb
2024-05-09,941,4082400,4338.36,1250,5767300,4614,-1684900,abb
2024-05-08,721,2897700,4019.0,652,3482700,5342,-585000,abb
2024-05-07,532,1789000,3362.78,665,3020800,4543,-1231800,abb
2024-05-06,648,2244000,3462.96,592,3116300,5264,-872300,abb
2024-05-03,720,1849200,2568.33,529,3316400,6269,-1467200,abb
2024-05-02,598,1527400,2554.18,431,2642600,6131,-1115200,abb
2024-04-26,588,1628300,2769.22,579,4037100,6973,-2408800,abb
2024-04-25,570,2285000,4008.77,589,3206100,5443,-921100,abb
2024-04-24,706,1967300,2786.54,566,2474700,4372,-507400,abb
2024-04-23,639,1612300,2523.16,549,2953400,5380,-1341100,abb
2024-04-22,877,2117300,2414.25,591,3226000,5459,-1108700,abb
2024-04-19,1324,2274700,1718.05,666,3379600,5074,-1104900,abb
2024-04-17,936,2548600,2722.86,678,5393800,7955,-2845200,abb
2024-04-16,1327,3447500,2597.97,779,5745000,7375,-2297500,abb
2024-04-15,1075,4401500,4094.42,1095,8332400,7609,-3930900,abb
2024-04-12,1033,4636800,4488.67,971,8437000,8689,-3800200,abb
2024-04-11,820,4563500,5565.24,1111,7621600,6860,-3058100,abb
2024-04-10,1411,6866900,4866.69,1640,8579200,5231,-1712300,abb
2024-04-09,1025,2355800,2298.34,600,4114900,6858,-1759100,abb
2024-04-08,872,1479100,1696.22,613,3783900,6173,-2304800,abb
2024-04-05,1028,2430100,2363.91,607,3905800,6435,-1475700,abb
2024-04-04,675,2773400,4108.74,756,4682300,6194,-1908900,abb
2024-04-03,822,3081000,3748.18,770,4171100,5417,-1090100,abb
2024-04-02,1173,2920400,2489.68,690,3958500,5737,-1038100,abb
2024-04-01,877,1963200,2238.54,709,4308200,6076,-2345000,abb
2024-03-29,661,2529900,3827.38,703,3482700,4954,-952800,abb
2024-03-28,922,4345700,4713.34,802,4936200,6155,-590500,abb
2024-03-27,935,2643700,2827.49,686,4411000,6430,-1767300,abb
2024-03-26,763,2061600,2701.97,738,5357900,7260,-3296300,abb
2024-03-25,864,2042300,2363.77,770,5519300,7168,-3477000,abb
2024-03-22,802,3455200,4308.23,1009,6915900,6854,-3460700,abb
2024-03-21,770,2563600,3329.35,845,6680600,7906,-4117000,abb
2024-03-20,817,1748900,2140.64,727,4131600,5683,-2382700,abb
2024-03-19,1009,1866800,1850.15,703,4064300,5781,-2197500,abb
2024-03-18,1324,3089700,2333.61,870,5523600,6349,-2433900,abb
2024-03-15,836,2408700,2881.22,833,4705800,5649,-2297100,abb
2024-03-14,729,2021100,2772.43,876,4926400,5624,-2905300,abb
2024-03-13,987,3101000,3141.84,773,4403700,5697,-1302700,abb
2024-03-12,964,1707800,1771.58,558,2981100,5342,-1273300,abb
2024-03-11,957,2157100,2254.02,750,4295100,5727,-2138000,abb
2024-03-08,971,2638900,2717.71,797,4564900,5728,-1926000,abb
2024-03-07,1078,3272900,3036.09,786,4740400,6031,-1467500,abb
2024-03-06,1325,4054300,3059.85,802,5981200,7458,-1926900,abb
2024-03-05,1225,4056900,3311.76,847,5999300,7083,-1942400,abb
2024-03-04,951,2916000,3066.25,959,4761800,4965,-1845800,abb
2024-03-01,1066,6969100,6537.62,1586,7671600,4837,-702500,abb
2024-02-29,663,1780200,2685.07,1023,3932000,3844,-2151800,abb
2024-02-28,784,2500900,3189.92,941,4474100,4755,-1973200,abb
2024-02-27,940,2894200,3078.94,864,5331800,6171,-2437600,abb
2024-02-26,625,2036900,3259.04,759,3526700,4647,-1489800,abb
2024-02-23,1406,6701400,4766.29,1573,8306700,5281,-1605300,abb
2024-02-22,968,3493700,3609.19,997,5291300,5307,-1797600,abb
2024-02-21,830,3716500,4477.71,865,4300000,4971,-583500,abb
2024-02-20,705,2168500,3075.89,808,3869600,4789,-1701100,abb
2024-02-19,740,3473200,4693.51,1062,4365100,4110,-891900,abb
2024-02-16,766,2941100,3839.56,1150,5169200,4495,-2228100,abb
2024-02-15,993,5197500,5234.14,1559,6657000,4270,-1459500,abb
2024-02-07,519,2430500,4683.04,655,3552200,5423,-1121700,abb
2024-02-06,467,1799900,3854.18,653,3698700,5664,-1898800,abb
2024-02-05,575,2907700,5056.87,940,4104800,4367,-1197100,abb
2024-02-02,494,2057400,4164.78,599,3133000,5230,-1075600,abb
2024-02-01,600,2379900,3966.5,577,2987300,5177,-607400,abb
2024-01-31,688,2098800,3050.58,673,4132600,6141,-2033800,abb
2024-01-30,741,3987800,5381.65,583,4402800,7552,-415000,abb
2024-01-29,610,2437700,3996.23,697,3500600,5022,-1062900,abb
2024-01-26,529,3076500,5815.69,695,4115400,5921,-1038900,abb
2024-01-25,448,2157900,4816.74,716,3776400,5274,-1618500,abb
2024-01-24,490,3729200,7610.61,777,4690600,6037,-961400,abb
2024-01-23,703,4127900,5871.83,819,6266900,7652,-2139000,abb
2024-01-22,630,4717300,7487.78,983,5211000,5301,-493700,abb
2024-01-19,933,7141900,7654.77,776,6059800,7809,1082100,abb
2024-01-18,927,3362800,3627.62,742,4300200,5795,-937400,abb
2024-01-17,770,2861700,3716.49,816,4953900,6071,-2092200,abb
2024-01-16,694,4116800,5931.99,708,3568900,5041,547900,abb
2024-01-15,723,3590500,4966.11,933,5746000,6159,-2155500,abb
2024-01-12,1129,4560500,4039.42,1182,6718100,5684,-2157600,abb
2024-01-11,1377,8124100,5899.85,2422,10258200,4235,-2134100,abb
2024-01-10,785,5128300,6532.87,1117,6114100,5474,-985800,abb
2024-01-09,795,2964100,3728.43,769,4502300,5855,-1538200,abb
2024-01-08,756,2157000,2853.17,930,4525500,4866,-2368500,abb
2024-01-05,781,2569800,3290.4,885,4312100,4872,-1742300,abb
2024-01-04,962,8105500,8425.68,1441,8479000,5884,-373500,abb
2024-01-03,603,11454900,18996.52,909,4450500,4896,7004400,abb
2024-01-02,1208,17340200,14354.47,1281,7733500,6037,9606700,abb
2024-09-12,48,32000,666.67,45,88900,1976,-56900,abc
2024-09-11,70,79300,1132.86,64,169000,2641,-89700,abc
2024-09-10,57,92800,1628.07,54,113400,2100,-20600,abc
2024-09-09,40,30800,770.0,51,82500,1618,-51700,abc
2024-09-06,62,56400,909.68,84,148500,1768,-92100,abc
2024-09-05,90,95700,1063.33,61,136000,2230,-40300,abc
2024-09-04,62,53500,862.9,40,41100,1028,12400,abc
2024-08-30,60,58800,980.0,66,73500,1114,-14700,abc
2024-08-29,71,69100,973.24,74,88300,1193,-19200,abc
2024-08-28,71,93100,1311.27,63,114600,1819,-21500,abc
2024-08-27,41,50400,1229.27,53,71700,1353,-21300,abc
2024-08-26,57,59500,1043.86,62,76000,1226,-16500,abc
2024-08-23,103,137000,1330.1,58,82700,1426,54300,abc
2024-08-22,89,62600,703.37,72,74300,1032,-11700,abc
2024-08-21,100,139000,1390.0,72,178800,2483,-39800,abc
2024-08-20,95,96000,1010.53,89,102200,1148,-6200,abc
2024-08-19,67,56500,843.28,78,81700,1047,-25200,abc
2024-08-16,66,72100,1092.42,70,84200,1203,-12100,abc
2024-08-15,98,97400,993.88,52,64700,1244,32700,abc
2024-08-14,94,70600,751.06,90,72000,800,-1400,abc
2024-08-13,81,126500,1561.73,77,108800,1413,17700,abc
2024-08-12,90,72900,810.0,57,64200,1126,8700,abc
2024-08-09,53,52700,994.34,64,73500,1148,-20800,abc
2024-08-08,104,142500,1370.19,97,112500,1160,30000,abc
2024-08-07,136,78900,580.15,55,93000,1691,-14100,abc
2024-08-06,224,183300,818.3,79,159900,2024,23400,abc
2024-08-05,121,68200,563.64,78,84000,1077,-15800,abc
2024-08-02,124,78800,635.48,62,47000,758,31800,abc
2024-08-01,197,132200,671.07,103,104300,1013,27900,abc
2024-07-31,96,64800,675.0,83,86500,1042,-21700,abc
2024-07-30,114,79400,696.49,80,117200,1465,-37800,abc
2024-07-29,104,73100,702.88,88,129700,1474,-56600,abc
2024-07-26,154,182700,1186.36,119,110700,930,72000,abc
2024-07-25,118,93600,793.22,68,64600,950,29000,abc
2024-07-24,99,75100,758.59,72,88000,1222,-12900,abc
2024-07-23,128,84200,657.81,87,97800,1124,-13600,abc
2024-07-22,108,57100,528.7,100,81600,816,-24500,abc
2024-07-19,182,116500,640.11,143,118300,827,-1800,abc
2024-07-18,192,173800,905.21,123,109800,893,64000,abc
2024-07-17,176,138000,784.09,174,161000,925,-23000,abc
2024-07-16,275,257300,935.64,182,254400,1398,2900,abc
2024-07-15,164,158200,964.63,171,215400,1260,-57200,abc
2024-07-12,282,251000,890.07,237,312700,1319,-61700,abc
2024-07-11,154,148100,961.69,147,196800,1339,-48700,abc
2024-07-10,290,273200,942.07,221,370800,1678,-97600,abc
2024-07-09,432,422100,977.08,256,403500,1576,18600,abc
2024-07-08,278,232900,837.77,185,289200,1563,-56300,abc
2024-07-05,420,390300,929.29,292,416600,1427,-26300,abc
2024-07-04,285,262800,922.11,193,217900,1129,44900,abc
2024-07-03,244,220400,903.28,147,258600,1759,-38200,abc
2024-07-02,236,196500,832.63,184,215700,1172,-19200,abc
2024-07-01,208,155400,747.12,147,233200,1586,-77800,abc
2024-06-28,443,347200,783.75,295,384200,1302,-37000,abc
2024-06-27,343,248000,723.03,247,321400,1301,-73400,abc
2024-06-26,427,286900,671.9,297,354500,1194,-67600,abc
2024-06-25,461,461800,1001.74,352,564600,1604,-102800,abc
2024-06-24,1173,1270600,1083.21,719,1250600,1739,20000,abc
2024-06-21,767,916600,1195.05,149,497200,3337,419400,abc
2024-06-20,737,1058100,1435.69,281,951600,3386,106500,abc
2024-06-19,247,202500,819.84,170,497800,2928,-295300,abc
2024-06-18,242,314000,1297.52,240,517800,2158,-203800,abc
2024-06-17,107,99600,930.84,98,168600,1720,-69000,abc
2024-06-14,178,132700,745.51,133,254700,1915,-122000,abc
2024-06-13,86,60400,702.33,87,169400,1947,-109000,abc
2024-06-12,199,126900,637.69,106,208700,1969,-81800,abc
2024-06-11,166,112300,676.51,110,254600,2315,-142300,abc
2024-06-10,253,190600,753.36,198,307700,1554,-117100,abc
2024-06-07,257,380000,1478.6,123,260700,2120,119300,abc
2024-06-06,188,249700,1328.19,104,90500,870,159200,abc
2024-06-05,125,109300,874.4,109,143600,1317,-34300,abc
2024-06-04,61,47500,778.69,62,67400,1087,-19900,abc
2024-06-03,85,59200,696.47,64,175400,2741,-116200,abc
2024-05-31,34,19000,558.82,33,87600,2655,-68600,abc
2024-05-30,37,19100,516.22,47,151200,3217,-132100,abc
2024-05-29,59,57100,967.8,67,144400,2155,-87300,abc
2024-05-28,39,37000,948.72,43,137900,3207,-100900,abc
2024-05-27,44,40700,925.0,43,150600,3502,-109900,abc
2024-05-24,48,42800,891.67,48,87300,1819,-44500,abc
2024-05-23,65,65200,1003.08,46,158200,3439,-93000,abc
2024-05-22,55,50900,925.45,49,120500,2459,-69600,abc
2024-05-21,84,85900,1022.62,54,114200,2115,-28300,abc
2024-05-20,39,24700,633.33,51,118800,2329,-94100,abc
2024-05-17,62,40000,645.16,47,67000,1426,-27000,abc
2024-05-16,35,19600,560.0,39,96100,2464,-76500,abc
2024-05-15,57,66900,1173.68,47,67300,1432,-400,abc
2024-05-14,62,37800,609.68,39,53200,1364,-15400,abc
2024-05-13,108,75900,702.78,48,148200,3088,-72300,abc
2024-05-10,43,59200,1376.74,35,53500,1529,5700,abc
2024-05-09,38,17500,460.53,30,47700,1590,-30200,abc
2024-05-08,46,16800,365.22,44,68000,1545,-51200,abc
2024-05-07,30,31300,1043.33,25,42500,1700,-11200,abc
2024-05-06,24,18200,758.33,19,36900,1942,-18700,abc
2024-05-03,28,30100,1075.0,17,44500,2618,-14400,abc
2024-05-02,36,28100,780.56,17,122700,7218,-94600,abc
2024-04-26,16,12500,781.25,23,52300,2274,-39800,abc
2024-04-25,18,10200,566.67,21,51500,2452,-41300,abc
2024-04-24,27,16800,622.22,21,50700,2414,-33900,abc
2024-04-23,16,13400,837.5,23,59200,2574,-45800,abc
2024-04-22,20,18600,930.0,25,64300,2572,-45700,abc
2024-04-19,21,12500,595.24,25,63500,2540,-51000,abc
2024-04-17,22,12800,581.82,26,65800,2531,-53000,abc
2024-04-16,29,27800,958.62,24,71200,2967,-43400,abc
2024-04-15,29,14000,482.76,28,34800,1243,-20800,abc
2024-04-12,40,31800,795.0,44,131500,2989,-99700,abc
2024-04-11,45,17400,386.67,35,53600,1531,-36200,abc
2024-04-10,33,30800,933.33,31,45800,1477,-15000,abc
2024-04-09,37,18700,505.41,34,120600,3547,-101900,abc
2024-04-08,22,15300,695.45,33,43700,1324,-28400,abc
2024-04-05,25,17800,712.0,31,52700,1700,-34900,abc
2024-04-04,33,18000,545.45,31,170000,5484,-152000,abc
2024-04-03,25,31800,1272.0,33,148200,4491,-116400,abc
2024-04-02,30,15800,526.67,33,172300,5221,-156500,abc
2024-04-01,18,20400,1133.33,37,122600,3314,-102200,abc
2024-03-29,24,18400,766.67,48,137600,2867,-119200,abc
2024-03-28,44,37300,847.73,57,196500,3447,-159200,abc
2024-03-27,30,27900,930.0,38,163900,4313,-136000,abc
2024-03-26,24,19200,800.0,50,65200,1304,-46000,abc
2024-03-25,32,21800,681.25,35,165200,4720,-143400,abc
2024-03-22,28,23000,821.43,46,83200,1809,-60200,abc
2024-03-21,22,17400,790.91,46,95800,2083,-78400,abc
2024-03-20,26,16800,646.15,49,107500,2194,-90700,abc
2024-03-19,27,21800,807.41,39,90100,2310,-68300,abc
2024-03-18,30,27200,906.67,65,102900,1583,-75700,abc
2024-03-15,29,60100,2072.41,28,87400,3121,-27300,abc
2024-03-14,26,27700,1065.38,20,25900,1295,1800,abc
2024-03-13,38,14300,376.32,20,154900,7745,-140600,abc
2024-03-12,36,19200,533.33,51,81300,1594,-62100,abc
2024-03-11,37,32800,886.49,40,112900,2822,-80100,abc
2024-03-08,31,17200,554.84,29,64900,2238,-47700,abc
2024-03-07,28,16400,585.71,29,79400,2738,-63000,abc
2024-03-06,44,22900,520.45,34,88300,2597,-65400,abc
2024-03-05,32,20300,634.38,28,67700,2418,-47400,abc
2024-03-04,47,28800,612.77,37,88500,2392,-59700,abc
2024-03-01,42,25800,614.29,33,76800,2327,-51000,abc
2024-02-29,41,38900,948.78,26,69400,2669,-30500,abc
2024-02-28,50,36300,726.0,28,80200,2864,-43900,abc
2024-02-27,24,15700,654.17,40,103400,2585,-87700,abc
2024-02-26,29,24200,834.48,28,57200,2043,-33000,abc
2024-02-23,30,19000,633.33,42,171000,4071,-152000,abc
2024-02-22,17,14700,864.71,37,179900,4862,-165200,abc
2024-02-21,30,16800,560.0,53,75700,1428,-58900,abc
2024-02-20,38,39900,1050.0,48,81800,1704,-41900,abc
2024-02-19,47,23700,504.26,27,63800,2363,-40100,abc
2024-02-16,35,17400,497.14,20,148700,7435,-131300,abc
2024-02-15,30,23200,773.33,28,59700,2132,-36500,abc
2024-02-07,32,21100,659.38,25,41500,1660,-20400,abc
2024-02-06,45,28500,633.33,27,49300,1826,-20800,abc
2024-02-05,32,19000,593.75,32,83100,2597,-64100,abc
2024-02-02,37,22700,613.51,29,60400,2083,-37700,abc
2024-02-01,21,18800,895.24,26,36700,1412,-17900,abc
2024-01-31,19,15100,794.74,36,71700,1992,-56600,abc
2024-01-30,31,26800,864.52,37,56300,1522,-29500,abc
2024-01-29,46,27800,604.35,34,57900,1703,-30100,abc
2024-01-26,42,48800,1161.9,32,94200,2944,-45400,abc
2024-01-25,27,47200,1748.15,34,59600,1753,-12400,abc
2024-01-24,33,45700,1384.85,35,59500,1700,-13800,abc
2024-01-23,30,49100,1636.67,38,45500,1197,3600,abc
2024-01-22,32,49100,1534.38,26,39800,1531,9300,abc
2024-01-19,63,60300,957.14,30,109200,3640,-48900,abc
2024-01-18,35,56100,1602.86,51,136600,2678,-80500,abc
2024-01-17,23,37300,1621.74,28,62400,2229,-25100,abc
2024-01-16,17,31700,1864.71,24,61700,2571,-30000,abc
2024-01-15,32,29700,928.12,34,109900,3232,-80200,abc
2024-01-12,21,26700,1271.43,35,52900,1511,-26200,abc
2024-01-11,18,28100,1561.11,54,67500,1250,-39400,abc
2024-01-10,20,26200,1310.0,57,85200,1495,-59000,abc
2024-01-09,21,26800,1276.19,26,47900,1842,-21100,abc
2024-01-08,19,25200,1326.32,35,57900,1654,-32700,abc
2024-01-05,35,51600,1474.29,50,78300,1566,-26700,abc
2024-01-04,44,50000,1136.36,31,65300,2106,-15300,abc
2024-01-03,28,30900,1103.57,25,58600,2344,-27700,abc
2024-01-02,32,38100,1190.62,27,52000,1926,-13900,abc
2024-09-12,191,157700,825.65,136,252200,1854,-94500,abi
2024-09-11,235,266300,1133.19,147,410400,2792,-144100,abi
2024-09-10,46,23300,506.52,86,110600,1286,-87300,abi
2024-09-09,62,43100,695.16,95,119400,1257,-76300,abi
2024-09-06,55,66900,1216.36,90,94500,1050,-27600,abi
2024-09-05,57,72200,1266.67,98,135500,1383,-63300,abi
2024-09-04,35,40800,1165.71,95,101300,1066,-60500,abi
2024-08-30,55,46800,850.91,91,137600,1512,-90800,abi
2024-08-29,71,59000,830.99,78,91600,1174,-32600,abi
2024-08-28,59,51000,864.41,99,104700,1058,-53700,abi
2024-08-27,52,82500,1586.54,114,139500,1224,-57000,abi
2024-08-26,46,62600,1360.87,106,120800,1140,-58200,abi
2024-08-23,52,62700,1205.77,107,166300,1554,-103600,abi
2024-08-22,52,141800,2726.92,121,185800,1536,-44000,abi
2024-08-21,51,97000,1901.96,108,169700,1571,-72700,abi
2024-08-20,70,135500,1935.71,121,126200,1043,9300,abi
2024-08-19,70,185300,2647.14,99,182700,1845,2600,abi
2024-08-16,82,71200,868.29,95,153900,1620,-82700,abi
2024-08-15,59,50300,852.54,116,127300,1097,-77000,abi
2024-08-14,78,217100,2783.33,122,192000,1574,25100,abi
2024-08-13,50,95200,1904.0,96,129200,1346,-34000,abi
2024-08-12,127,212400,1672.44,161,204500,1270,7900,abi
2024-08-09,125,55300,442.4,84,71000,845,-15700,abi
2024-08-08,139,88600,637.41,81,67300,831,21300,abi
2024-08-07,139,104300,750.36,79,119500,1513,-15200,abi
2024-08-06,208,99500,478.37,117,92300,789,7200,abi
2024-08-05,212,106700,503.3,163,163800,1005,-57100,abi
2024-08-02,234,189800,811.11,148,207000,1399,-17200,abi
2024-08-01,184,129800,705.43,182,220600,1212,-90800,abi
2024-07-31,69,41100,595.65,118,138000,1169,-96900,abi
2024-07-30,77,38600,501.3,120,158000,1317,-119400,abi
2024-07-29,72,60500,840.28,92,130800,1422,-70300,abi
2024-07-26,91,69600,764.84,140,200800,1434,-131200,abi
2024-07-25,91,52800,580.22,122,140400,1151,-87600,abi
2024-07-24,180,109200,606.67,162,141800,875,-32600,abi
2024-07-23,168,113900,677.98,153,201100,1314,-87200,abi
2024-07-22,246,158600,644.72,175,205300,1173,-46700,abi
2024-07-19,163,133800,820.86,149,212300,1425,-78500,abi
2024-07-18,140,103300,737.86,143,156000,1091,-52700,abi
2024-07-17,155,158200,1020.65,202,259600,1285,-101400,abi
2024-07-16,211,220700,1045.97,174,305800,1757,-85100,abi
2024-07-15,137,96900,707.3,155,215500,1390,-118600,abi
2024-07-12,193,206200,1068.39,166,286200,1724,-80000,abi
2024-07-11,162,102600,633.33,158,229700,1454,-127100,abi
2024-07-10,152,150600,990.79,168,273300,1627,-122700,abi
2024-07-09,234,189500,809.83,247,346200,1402,-156700,abi
2024-07-08,122,103400,847.54,143,187000,1308,-83600,abi
2024-07-05,129,90100,698.45,157,263600,1679,-173500,abi
2024-07-04,214,280600,1311.21,155,376200,2427,-95600,abi
2024-07-03,155,245300,1582.58,126,284100,2255,-38800,abi
2024-07-02,115,101500,882.61,160,313100,1957,-211600,abi
2024-07-01,171,165000,964.91,179,357600,1998,-192600,abi
2024-06-28,261,241800,926.44,270,452700,1677,-210900,abi
2024-06-27,246,262100,1065.45,200,406000,2030,-143900,abi
2024-06-26,245,251900,1028.16,193,318000,1648,-66100,abi
2024-06-25,223,244400,1095.96,241,350200,1453,-105800,abi
2024-06-24,548,656600,1198.18,362,787700,2176,-131100,abi
2024-06-21,262,324700,1239.31,275,454800,1654,-130100,abi
2024-06-20,200,256800,1284.0,157,342800,2183,-86000,abi
2024-06-19,148,100400,678.38,121,217700,1799,-117300,abi
2024-06-18,123,99700,810.57,113,182400,1614,-82700,abi
2024-06-17,197,189600,962.44,135,281200,2083,-91600,abi
2024-06-14,141,114800,814.18,182,350700,1927,-235900,abi
2024-06-13,147,158700,1079.59,175,306100,1749,-147400,abi
2024-06-12,260,448700,1725.77,248,484100,1952,-35400,abi
2024-06-11,98,153400,1565.31,154,287600,1868,-134200,abi
2024-06-10,116,118300,1019.83,167,256600,1537,-138300,abi
2024-06-07,136,140600,1033.82,163,343100,2105,-202500,abi
2024-06-06,150,194100,1294.0,235,349900,1489,-155800,abi
2024-06-05,196,374000,1908.16,225,367100,1632,6900,abi
2024-06-04,99,74300,750.51,106,144000,1358,-69700,abi
2024-06-03,238,180300,757.56,143,242400,1695,-62100,abi
2024-05-31,92,83500,907.61,144,249000,1729,-165500,abi
2024-05-30,129,73700,571.32,176,232600,1322,-158900,abi
2024-05-29,155,229000,1477.42,240,416200,1734,-187200,abi
2024-05-28,132,412300,3123.48,219,335000,1530,77300,abi
2024-05-27,180,471500,2619.44,283,453800,1604,17700,abi
2024-05-24,200,175800,879.0,237,356000,1502,-180200,abi
2024-05-23,214,378700,1769.63,192,273900,1427,104800,abi
2024-05-22,168,213200,1269.05,192,409300,2132,-196100,abi
2024-05-21,188,206100,1096.28,144,264300,1835,-58200,abi
2024-05-20,222,274700,1237.39,196,395100,2016,-120400,abi
2024-05-17,91,48900,537.36,87,99000,1138,-50100,abi
2024-05-16,125,96300,770.4,75,145500,1940,-49200,abi
2024-05-15,172,91800,533.72,99,133400,1347,-41600,abi
2024-05-14,75,31300,417.33,69,109200,1583,-77900,abi
2024-05-13,107,61000,570.09,103,184300,1789,-123300,abi
2024-05-10,84,33200,395.24,79,140700,1781,-107500,abi
2024-05-09,62,39300,633.87,69,66800,968,-27500,abi
2024-05-08,71,67700,953.52,80,100500,1256,-32800,abi
2024-05-07,81,63000,777.78,77,103700,1347,-40700,abi
2024-05-06,88,97500,1107.95,114,241400,2118,-143900,abi
2024-05-03,61,33700,552.46,66,105600,1600,-71900,abi
2024-05-02,71,39200,552.11,79,97800,1238,-58600,abi
2024-04-26,45,26100,580.0,98,367700,3752,-341600,abi
2024-04-25,52,25400,488.46,70,111200,1589,-85800,abi
2024-04-24,63,111600,1771.43,76,172200,2266,-60600,abi
2024-04-23,46,46300,1006.52,59,164500,2788,-118200,abi
2024-04-22,70,51300,732.86,59,177700,3012,-126400,abi
2024-04-19,185,136200,736.22,85,191900,2258,-55700,abi
2024-04-17,111,92700,835.14,86,133700,1555,-41000,abi
2024-04-16,226,136600,604.42,159,235100,1479,-98500,abi
2024-04-15,121,80000,661.16,149,251700,1689,-171700,abi
2024-04-12,85,76200,896.47,120,228900,1908,-152700,abi
2024-04-11,94,103000,1095.74,123,177000,1439,-74000,abi
2024-04-10,96,82500,859.38,129,202300,1568,-119800,abi
2024-04-09,123,110100,895.12,128,183700,1435,-73600,abi
2024-04-08,53,44000,830.19,127,185300,1459,-141300,abi
2024-04-05,96,101300,1055.21,148,205400,1388,-104100,abi
2024-04-04,96,57400,597.92,157,344200,2192,-286800,abi
2024-04-03,89,97900,1100.0,130,230800,1775,-132900,abi
2024-04-02,164,150800,919.51,162,333500,2059,-182700,abi
2024-04-01,132,143800,1089.39,147,310500,2112,-166700,abi
2024-03-29,180,280800,1560.0,207,583300,2818,-302500,abi
2024-03-28,68,52000,764.71,137,364100,2658,-312100,abi
2024-03-27,72,51600,716.67,131,374200,2856,-322600,abi
2024-03-26,79,62900,796.2,158,328300,2078,-265400,abi
2024-03-25,94,131000,1393.62,130,282700,2175,-151700,abi
2024-03-22,184,420300,2284.24,189,503000,2661,-82700,abi
2024-03-21,109,115000,1055.05,158,294300,1863,-179300,abi
2024-03-20,102,95800,939.22,149,314100,2108,-218300,abi
2024-03-19,92,62900,683.7,139,289800,2085,-226900,abi
2024-03-18,168,115200,685.71,155,361600,2333,-246400,abi
2024-03-15,129,152000,1178.29,184,289300,1572,-137300,abi
2024-03-14,144,173700,1206.25,162,428800,2647,-255100,abi
2024-03-13,93,125700,1351.61,175,289000,1651,-163300,abi
2024-03-12,165,112100,679.39,157,275100,1752,-163000,abi
2024-03-11,102,70100,687.25,143,219600,1536,-149500,abi
2024-03-08,129,66600,516.28,143,276200,1931,-209600,abi
2024-03-07,148,85600,578.38,152,256700,1689,-171100,abi
2024-03-06,118,74200,628.81,131,227000,1733,-152800,abi
2024-03-05,114,73500,644.74,138,243500,1764,-170000,abi
2024-03-04,138,131400,952.17,147,258400,1758,-127000,abi
2024-03-01,138,187100,1355.8,148,248300,1678,-61200,abi
2024-02-29,182,145700,800.55,176,343100,1949,-197400,abi
2024-02-28,86,50800,590.7,146,209000,1432,-158200,abi
2024-02-27,84,44400,528.57,138,197800,1433,-153400,abi
2024-02-26,86,64600,751.16,135,153700,1139,-89100,abi
2024-02-23,173,152200,879.77,169,284500,1683,-132300,abi
2024-02-22,164,148600,906.1,138,238200,1726,-89600,abi
2024-02-21,163,203700,1249.69,167,325200,1947,-121500,abi
2024-02-20,158,223700,1415.82,187,327000,1749,-103300,abi
2024-02-19,152,148500,976.97,169,232800,1378,-84300,abi
2024-02-16,137,216500,1580.29,166,272000,1639,-55500,abi
2024-02-15,156,185700,1190.38,175,362000,2069,-176300,abi
2024-02-07,81,114000,1407.41,148,267600,1808,-153600,abi
2024-02-06,114,113600,996.49,158,242200,1533,-128600,abi
2024-02-05,116,119100,1026.72,128,224900,1757,-105800,abi
2024-02-02,127,218100,1717.32,160,409800,2561,-191700,abi
2024-02-01,61,103100,1690.16,193,534700,2770,-431600,abi
2024-01-31,113,408000,3610.62,196,490100,2501,-82100,abi
2024-01-30,70,193300,2761.43,103,170500,1655,22800,abi
2024-01-29,70,171800,2454.29,136,273100,2008,-101300,abi
2024-01-26,84,202300,2408.33,162,229900,1419,-27600,abi
2024-01-25,81,253900,3134.57,148,250800,1695,3100,abi
2024-01-24,111,590600,5320.72,167,412400,2469,178200,abi
2024-01-23,94,223700,2379.79,96,161800,1685,61900,abi
2024-01-22,118,120900,1024.58,98,159400,1627,-38500,abi
2024-01-19,76,65200,857.89,107,165700,1549,-100500,abi
2024-01-18,97,94800,977.32,119,268700,2258,-173900,abi
2024-01-17,95,113000,1189.47,97,171400,1767,-58400,abi
2024-01-16,102,134200,1315.69,85,173600,2042,-39400,abi
2024-01-15,57,42700,749.12,96,143400,1494,-100700,abi
2024-01-12,83,108000,1301.2,122,123100,1009,-15100,abi
2024-01-11,88,114700,1303.41,101,101000,1000,13700,abi
2024-01-10,104,62700,602.88,62,112400,1813,-49700,abi
2024-01-09,104,95000,913.46,75,121300,1617,-26300,abi
2024-01-08,166,413300,2489.76,103,238600,2317,174700,abi
2024-01-05,152,339900,2236.18,77,176100,2287,163800,abi
2024-01-04,85,236600,2783.53,67,119400,1782,117200,abi
2024-01-03,114,179900,1578.07,68,194700,2863,-14800,abi
2024-01-02,107,164100,1533.64,83,139700,1683,24400,abi
2024-09-12,319,1112400,3487.15,313,1098200,3509,14200,abs
2024-09-11,234,463600,1981.2,155,392700,2534,70900,abs
2024-09-10,276,617600,2237.68,157,451600,2876,166000,abs
2024-09-09,236,455500,1930.08,125,371100,2969,84400,abs
2024-09-06,233,349800,1501.29,132,285300,2161,64500,abs
2024-09-05,206,345300,1676.21,161,320800,1993,24500,abs
2024-09-04,281,574600,2044.84,137,434200,3169,140400,abs
2024-08-30,288,413700,1436.46,132,630000,4773,-216300,abs
2024-08-29,187,504600,2698.4,234,611000,2611,-106400,abs
2024-08-28,312,923500,2959.94,462,860800,1863,62700,abs
2024-08-27,220,484900,2204.09,191,412100,2158,72800,abs
2024-08-26,440,849600,1930.91,164,592500,3613,257100,abs
2024-08-23,257,362400,1410.12,192,445700,2321,-83300,abs
2024-08-22,290,537900,1854.83,206,536500,2604,1400,abs
2024-08-21,250,405900,1623.6,191,548800,2873,-142900,abs
2024-08-20,456,900900,1975.66,223,984700,4416,-83800,abs
2024-08-19,254,293800,1156.69,195,683400,3505,-389600,abs
2024-08-16,298,1068900,3586.91,310,902800,2912,166100,abs
2024-08-15,221,475900,2153.39,210,484500,2307,-8600,abs
2024-08-14,221,284500,1287.33,130,368200,2832,-83700,abs
2024-08-13,210,275100,1310.0,100,460700,4607,-185600,abs
2024-08-12,159,280400,1763.52,151,394500,2613,-114100,abs
2024-08-08,208,461500,2218.75,167,424900,2544,36600,abs
2024-08-07,208,280800,1350.0,142,371100,2613,-90300,abs
2024-08-06,388,727700,1875.52,227,803400,3539,-75700,abs
2024-08-05,396,545900,1378.54,216,840800,3893,-294900,abs
2024-08-02,428,686100,1603.04,210,485900,2314,200200,abs
2024-08-01,407,768900,1889.19,197,711700,3613,57200,abs
2024-07-31,261,329500,1262.45,157,533000,3395,-203500,abs
2024-07-30,276,457900,1659.06,202,592600,2934,-134700,abs
2024-07-29,343,448100,1306.41,164,443600,2705,4500,abs
2024-07-26,236,651300,2759.75,268,338000,1261,313300,abs
2024-07-25,323,550300,1703.72,153,333600,2180,216700,abs
2024-07-24,501,893600,1783.63,212,514200,2425,379400,abs
2024-07-22,523,959500,1834.61,240,1003700,4182,-44200,abs
2024-07-19,329,684800,2081.46,189,729400,3859,-44600,abs
2024-07-18,314,496700,1581.85,270,571500,2117,-74800,abs
2024-07-17,362,485100,1340.06,258,862800,3344,-377700,abs
2024-07-16,318,554500,1743.71,280,567300,2026,-12800,abs
2024-07-15,319,438100,1373.35,175,1054000,6023,-615900,abs
2024-07-12,248,456200,1839.52,214,518800,2424,-62600,abs
2024-07-11,256,509400,1989.84,248,482800,1947,26600,abs
2024-07-10,345,545100,1580.0,187,503100,2690,42000,abs
2024-07-09,279,432200,1549.1,180,571300,3174,-139100,abs
2024-07-08,294,468300,1592.86,207,395100,1909,73200,abs
2024-07-05,399,623900,1563.66,192,668700,3483,-44800,abs
2024-07-04,202,448800,2221.78,270,735100,2723,-286300,abs
2024-07-03,247,441900,1789.07,161,457100,2839,-15200,abs
2024-07-02,204,361400,1771.57,187,443000,2369,-81600,abs
2024-07-01,214,417500,1950.93,204,359100,1760,58400,abs
2024-06-28,349,578200,1656.73,173,500800,2895,77400,abs
2024-06-27,521,718400,1378.89,197,709300,3601,9100,abs
2024-06-26,420,735900,1752.14,197,785900,3989,-50000,abs
2024-06-25,267,506200,1895.88,176,476300,2706,29900,abs
2024-06-24,317,918700,2898.11,284,714100,2514,204600,abs
2024-06-21,336,614200,1827.98,223,502000,2251,112200,abs
2024-06-20,422,1057400,2505.69,226,781400,3458,276000,abs
2024-06-19,416,833900,2004.57,306,886800,2898,-52900,abs
2024-06-18,345,724900,2101.16,239,674000,2820,50900,abs
2024-06-17,448,1028900,2296.65,291,928800,3192,100100,abs
2024-06-14,440,1064200,2418.64,328,988800,3015,75400,abs
2024-06-13,496,1036400,2089.52,263,763100,2902,273300,abs
2024-06-12,377,729600,1935.28,308,1062000,3448,-332400,abs
2024-06-11,368,954300,2593.21,454,1227900,2705,-273600,abs
2024-06-10,474,961800,2029.11,539,1499500,2782,-537700,abs
2024-06-07,525,1314000,2502.86,671,1710500,2549,-396500,abs
2024-06-06,796,2426700,3048.62,1040,2626200,2525,-199500,abs
2024-06-05,459,853700,1859.91,299,1092800,3655,-239100,abs
2024-06-04,364,794200,2181.87,245,951300,3883,-157100,abs
2024-06-03,358,800500,2236.03,263,953800,3627,-153300,abs
2024-05-31,406,818900,2017.0,318,952800,2996,-133900,abs
2024-05-30,390,811100,2079.74,316,1214500,3843,-403400,abs
2024-05-29,626,1502600,2400.32,533,1301800,2442,200800,abs
2024-05-28,387,1280600,3309.04,247,807800,3270,472800,abs
2024-05-27,381,875700,2298.43,236,648700,2749,227000,abs
2024-05-24,464,1023100,2204.96,262,1132400,4322,-109300,abs
2024-05-23,382,879600,2302.62,256,1001500,3912,-121900,abs
2024-05-22,403,863500,2142.68,420,1086100,2586,-222600,abs
2024-05-21,321,916500,2855.14,322,921900,2863,-5400,abs
2024-05-20,400,964600,2411.5,360,930700,2585,33900,abs
2024-05-17,423,800300,1891.96,315,1730600,5494,-930300,abs
2024-05-16,332,808800,2436.14,286,751700,2628,57100,abs
2024-05-15,548,1281800,2339.05,299,1027400,3436,254400,abs
2024-05-14,291,546000,1876.29,251,980800,3908,-434800,abs
2024-05-13,445,1360700,3057.75,505,1512600,2995,-151900,abs
2024-05-10,430,1225700,2850.47,559,1093100,1955,132600,abs
2024-05-09,298,471100,1580.87,207,414100,2000,57000,abs
2024-05-08,402,856900,2131.59,285,599300,2103,257600,abs
2024-05-07,294,448400,1525.17,252,611000,2425,-162600,abs
2024-05-06,283,549800,1942.76,219,472100,2156,77700,abs
2024-05-03,319,649900,2037.3,170,502200,2954,147700,abs
2024-05-02,219,485100,2215.07,163,351400,2156,133700,abs
2024-04-26,313,525300,1678.27,196,484300,2471,41000,abs
2024-04-25,289,577100,1996.89,167,419200,2510,157900,abs
2024-04-24,254,482300,1898.82,220,430900,1959,51400,abs
2024-04-23,379,525100,1385.49,204,732100,3589,-207000,abs
2024-04-22,324,588900,1817.59,263,663200,2522,-74300,abs
2024-04-19,657,1256100,1911.87,287,1171200,4081,84900,abs
2024-04-17,473,790600,1671.46,275,788000,2865,2600,abs
2024-04-16,848,1694900,1998.7,410,1878400,4581,-183500,abs
2024-04-15,484,1029700,2127.48,325,1289900,3969,-260200,abs
2024-04-12,369,1152300,3122.76,408,1407300,3449,-255000,abs
2024-04-11,460,1243800,2703.91,437,886800,2029,357000,abs
2024-04-10,476,630500,1324.58,231,723200,3131,-92700,abs
2024-04-09,750,1377600,1836.8,498,1319100,2649,58500,abs
2024-04-08,587,900300,1533.73,251,989300,3941,-89000,abs
2024-04-05,581,1016500,1749.57,324,1083400,3344,-66900,abs
2024-04-04,417,700300,1679.38,557,1541700,2768,-841400,abs
2024-04-03,920,2394000,2602.17,871,2296600,2637,97400,abs
2024-04-02,647,1015900,1570.17,307,1079700,3517,-63800,abs
2024-04-01,452,912700,2019.25,350,1763900,5040,-851200,abs
2024-03-29,444,778100,1752.48,294,1179900,4013,-401800,abs
2024-03-28,386,566400,1467.36,322,1354500,4207,-788100,abs
2024-03-27,330,567100,1718.48,345,1100600,3190,-533500,abs
2024-03-26,456,753000,1651.32,257,1117100,4347,-364100,abs
2024-03-25,415,774200,1865.54,370,1418100,3833,-643900,abs
2024-03-22,513,838200,1633.92,567,1395000,2460,-556800,abs
2024-03-21,478,947200,1981.59,404,1428000,3535,-480800,abs
2024-03-20,424,739800,1744.81,388,1187600,3061,-447800,abs
2024-03-19,552,692200,1253.99,340,1022800,3008,-330600,abs
2024-03-18,1022,1592000,1557.73,495,1565500,3163,26500,abs
2024-03-15,721,1072400,1487.38,305,1237000,4056,-164600,abs
2024-03-14,430,839200,1951.63,397,1250500,3150,-411300,abs
2024-03-13,579,1153200,1991.71,345,1212300,3514,-59100,abs
2024-03-12,714,1015200,1421.85,378,1544400,4086,-529200,abs
2024-03-11,634,1024800,1616.4,429,1392700,3246,-367900,abs
2024-03-08,921,1400400,1520.52,445,2127600,4781,-727200,abs
2024-03-07,552,1095000,1983.7,430,1418300,3298,-323300,abs
2024-03-06,732,1717200,2345.9,833,2243900,2694,-526700,abs
2024-03-05,474,721000,1521.1,409,1161300,2839,-440300,abs
2024-03-04,690,1617600,2344.35,479,1734600,3621,-117000,abs
2024-03-01,462,854400,1849.35,342,1182800,3458,-328400,abs
2024-02-29,608,1289700,2121.22,435,1735400,3989,-445700,abs
2024-02-28,877,1631600,1860.43,433,1734300,4005,-102700,abs
2024-02-27,582,1000200,1718.56,414,1243200,3003,-243000,abs
2024-02-26,541,821000,1517.56,313,922000,2946,-101000,abs
2024-02-23,879,2098600,2387.49,1027,2937300,2860,-838700,abs
2024-02-22,632,2184400,3456.33,905,2735500,3023,-551100,abs
2024-02-21,487,1565600,3214.78,386,1155900,2995,409700,abs
2024-02-20,408,1008900,2472.79,579,1607500,2776,-598600,abs
2024-02-19,497,1395700,2808.25,701,1732300,2471,-336600,abs
2024-02-16,273,669500,2452.38,363,1090600,3004,-421100,abs
2024-02-15,355,613300,1727.61,277,657300,2373,-44000,abs
2024-02-07,0,0,0.0,0,0,0,0,abs
2024-02-06,368,752900,2045.92,299,875200,2927,-122300,abs
2024-02-05,507,814500,1606.51,361,1310800,3631,-496300,abs
2024-02-02,422,824300,1953.32,367,1305900,3558,-481600,abs
2024-02-01,370,870800,2353.51,313,1230000,3930,-359200,abs
2024-01-31,592,1374700,2322.13,410,1877900,4580,-503200,abs
2024-01-30,414,2034700,4914.73,475,1968300,4144,66400,abs
2024-01-29,303,1654600,5460.73,441,1757900,3986,-103300,abs
2024-01-26,387,948800,2451.68,386,1002600,2597,-53800,abs
2024-01-25,304,630200,2073.03,350,988900,2825,-358700,abs
2024-01-24,477,984000,2062.89,342,1102300,3223,-118300,abs
2024-01-23,446,955700,2142.83,358,1081800,3022,-126100,abs
2024-01-22,794,1494300,1881.99,439,1700500,3874,-206200,abs
2024-01-19,553,1564400,2828.93,616,1610400,2614,-46000,abs
2024-01-18,388,684800,1764.95,330,1186600,3596,-501800,abs
2024-01-17,401,765900,1909.98,373,1070000,2869,-304100,abs
2024-01-16,544,967700,1778.86,339,974200,2874,-6500,abs
2024-01-15,504,1118500,2219.25,380,1342600,3533,-224100,abs
2024-01-12,785,1924300,2451.34,647,1642500,2539,281800,abs
2024-01-11,684,1868500,2731.73,551,1606500,2916,262000,abs
2024-01-10,0,0,0.0,0,0,0,0,abs
2024-01-09,954,1688600,1770.02,472,1935900,4101,-247300,abs
2024-01-08,530,1061100,2002.08,468,1181900,2525,-120800,abs
2024-01-05,879,1620400,1843.46,651,1822700,2800,-202300,abs
2024-01-04,1331,3113600,2339.29,1144,3944300,3448,-830700,abs
2024-01-03,1058,3777000,3569.94,1451,4755900,3278,-978900,abs
2024-01-02,1440,6140400,4264.17,1324,4060500,3067,2079900,abs
2024-09-12,6,700,116.67,10,4800,480,-4100,abt
2024-09-11,6,800,133.33,9,5800,644,-5000,abt
2024-09-10,9,1200,133.33,13,6400,492,-5200,abt
2024-09-09,10,1800,180.0,10,8400,840,-6600,abt
2024-09-06,5,10600,2120.0,10,4200,420,6400,abt
2024-09-05,11,2500,227.27,14,5500,393,-3000,abt
2024-09-04,8,1900,237.5,12,2900,242,-1000,abt
2024-08-30,14,4900,350.0,17,4900,288,0,abt
2024-08-29,14,3100,221.43,14,5800,414,-2700,abt
2024-08-28,10,4200,420.0,19,8600,453,-4400,abt
2024-08-27,13,3400,261.54,17,8300,488,-4900,abt
2024-08-26,5,1200,240.0,12,3300,275,-2100,abt
2024-08-23,10,12800,1280.0,15,9100,607,3700,abt
2024-08-22,23,61200,2660.87,17,30500,1794,30700,abt
2024-08-21,16,37800,2362.5,15,6600,440,31200,abt
2024-08-20,8,2200,275.0,9,4400,489,-2200,abt
2024-08-19,5,11200,2240.0,15,9500,633,1700,abt
2024-08-16,9,21400,2377.78,7,10800,1543,10600,abt
2024-08-15,6,18800,3133.33,16,26400,1650,-7600,abt
2024-08-14,7,8700,1242.86,14,4300,307,4400,abt
2024-08-13,17,28500,1676.47,21,22300,1062,6200,abt
2024-08-12,5,2300,460.0,6,600,100,1700,abt
2024-08-08,2,500,250.0,6,1600,267,-1100,abt
2024-08-07,1,200,200.0,11,3300,300,-3100,abt
2024-08-06,7,2700,385.71,8,2300,288,400,abt
2024-08-05,11,5000,454.55,7,2100,300,2900,abt
2024-08-02,12,5000,416.67,16,5700,356,-700,abt
2024-08-01,6,1600,266.67,14,7600,543,-6000,abt
2024-07-31,12,4800,400.0,17,5600,329,-800,abt
2024-07-30,15,12100,806.67,15,8900,593,3200,abt
2024-07-29,12,5700,475.0,10,2700,270,3000,abt
2024-07-26,29,13800,475.86,26,22800,877,-9000,abt
2024-07-25,22,7400,336.36,21,7300,348,100,abt
2024-07-24,2,1100,550.0,4,400,100,700,abt
2024-07-22,9,5300,588.89,10,2000,200,3300,abt
2024-07-19,18,7300,405.56,13,3100,238,4200,abt
2024-07-18,14,15300,1092.86,18,2400,133,12900,abt
2024-07-17,19,16400,863.16,7,800,114,15600,abt
2024-07-16,18,22200,1233.33,12,5900,492,16300,abt
2024-07-15,17,10100,594.12,19,4400,232,5700,abt
2024-07-12,12,7900,658.33,14,6000,429,1900,abt
2024-07-11,21,26100,1242.86,19,24000,1263,2100,abt
2024-07-10,7,2500,357.14,6,4500,750,-2000,abt
2024-07-09,14,8900,635.71,5,1300,260,7600,abt
2024-07-08,26,12900,496.15,17,8500,500,4400,abt
2024-07-05,11,8700,790.91,7,1300,186,7400,abt
2024-07-04,18,16400,911.11,9,3500,389,12900,abt
2024-07-03,26,27200,1046.15,26,16000,615,11200,abt
2024-07-02,20,14400,720.0,7,5300,757,9100,abt
2024-07-01,24,12400,516.67,6,1500,250,10900,abt
2024-06-28,18,8700,483.33,16,11800,738,-3100,abt
2024-06-27,15,5100,340.0,17,4500,265,600,abt
2024-06-26,19,15800,831.58,29,23000,793,-7200,abt
2024-06-25,12,5500,458.33,16,12000,750,-6500,abt
2024-06-24,15,12100,806.67,15,8600,573,3500,abt
2024-06-21,39,23500,602.56,14,13600,971,9900,abt
2024-06-20,7,6400,914.29,7,8500,1214,-2100,abt
2024-06-19,18,11000,611.11,10,9000,900,2000,abt
2024-06-18,19,4900,257.89,16,7700,481,-2800,abt
2024-06-17,12,5700,475.0,15,4100,273,1600,abt
2024-06-14,20,9400,470.0,20,6200,310,3200,abt
2024-06-13,11,5000,454.55,12,9100,758,-4100,abt
2024-06-12,13,7500,576.92,9,8600,956,-1100,abt
2024-06-11,8,5000,625.0,15,6400,427,-1400,abt
2024-06-10,18,6400,355.56,20,4100,205,2300,abt
2024-06-07,46,18200,395.65,14,3400,243,14800,abt
2024-06-06,20,7000,350.0,9,8300,922,-1300,abt
2024-06-05,20,6900,345.0,13,7500,577,-600,abt
2024-06-04,20,6600,330.0,18,8400,467,-1800,abt
2024-06-03,13,3500,269.23,6,1300,217,2200,abt
2024-05-31,7,1700,242.86,7,1700,243,0,abt
2024-05-30,7,4700,671.43,9,3900,433,800,abt
2024-05-29,18,11700,650.0,7,3400,486,8300,abt
2024-05-28,12,9200,766.67,17,7200,424,2000,abt
2024-05-27,19,15500,815.79,16,7700,481,7800,abt
2024-05-24,15,13800,920.0,19,15900,837,-2100,abt
2024-05-23,13,8800,676.92,14,4000,286,4800,abt
2024-05-22,24,17400,725.0,23,9300,404,8100,abt
2024-05-21,21,11800,561.9,5,900,180,10900,abt
2024-05-20,29,14000,482.76,14,6800,486,7200,abt
2024-05-17,11,8400,763.64,11,6000,545,2400,abt
2024-05-16,13,3300,253.85,14,7600,543,-4300,abt
2024-05-15,21,23700,1128.57,20,17900,895,5800,abt
2024-05-14,14,6400,457.14,5,1800,360,4600,abt
2024-05-13,24,19200,800.0,14,9400,671,9800,abt
2024-05-10,16,11400,712.5,13,6000,462,5400,abt
2024-05-09,27,19700,729.63,23,13100,570,6600,abt
2024-05-08,13,8300,638.46,11,6700,609,1600,abt
2024-05-07,16,9200,575.0,13,7600,585,1600,abt
2024-05-06,22,13200,600.0,15,5200,347,8000,abt
2024-05-03,20,5600,280.0,11,4900,445,700,abt
2024-05-02,16,6400,400.0,8,3300,412,3100,abt
2024-04-26,11,5200,472.73,7,3500,500,1700,abt
2024-04-25,13,6700,515.38,16,7400,462,-700,abt
2024-04-24,15,30900,2060.0,31,16700,539,14200,abt
2024-04-23,7,3000,428.57,19,5000,263,-2000,abt
2024-04-22,15,8200,546.67,20,5700,285,2500,abt
2024-04-19,14,4500,321.43,20,3700,185,800,abt
2024-04-17,11,5000,454.55,16,10500,656,-5500,abt
2024-04-16,20,6300,315.0,22,7300,332,-1000,abt
2024-04-15,18,12200,677.78,24,18300,762,-6100,abt
2024-04-12,18,5700,316.67,16,8100,506,-2400,abt
2024-04-11,15,4000,266.67,12,3200,267,800,abt
2024-04-10,17,15000,882.35,14,6400,457,8600,abt
2024-04-09,15,9900,660.0,23,4300,187,5600,abt
2024-04-08,16,11400,712.5,10,2400,240,9000,abt
2024-04-05,14,13100,935.71,13,5400,415,7700,abt
2024-04-04,31,16100,519.35,19,10800,568,5300,abt
2024-04-03,45,19100,424.44,15,12700,847,6400,abt
2024-04-02,22,7100,322.73,11,2900,264,4200,abt
2024-04-01,42,18600,442.86,28,13900,496,4700,abt
2024-03-29,24,8900,370.83,16,6400,400,2500,abt
2024-03-28,12,6600,550.0,13,5200,400,1400,abt
2024-03-27,18,8300,461.11,20,4000,200,4300,abt
2024-03-26,30,10700,356.67,18,4700,261,6000,abt
2024-03-25,43,19100,444.19,13,2700,208,16400,abt
2024-03-22,44,21100,479.55,36,14200,394,6900,abt
2024-03-21,36,30000,833.33,21,19800,943,10200,abt
2024-03-20,31,12900,416.13,22,36200,1645,-23300,abt
2024-03-19,48,46400,966.67,23,43800,1904,2600,abt
2024-03-18,37,19800,535.14,28,18400,657,1400,abt
2024-03-15,35,22000,628.57,15,10400,693,11600,abt
2024-03-14,41,29500,719.51,26,29300,1127,200,abt
2024-03-13,78,37800,484.62,17,22500,1324,15300,abt
2024-03-12,27,8200,303.7,39,35500,910,-27300,abt
2024-03-11,33,12200,369.7,21,8900,424,3300,abt
2024-03-08,35,8200,234.29,36,12500,347,-4300,abt
2024-03-07,19,5300,278.95,36,10300,286,-5000,abt
2024-03-06,32,25800,806.25,35,21100,603,4700,abt
2024-03-05,46,14400,313.04,24,29900,1246,-15500,abt
2024-03-04,33,15900,481.82,30,20100,670,-4200,abt
2024-03-01,24,6800,283.33,22,6200,282,600,abt
2024-02-29,12,2700,225.0,13,3900,300,-1200,abt
2024-02-28,32,9000,281.25,9,3800,422,5200,abt
2024-02-27,16,3300,206.25,17,3400,200,-100,abt
2024-02-26,45,11000,244.44,25,6600,264,4400,abt
2024-02-23,20,4900,245.0,9,1200,133,3700,abt
2024-02-22,31,7000,225.81,17,10600,624,-3600,abt
2024-02-21,14,3700,264.29,4,1600,400,2100,abt
2024-02-20,20,6300,315.0,9,7400,822,-1100,abt
2024-02-19,28,21900,782.14,15,11400,760,10500,abt
2024-02-16,21,5800,276.19,9,4200,467,1600,abt
2024-02-15,29,10400,358.62,14,12400,886,-2000,abt
2024-02-07,0,0,0.0,0,0,0,0,abt
2024-02-06,23,7300,317.39,11,5600,509,1700,abt
2024-02-05,16,9500,593.75,9,11700,1300,-2200,abt
2024-02-02,12,2400,200.0,13,6600,508,-4200,abt
2024-02-01,23,11800,513.04,15,4300,287,7500,abt
2024-01-31,15,9200,613.33,20,9600,480,-400,abt
2024-01-30,10,4800,480.0,10,2100,210,2700,abt
2024-01-29,16,3800,237.5,11,4000,364,-200,abt
2024-01-26,28,4000,142.86,15,3300,220,700,abt
2024-01-25,18,11500,638.89,29,17000,586,-5500,abt
2024-01-24,16,7400,462.5,20,6700,335,700,abt
2024-01-23,30,13900,463.33,33,24600,745,-10700,abt
2024-01-22,23,5400,234.78,17,6800,400,-1400,abt
2024-01-19,52,17000,326.92,30,15600,520,1400,abt
2024-01-18,42,11000,261.9,30,14900,497,-3900,abt
2024-01-17,19,8700,457.89,23,17800,774,-9100,abt
2024-01-16,21,5600,266.67,9,5800,644,-200,abt
2024-01-15,13,3500,269.23,12,7200,600,-3700,abt
2024-01-12,18,9100,505.56,11,8800,800,300,abt
2024-01-11,7,2300,328.57,12,3500,292,-1200,abt
2024-01-10,0,0,0.0,0,0,0,0,abt
2024-01-09,1,200,200.0,26,14100,542,-13900,abt
2024-01-08,13,11900,915.38,13,6000,462,5900,abt
2024-01-05,17,2300,135.29,21,28400,1352,-26100,abt
2024-01-04,30,21600,720.0,29,32000,1103,-10400,abt
2024-01-03,43,48300,1123.26,4,4100,1025,44200,abt
2024-01-02,6,600,100.0,3,300,100,300,abt
2024-09-12,2079,5826200,2802.41,1909,7534400,3947,-1708200,acb
2024-09-11,3240,7072300,2182.81,1430,8962900,6268,-1890600,acb
2024-09-10,3251,8744700,2689.85,2517,17136100,6808,-8391400,acb
2024-09-09,3023,8104600,2680.98,1676,12273700,7323,-4169100,acb
2024-09-06,1986,7695000,3874.62,2245,10524300,4688,-2829300,acb
2024-09-05,2100,5584400,2659.24,2135,8953600,4194,-3369200,acb
2024-09-04,3395,9557300,2815.11,2318,10308300,4447,-751000,acb
2024-08-30,1688,8203000,4859.6,3412,11177500,3276,-2974500,acb
2024-08-29,2833,15514700,5476.42,5097,20108300,3945,-4593600,acb
2024-08-28,2112,12126200,5741.57,2665,10986100,4122,1140100,acb
2024-08-27,1651,11418900,6916.35,2969,11351200,3823,67700,acb
2024-08-26,2020,9914600,4908.22,3175,11952100,3764,-2037500,acb
2024-08-23,2128,8271700,3887.08,2961,9848000,3326,-1576300,acb
2024-08-22,2920,13985400,4789.52,3694,15687900,4247,-1702500,acb
2024-08-21,2565,14793300,5767.37,3586,13427500,3744,1365800,acb
2024-08-20,2505,13132800,5242.63,3117,11926200,3826,1206600,acb
2024-08-19,2052,6893400,3359.36,2632,9003600,3421,-2110200,acb
2024-08-16,2619,12162500,4643.95,3459,12432600,3594,-270100,acb
2024-08-15,2634,7000600,2657.78,1699,7443100,4381,-442500,acb
2024-08-14,1746,6425200,3679.95,2113,7452100,3527,-1026900,acb
2024-08-13,2047,6322300,3088.57,2024,6826300,3373,-504000,acb
2024-08-12,3548,8882400,2503.49,2013,7100200,3527,1782200,acb
2024-08-08,3428,7477700,2181.36,1836,7862200,4282,-384500,acb
2024-08-07,3564,8752100,2455.7,1746,8645100,4951,107000,acb
2024-08-06,4691,14948200,3186.57,3760,13919300,3702,1028900,acb
2024-08-05,8161,28038300,3435.65,4054,27825800,6864,212500,acb
2024-08-02,7904,23491900,2972.15,2979,22442800,7534,1049100,acb
2024-08-01,5057,12931300,2557.11,3913,17331100,4429,-4399800,acb
2024-07-31,4074,18510300,4543.52,4408,15652300,3551,2858000,acb
2024-07-30,3850,11150000,2896.1,2054,10764400,5241,385600,acb
2024-07-29,2994,8950300,2989.41,2464,8794400,3569,155900,acb
2024-07-26,3447,10424500,3024.22,2026,8455900,4174,1968600,acb
2024-07-25,5999,19139600,3190.47,2297,13023000,5670,6116600,acb
2024-07-24,6342,22715300,3581.73,4507,19851000,4404,2864300,acb
2024-07-22,6461,26724100,4136.22,6004,28433500,4736,-1709400,acb
2024-07-19,5491,29564000,5384.08,8765,33417700,3813,-3853700,acb
2024-07-18,5020,20807300,4144.88,6883,24891700,3616,-4084400,acb
2024-07-17,9473,48530600,5123.04,14316,46362000,3238,2168600,acb
2024-07-16,3184,11714800,3679.27,4399,15152300,3444,-3437500,acb
2024-07-15,3208,8159500,2543.49,2390,8171800,3419,-12300,acb
2024-07-12,5049,10933900,2165.56,2363,13941300,5900,-3007400,acb
2024-07-11,2830,8058500,2847.53,4040,14743700,3649,-6685200,acb
2024-07-10,3488,16121400,4621.96,4321,15817100,3661,304300,acb
2024-07-09,3702,17928700,4842.98,4186,17468400,4173,460300,acb
2024-07-08,3359,9803600,2918.61,3207,10752600,3353,-949000,acb
2024-07-05,4220,13687900,3243.58,3547,11573000,3263,2114900,acb
2024-07-04,4306,11885800,2760.29,3448,13627500,3952,-1741700,acb
2024-07-03,3479,12048900,3463.32,3605,12865000,3569,-816100,acb
2024-07-02,3840,15802100,4115.13,3004,11674600,3886,4127500,acb
2024-07-01,4300,8258200,1920.51,1762,7515000,4265,743200,acb
2024-06-28,3774,9649100,2556.73,2975,11544400,3880,-1895300,acb
2024-06-27,4307,9298500,2158.93,2036,9415000,4624,-116500,acb
2024-06-26,6991,18538200,2651.72,3385,16561500,4893,1976700,acb
2024-06-25,4951,12516400,2528.05,2665,12153800,4561,362600,acb
2024-06-24,9803,22096100,2254.01,4179,21937900,5250,158200,acb
2024-06-21,4372,8819900,2017.36,2921,11762800,4027,-2942900,acb
2024-06-20,5080,14088800,2773.39,4951,16205000,3273,-2116200,acb
2024-06-19,5765,13756300,2386.18,3407,13145900,3858,610400,acb
2024-06-18,3875,10653200,2749.21,4738,11857400,2503,-1204200,acb
2024-06-17,5281,12751800,2414.66,3192,11298300,3540,1453500,acb
2024-06-14,7511,18650500,2483.09,5969,24318000,4074,-5667500,acb
2024-06-13,6862,20398900,2972.73,6558,23629400,3603,-3230500,acb
2024-06-12,8766,19759100,2254.06,3781,16359200,4327,3399900,acb
2024-06-11,7830,16386800,2092.82,3461,16430500,4747,-43700,acb
2024-06-10,6463,12798700,1980.3,2976,14314600,4810,-1515900,acb
2024-06-07,4005,11264700,2812.66,3993,11748500,2942,-483800,acb
2024-06-06,5747,15438300,2686.32,3212,15007100,4672,431200,acb
2024-06-05,6864,16982700,2474.17,3577,18889300,5281,-1906600,acb
2024-06-04,8110,15955300,1967.36,3651,17344100,4751,-1388800,acb
2024-06-03,8142,22840500,2805.27,3273,22381200,6838,459300,acb
2024-05-31,9295,18966400,2040.49,4583,20234700,4415,-1268300,acb
2024-05-30,8031,26623500,3315.09,5401,21301700,3944,5321800,acb
2024-05-29,6535,20370000,3117.06,5855,23261500,3973,-2891500,acb
2024-05-28,6432,23360900,3631.98,5656,18977800,3355,4383100,acb
2024-05-27,4723,14571200,3085.16,4451,15503300,3483,-932100,acb
2024-05-24,15885,67348100,4239.73,13326,52863400,3967,14484700,acb
2024-05-23,4129,20399700,4940.59,5115,18108000,3540,2291700,acb
2024-05-22,5425,15271100,2814.95,3446,15760400,4574,-489300,acb
2024-05-21,6354,17245600,2714.13,3488,16287000,4669,958600,acb
2024-05-20,4434,19381900,4371.2,4711,16498600,3502,2883300,acb
2024-05-17,5481,15674200,2859.73,3907,15989600,4093,-315400,acb
2024-05-16,11510,44192300,3839.47,6630,45348900,6840,-1156600,acb
2024-05-15,3296,11404400,3460.07,3220,13642600,4237,-2238200,acb
2024-05-14,2607,8294100,3181.47,2739,10413200,3802,-2119100,acb
2024-05-13,3317,12097600,3647.15,3317,12751500,3844,-653900,acb
2024-05-10,2917,9147900,3136.06,2478,9978400,4027,-830500,acb
2024-05-09,3149,9040300,2870.85,3465,10671500,3080,-1631200,acb
2024-05-08,4147,9157300,2208.17,2476,7851100,3171,1306200,acb
2024-05-07,3659,8510200,2325.83,2870,9826000,3424,-1315800,acb
2024-05-06,3720,12316900,3310.99,3326,15882400,4775,-3565500,acb
2024-05-03,2657,13671100,5145.31,2892,14435100,4991,-764000,acb
2024-05-02,2489,9193100,3693.49,1672,8857900,5298,335200,acb
2024-04-26,3687,10137700,2749.58,1855,11764700,6342,-1627000,acb
2024-04-25,3556,9428800,2651.52,2812,8945000,3181,483800,acb
2024-04-24,2649,12350800,4662.44,2719,11432200,4205,918600,acb
2024-04-23,2788,13074200,4689.45,2814,12722800,4521,351400,acb
2024-04-22,2426,11739800,4839.16,2555,12196200,4773,-456400,acb
2024-04-19,4286,19045800,4443.72,3520,16625900,4723,2419900,acb
2024-04-17,3894,16861400,4330.1,2947,17118600,5809,-257200,acb
2024-04-16,5532,29149300,5269.22,4950,26689100,5392,2460200,acb
2024-04-15,6502,24756800,3807.57,4324,25212500,5831,-455700,acb
2024-04-12,4372,20313400,4646.25,4030,15950500,3958,4362900,acb
2024-04-11,4809,20584000,4280.31,2072,20516200,9902,67800,acb
2024-04-10,3027,10229000,3379.25,2514,18247500,7258,-8018500,acb
2024-04-09,3789,12249600,3232.94,1923,14142100,7354,-1892500,acb
2024-04-08,4684,15649100,3340.97,2613,20658200,7906,-5009100,acb
2024-04-05,6644,23448800,3529.32,3198,26998400,8442,-3549600,acb
2024-04-04,4191,16369600,3905.89,3328,25468400,7653,-9098800,acb
2024-04-03,3431,15351400,4474.32,3133,22870500,7300,-7519100,acb
2024-04-02,4272,18383200,4303.18,3185,22270400,6992,-3887200,acb
2024-04-01,3073,11635900,3786.5,3435,18284800,5323,-6648900,acb
2024-03-29,2948,21640100,7340.6,5446,31594700,5801,-9954600,acb
2024-03-28,4700,19963500,4247.55,7241,27362100,3779,-7398600,acb
2024-03-27,3641,11797200,3240.1,3122,11728800,3757,68400,acb
2024-03-26,4684,15973900,3410.31,2927,11329500,3871,4644400,acb
2024-03-25,6287,16155400,2569.65,3807,21775700,5720,-5620300,acb
2024-03-22,10661,35242700,3305.76,8793,40178400,4569,-4935700,acb
2024-03-21,4180,20635500,4936.72,6210,24548500,3953,-3913000,acb
2024-03-20,7800,30442000,3902.82,6148,25853100,4205,4588900,acb
2024-03-19,4546,15366600,3380.25,2897,9959000,3438,5407600,acb
2024-03-18,6936,23663400,3411.68,3873,21692600,5601,1970800,acb
2024-03-15,5460,15510000,2840.66,2725,14173300,5201,1336700,acb
2024-03-14,5575,13259200,2378.33,4048,17684100,4369,-4424900,acb
2024-03-13,4022,20043000,4983.34,4589,15391800,3354,4651200,acb
2024-03-12,5193,16581200,3192.99,4448,13384800,3009,3196400,acb
2024-03-11,5686,19931300,3505.33,4215,18870300,4477,1061000,acb
2024-03-08,10623,32236200,3034.57,6192,31604300,5104,631900,acb
2024-03-07,7316,19320200,2640.81,2662,18672600,7015,647600,acb
2024-03-06,5455,15822700,2900.59,3836,17704600,4615,-1881900,acb
2024-03-05,5413,13532400,2499.98,2703,12465600,4612,1066800,acb
2024-03-04,8685,23249500,2676.97,4293,24478000,5702,-1228500,acb
2024-03-01,7042,18663300,2650.28,3873,17408900,4495,1254400,acb
2024-02-29,4275,15460000,3616.37,4310,21027500,4879,-5567500,acb
2024-02-28,5239,22480900,4291.07,5055,17995100,3560,4485800,acb
2024-02-27,5188,22766900,4388.38,3657,20122800,5503,2644100,acb
2024-02-26,5684,19507800,3432.05,3120,16804400,5386,2703400,acb
2024-02-23,8270,38089300,4605.72,8134,43628600,5364,-5539300,acb
2024-02-22,5153,14203300,2756.32,2762,14125800,5114,77500,acb
2024-02-21,5923,18737700,3163.55,3518,21167200,6017,-2429500,acb
2024-02-20,5300,17017400,3210.83,2781,15027900,5404,1989500,acb
2024-02-19,6881,21552400,3132.16,2948,17807900,6041,3744500,acb
2024-02-16,6071,18571300,3059.02,3203,18437700,5756,133600,acb
2024-02-15,4903,20821300,4246.64,3529,24155800,6845,-3334500,acb
2024-02-07,0,0,0.0,0,0,0,0,acb
2024-02-06,3677,8878600,2414.63,3135,14043400,4480,-5164800,acb
2024-02-05,11002,45411000,4127.52,7365,39436900,5355,5974100,acb
2024-02-02,3902,25956500,6652.1,3512,27124900,7723,-1168400,acb
2024-02-01,3259,16772400,5146.49,2555,12516800,4899,4255600,acb
2024-01-31,5179,21445800,4140.92,3388,20037600,5914,1408200,acb
2024-01-30,2616,12385300,4734.44,2179,12714200,5835,-328900,acb
2024-01-29,2568,14685200,5718.54,3253,20203600,6211,-5518400,acb
2024-01-26,2496,16529000,6622.2,4015,15481200,3856,1047800,acb
2024-01-25,3713,13709600,3692.32,1827,9803000,5366,3906600,acb
2024-01-24,3938,18448900,4684.84,2869,19062100,6644,-613200,acb
2024-01-23,2860,18597100,6502.48,3799,19989500,5262,-1392400,acb
2024-01-22,3561,20494900,5755.38,4792,18945300,3954,1549600,acb
2024-01-19,3779,31531400,8343.85,4031,21078000,5229,10453400,acb
2024-01-18,4239,22172700,5230.64,3299,18890900,5726,3281800,acb
2024-01-17,3699,19191500,5188.29,3386,18455300,5450,736200,acb
2024-01-16,4813,23871800,4959.86,2674,22009900,8231,1861900,acb
2024-01-15,3888,17486900,4497.66,3197,23247300,7272,-5760400,acb
2024-01-12,7916,52456200,6626.6,7771,39770100,5118,12686100,acb
2024-01-11,3564,17380500,4876.68,4019,20551100,5113,-3170600,acb
2024-01-10,0,0,0.0,0,0,0,0,acb
2024-01-09,6054,23903400,3948.36,2583,24253200,9390,-349800,acb
2024-01-08,3411,19038900,5581.62,3833,24672700,6437,-5633800,acb
2024-01-05,2668,15313400,5739.66,3876,16203800,4181,-890400,acb
2024-01-04,4641,40328500,8689.61,6758,38647000,5719,1681500,acb
2024-01-03,2488,21308600,8564.55,3930,15983900,4067,5324700,acb
2024-01-02,3047,22979800,7541.78,6030,25134000,4168,-2154200,acb
2024-09-12,13,58400,4492.31,83,81200,978,-22800,acc
2024-09-11,16,62800,3925.0,69,66700,967,-3900,acc
2024-09-10,20,78700,3935.0,73,58300,799,20400,acc
2024-09-09,23,94600,4113.04,85,82100,966,12500,acc
2024-09-06,39,82500,2115.38,67,147200,2197,-64700,acc
2024-09-05,23,86400,3756.52,60,58300,972,28100,acc
2024-09-04,29,114800,3958.62,66,94900,1438,19900,acc
2024-08-30,21,73900,3519.05,66,107600,1630,-33700,acc
2024-08-29,59,1083600,18366.1,223,1232500,5527,-148900,acc
2024-08-28,28,78300,2796.43,48,42000,875,36300,acc
2024-08-27,28,89000,3178.57,54,64300,1191,24700,acc
2024-08-26,40,131800,3295.0,57,135200,2372,-3400,acc
2024-08-23,46,70300,1528.26,68,86600,1274,-16300,acc
2024-08-22,36,133000,3694.44,56,77500,1384,55500,acc
2024-08-21,53,75000,1415.09,71,115000,1620,-40000,acc
2024-08-20,54,112900,2090.74,108,154900,1434,-42000,acc
2024-08-19,60,105300,1755.0,89,84300,947,21000,acc
2024-08-16,31,140100,4519.35,20,51600,2580,88500,acc
2024-08-15,34,104100,3061.76,38,68300,1797,35800,acc
2024-08-14,33,169000,5121.21,55,177800,3233,-8800,acc
2024-08-13,27,110500,4092.59,45,116800,2596,-6300,acc
2024-08-12,34,39200,1152.94,50,128900,2578,-89700,acc
2024-08-08,18,61500,3416.67,51,57700,1131,3800,acc
2024-08-07,31,116400,3754.84,44,51300,1166,65100,acc
2024-08-06,32,33500,1046.88,26,21400,823,12100,acc
2024-08-05,17,18100,1064.71,37,57400,1551,-39300,acc
2024-08-02,28,16900,603.57,27,27200,1007,-10300,acc
2024-08-01,25,67100,2684.0,67,73400,1096,-6300,acc
2024-07-31,42,42900,1021.43,67,103400,1543,-60500,acc
2024-07-30,31,84800,2735.48,119,125200,1052,-40400,acc
2024-07-29,34,39700,1167.65,74,96200,1300,-56500,acc
2024-07-26,60,93800,1563.33,87,65600,754,28200,acc
2024-07-25,57,50500,885.96,71,100900,1421,-50400,acc
2024-07-24,29,15400,531.03,74,114600,1549,-99200,acc
2024-07-22,65,54500,838.46,98,116000,1184,-61500,acc
2024-07-19,49,81800,1669.39,135,177600,1316,-95800,acc
2024-07-18,110,224400,2040.0,128,198800,1553,25600,acc
2024-07-17,123,209000,1699.19,147,180600,1229,28400,acc
2024-07-16,153,367500,2401.96,197,389500,1977,-22000,acc
2024-07-15,69,218500,3166.67,123,175200,1424,43300,acc
2024-07-12,76,134500,1769.74,83,113900,1372,20600,acc
2024-07-11,56,266800,4764.29,90,158100,1757,108700,acc
2024-07-10,62,241900,3901.61,100,279900,2799,-38000,acc
2024-07-09,43,267600,6223.26,77,358000,4649,-90400,acc
2024-07-08,67,209200,3122.39,79,204400,2587,4800,acc
2024-07-05,37,205000,5540.54,79,152400,1929,52600,acc
2024-07-04,55,146000,2654.55,48,183000,3812,-37000,acc
2024-07-03,55,156200,2840.0,80,238600,2982,-82400,acc
2024-07-02,78,138600,1776.92,88,192500,2188,-53900,acc
2024-07-01,50,67500,1350.0,85,194300,2286,-126800,acc
2024-06-28,110,140800,1280.0,77,137300,1783,3500,acc
2024-06-27,101,395600,3916.83,84,302800,3605,92800,acc
2024-06-26,22,15100,686.36,60,184200,3070,-169100,acc
2024-06-25,41,62700,1529.27,84,176500,2101,-113800,acc
2024-06-24,104,115300,1108.65,98,264700,2701,-149400,acc
2024-06-21,96,120900,1259.38,86,365200,4247,-244300,acc
2024-06-20,82,87400,1065.85,80,207300,2591,-119900,acc
2024-06-19,83,153700,1851.81,84,171500,2042,-17800,acc
2024-06-18,114,173400,1521.05,69,150700,2184,22700,acc
2024-06-17,79,139300,1763.29,86,147700,1717,-8400,acc
2024-06-14,48,121200,2525.0,115,151200,1315,-30000,acc
2024-06-13,93,144000,1548.39,168,228500,1360,-84500,acc
2024-06-12,119,217000,1823.53,114,157500,1382,59500,acc
2024-06-11,46,163800,3560.87,106,138000,1302,25800,acc
2024-06-10,76,206000,2710.53,92,144700,1573,61300,acc
2024-06-07,53,180000,3396.23,165,236500,1433,-56500,acc
2024-06-06,134,300700,2244.03,197,255900,1299,44800,acc
2024-06-05,54,153800,2848.15,84,134100,1596,19700,acc
2024-06-04,101,193500,1915.84,87,183400,2108,10100,acc
2024-06-03,34,39800,1170.59,79,101300,1282,-61500,acc
2024-05-31,20,85400,4270.0,64,64300,1005,21100,acc
2024-05-30,35,76500,2185.71,80,77000,962,-500,acc
2024-05-29,28,66800,2385.71,103,165200,1604,-98400,acc
2024-05-28,43,80500,1872.09,128,128600,1005,-48100,acc
2024-05-27,42,72700,1730.95,102,96900,950,-24200,acc
2024-05-24,45,78900,1753.33,121,177300,1465,-98400,acc
2024-05-23,57,45500,798.25,93,160500,1726,-115000,acc
2024-05-22,61,100200,1642.62,123,123900,1007,-23700,acc
2024-05-21,47,94100,2002.13,175,168400,962,-74300,acc
2024-05-20,92,503500,5472.83,118,489400,4147,14100,acc
2024-05-17,46,110700,2406.52,83,84700,1020,26000,acc
2024-05-16,48,94400,1966.67,102,101000,990,-6600,acc
2024-05-15,69,137400,1991.3,99,90200,911,47200,acc
2024-05-14,36,80900,2247.22,85,78200,920,2700,acc
2024-05-13,27,74200,2748.15,77,70400,914,3800,acc
2024-05-10,31,82900,2674.19,68,140800,2071,-57900,acc
2024-05-09,34,34000,1000.0,79,67500,854,-33500,acc
2024-05-08,28,96900,3460.71,54,52300,969,44600,acc
2024-05-07,36,25700,713.89,81,98400,1215,-72700,acc
2024-05-06,55,107400,1952.73,50,73500,1470,33900,acc
2024-05-03,28,76100,2717.86,85,120000,1412,-43900,acc
2024-05-02,53,168700,3183.02,83,201400,2427,-32700,acc
2024-04-26,56,188000,3357.14,71,76700,1080,111300,acc
2024-04-25,38,115300,3034.21,43,51300,1193,64000,acc
2024-04-24,39,123900,3176.92,36,73900,2053,50000,acc
2024-04-23,32,129100,4034.38,45,88800,1973,40300,acc
2024-04-22,27,129000,4777.78,33,79200,2400,49800,acc
2024-04-19,42,168700,4016.67,81,242700,2996,-74000,acc
2024-04-17,23,89700,3900.0,68,140900,2072,-51200,acc
2024-04-16,23,188000,8173.91,124,265000,2137,-77000,acc
2024-04-15,24,99900,4162.5,159,209000,1314,-109100,acc
2024-04-12,16,55200,3450.0,119,181200,1523,-126000,acc
2024-04-11,46,134900,2932.61,145,177300,1223,-42400,acc
2024-04-10,39,150700,3864.1,212,334800,1579,-184100,acc
2024-04-09,53,153800,2901.89,178,323500,1817,-169700,acc
2024-04-08,96,386500,4026.04,232,402900,1737,-16400,acc
2024-04-05,39,110400,2830.77,163,225500,1383,-115100,acc
2024-04-04,28,153500,5482.14,154,351000,2279,-197500,acc
2024-04-03,48,132700,2764.58,173,274000,1584,-141300,acc
2024-04-02,28,106700,3810.71,186,210200,1130,-103500,acc
2024-04-01,80,187700,2346.25,180,290700,1615,-103000,acc
2024-03-29,57,211600,3712.28,189,335000,1772,-123400,acc
2024-03-28,104,357400,3436.54,190,330400,1739,27000,acc
2024-03-27,99,250200,2527.27,161,218200,1355,32000,acc
2024-03-26,99,385400,3892.93,171,403800,2361,-18400,acc
2024-03-25,89,341900,3841.57,175,269500,1540,72400,acc
2024-03-22,84,305600,3638.1,226,378600,1675,-73000,acc
2024-03-21,103,337300,3274.76,179,245300,1370,92000,acc
2024-03-20,58,254800,4393.1,124,196800,1587,58000,acc
2024-03-19,33,179000,5424.24,94,118200,1257,60800,acc
2024-03-18,47,100500,2138.3,105,195300,1860,-94800,acc
2024-03-15,31,118900,3835.48,61,274000,4492,-155100,acc
2024-03-14,33,143400,4345.45,88,166300,1890,-22900,acc
2024-03-13,40,171700,4292.5,75,169900,2265,1800,acc
2024-03-12,39,227500,5833.33,77,175400,2278,52100,acc
2024-03-11,41,110500,2695.12,93,215300,2315,-104800,acc
2024-03-08,71,58700,826.76,82,149400,1822,-90700,acc
2024-03-07,40,30600,765.0,75,155800,2077,-125200,acc
2024-03-06,44,75500,1715.91,86,135700,1578,-60200,acc
2024-03-05,77,173400,2251.95,115,154000,1339,19400,acc
2024-03-04,53,127800,2411.32,106,151700,1431,-23900,acc
2024-03-01,33,50300,1524.24,78,89700,1150,-39400,acc
2024-02-29,38,58500,1539.47,63,282000,4476,-223500,acc
2024-02-28,34,59000,1735.29,75,114100,1521,-55100,acc
2024-02-27,33,38000,1151.52,66,88900,1347,-50900,acc
2024-02-26,32,45400,1418.75,48,249300,5194,-203900,acc
2024-02-23,42,70800,1685.71,87,115500,1328,-44700,acc
2024-02-22,48,33400,695.83,74,67800,916,-34400,acc
2024-02-21,39,25900,664.1,108,102200,946,-76300,acc
2024-02-20,39,38400,984.62,112,118100,1054,-79700,acc
2024-02-19,49,39400,804.08,76,89700,1180,-50300,acc
2024-02-16,51,39800,780.39,89,111100,1248,-71300,acc
2024-02-15,38,75600,1989.47,91,138000,1516,-62400,acc
2024-02-07,0,0,0.0,0,0,0,0,acc
2024-02-06,36,18700,519.44,48,465100,9690,-446400,acc
2024-02-05,53,38200,720.75,48,310100,6460,-271900,acc
2024-02-02,38,18400,484.21,55,260100,4729,-241700,acc
2024-02-01,47,83600,1778.72,57,591100,10370,-507500,acc
2024-01-31,51,32100,629.41,49,336800,6873,-304700,acc
2024-01-30,64,55300,864.06,50,86200,1724,-30900,acc
2024-01-29,65,34100,524.62,55,68300,1242,-34200,acc
2024-01-26,41,27300,665.85,47,279600,5949,-252300,acc
2024-01-25,40,19900,497.5,47,45300,964,-25400,acc
2024-01-24,79,46800,592.41,53,296000,5585,-249200,acc
2024-01-23,68,37600,552.94,58,49500,853,-11900,acc
2024-01-22,64,63100,985.94,80,101600,1270,-38500,acc
2024-01-19,63,56400,895.24,60,96900,1615,-40500,acc
2024-01-18,177,218600,1235.03,91,177400,1949,41200,acc
2024-01-17,47,45500,968.09,65,59900,922,-14400,acc
2024-01-16,40,22400,560.0,39,50300,1290,-27900,acc
2024-01-15,39,39600,1015.38,35,49800,1423,-10200,acc
2024-01-12,38,37200,978.95,46,82700,1798,-45500,acc
2024-01-11,68,83300,1225.0,65,88500,1362,-5200,acc
2024-01-10,0,0,0.0,0,0,0,0,acc
2024-01-09,51,38600,756.86,69,66200,959,-27600,acc
2024-01-08,49,53600,1093.88,110,140500,1277,-86900,acc
2024-01-05,41,51200,1248.78,95,351300,3698,-300100,acc
2024-01-04,35,52200,1491.43,91,101800,1119,-49600,acc
2024-01-03,32,44900,1403.12,75,97700,1303,-52800,acc
2024-01-02,38,98100,2581.58,97,125700,1296,-27600,acc
2024-09-12,8,1700,212.5,10,1700,170,0,ace
2024-09-11,13,5900,453.85,12,2400,200,3500,ace
2024-09-10,20,6100,305.0,17,2400,141,3700,ace
2024-09-09,12,5000,416.67,6,1200,200,3800,ace
2024-09-06,16,10700,668.75,12,5400,450,5300,ace
2024-09-05,12,8100,675.0,8,4200,525,3900,ace
2024-09-04,19,24800,1305.26,13,14300,1100,10500,ace
2024-08-30,9,4500,500.0,10,3900,390,600,ace
2024-08-29,21,29400,1400.0,27,24400,904,5000,ace
2024-08-28,13,46900,3607.69,18,12200,678,34700,ace
2024-08-27,15,2400,160.0,11,2400,218,0,ace
2024-08-26,20,14700,735.0,12,4400,367,10300,ace
2024-08-23,10,7100,710.0,7,2500,357,4600,ace
2024-08-22,17,11800,694.12,11,8100,736,3700,ace
2024-08-21,12,5700,475.0,12,8400,700,-2700,ace
2024-08-20,23,17200,747.83,15,11700,780,5500,ace
2024-08-19,16,14400,900.0,16,17300,1081,-2900,ace
2024-08-16,29,26800,924.14,22,25500,1159,1300,ace
2024-08-15,10,8700,870.0,17,5900,347,2800,ace
2024-08-14,13,14700,1130.77,22,17500,795,-2800,ace
2024-08-13,14,9700,692.86,14,8700,621,1000,ace
2024-08-12,37,18500,500.0,24,16700,696,1800,ace
2024-08-09,21,13200,628.57,12,8200,683,5000,ace
2024-08-08,11,2500,227.27,21,12400,590,-9900,ace
2024-08-07,20,5300,265.0,14,7800,557,-2500,ace
2024-08-06,25,5100,204.0,16,9000,562,-3900,ace
2024-08-05,22,8800,400.0,14,9800,700,-1000,ace
2024-08-02,13,10800,830.77,12,8200,683,2600,ace
2024-08-01,31,41700,1345.16,19,43700,2300,-2000,ace
2024-07-31,35,41700,1191.43,25,40000,1600,1700,ace
2024-07-30,24,38700,1612.5,14,37200,2657,1500,ace
2024-07-29,33,44200,1339.39,31,39800,1284,4400,ace
2024-07-26,24,30000,1250.0,20,27600,1380,2400,ace
2024-07-25,30,28600,953.33,19,14200,747,14400,ace
2024-07-24,17,20800,1223.53,16,16400,1025,4400,ace
2024-07-23,13,9200,707.69,15,9500,633,-300,ace
2024-07-22,18,20100,1116.67,20,20000,1000,100,ace
2024-07-19,23,25900,1126.09,21,28800,1371,-2900,ace
2024-07-18,28,18700,667.86,12,17300,1442,1400,ace
2024-07-17,38,34800,915.79,35,28100,803,6700,ace
2024-07-16,36,53500,1486.11,18,45000,2500,8500,ace
2024-07-15,33,35400,1072.73,15,20900,1393,14500,ace
2024-07-12,27,33500,1240.74,15,19400,1293,14100,ace
2024-07-11,32,46400,1450.0,21,37100,1767,9300,ace
2024-07-10,24,39900,1662.5,21,28800,1371,11100,ace
2024-07-09,34,39200,1152.94,23,29900,1300,9300,ace
2024-07-08,39,33700,864.1,21,34600,1648,-900,ace
2024-07-05,23,14900,647.83,15,10500,700,4400,ace
2024-07-04,34,36000,1058.82,20,28700,1435,7300,ace
2024-07-03,27,32200,1192.59,20,26500,1325,5700,ace
2024-07-02,32,32900,1028.12,20,28600,1430,4300,ace
2024-07-01,12,7600,633.33,10,8100,810,-500,ace
2024-06-28,28,23100,825.0,21,23000,1095,100,ace
2024-06-27,20,15400,770.0,13,13000,1000,2400,ace
2024-06-26,25,28400,1136.0,23,26000,1130,2400,ace
2024-06-25,21,25500,1214.29,23,22300,970,3200,ace
2024-06-24,28,26000,928.57,16,27100,1694,-1100,ace
2024-06-21,25,26000,1040.0,24,18100,754,7900,ace
2024-06-20,21,22700,1080.95,12,20000,1667,2700,ace
2024-06-19,27,29700,1100.0,20,28100,1405,1600,ace
2024-06-18,26,23300,896.15,14,16500,1179,6800,ace
2024-06-17,22,25800,1172.73,16,25000,1562,800,ace
2024-06-14,30,41300,1376.67,29,38700,1334,2600,ace
2024-06-13,27,28200,1044.44,17,17600,1035,10600,ace
2024-06-12,29,35700,1231.03,19,24400,1284,11300,ace
2024-06-11,38,44400,1168.42,24,35300,1471,9100,ace
2024-06-10,38,58900,1550.0,25,47400,1896,11500,ace
2024-06-07,26,39100,1503.85,27,29400,1089,9700,ace
2024-06-06,26,45600,1753.85,27,40000,1481,5600,ace
2024-06-05,37,45200,1221.62,25,28900,1156,16300,ace
2024-06-04,29,38800,1337.93,22,37000,1682,1800,ace
2024-06-03,29,29800,1027.59,24,26200,1092,3600,ace
2024-05-31,30,49400,1646.67,21,39000,1857,10400,ace
2024-05-30,32,27600,862.5,10,17400,1740,10200,ace
2024-05-29,46,67300,1463.04,24,54600,2275,12700,ace
2024-05-28,22,28500,1295.45,13,23100,1777,5400,ace
2024-05-27,30,36900,1230.0,23,34000,1478,2900,ace
2024-05-24,34,31000,911.76,16,19200,1200,11800,ace
2024-05-23,36,41300,1147.22,16,18700,1169,22600,ace
2024-05-22,30,26000,866.67,19,20500,1079,5500,ace
2024-05-21,38,42700,1123.68,22,29700,1350,13000,ace
2024-05-20,19,15800,831.58,7,3100,443,12700,ace
2024-05-17,47,34900,742.55,22,23900,1086,11000,ace
2024-05-16,22,14800,672.73,5,4500,900,10300,ace
2024-05-15,20,23600,1180.0,7,14300,2043,9300,ace
2024-05-14,11,11800,1072.73,7,6500,929,5300,ace
2024-05-13,14,12800,914.29,10,11000,1100,1800,ace
2024-05-10,16,14300,893.75,8,4000,500,10300,ace
2024-05-09,12,9800,816.67,8,7000,875,2800,ace
2024-05-08,11,8600,781.82,6,3600,600,5000,ace
2024-05-07,16,10100,631.25,9,6000,667,4100,ace
2024-05-06,19,16000,842.11,11,9900,900,6100,ace
2024-05-03,15,14400,960.0,7,7700,1100,6700,ace
2024-05-02,12,18000,1500.0,11,11400,1036,6600,ace
2024-04-26,14,9000,642.86,10,4700,470,4300,ace
2024-04-25,20,9600,480.0,11,4800,436,4800,ace
2024-04-24,12,4700,391.67,15,11500,767,-6800,ace
2024-04-23,17,5900,347.06,7,8000,1143,-2100,ace
2024-04-22,22,6000,272.73,11,12200,1109,-6200,ace
2024-04-19,11,3600,327.27,11,10600,964,-7000,ace
2024-04-17,16,7700,481.25,14,11800,843,-4100,ace
2024-04-16,25,7200,288.0,13,12800,985,-5600,ace
2024-04-15,27,19800,733.33,17,20900,1229,-1100,ace
2024-04-12,19,23800,1252.63,12,18800,1567,5000,ace
2024-04-11,23,20900,908.7,28,25800,921,-4900,ace
2024-04-10,23,26100,1134.78,23,24500,1065,1600,ace
2024-04-09,33,14900,451.52,17,8200,482,6700,ace
2024-04-08,21,3800,180.95,9,2100,233,1700,ace
2024-04-05,31,19300,622.58,21,22900,1090,-3600,ace
2024-04-04,26,15100,580.77,19,17200,905,-2100,ace
2024-04-03,18,16400,911.11,14,16800,1200,-400,ace
2024-04-02,52,27900,536.54,21,26500,1262,1400,ace
2024-04-01,18,4900,272.22,13,9900,762,-5000,ace
2024-03-29,33,19100,578.79,23,18800,817,300,ace
2024-03-28,23,13600,591.3,14,21800,1557,-8200,ace
2024-03-27,17,26900,1582.35,13,37100,2854,-10200,ace
2024-03-26,20,25600,1280.0,10,21900,2190,3700,ace
2024-03-25,31,69600,2245.16,19,53700,2826,15900,ace
2024-03-22,26,36700,1411.54,16,70300,4394,-33600,ace
2024-03-21,24,54300,2262.5,10,62800,6280,-8500,ace
2024-03-20,25,11500,460.0,27,24800,919,-13300,ace
2024-03-19,20,22600,1130.0,22,28500,1295,-5900,ace
2024-03-18,26,24200,930.77,22,25100,1141,-900,ace
2024-03-15,29,24700,851.72,20,32300,1615,-7600,ace
2024-03-14,37,30900,835.14,28,29100,1039,1800,ace
2024-03-13,17,21100,1241.18,19,34400,1811,-13300,ace
2024-03-12,16,12100,756.25,17,15600,918,-3500,ace
2024-03-11,21,22300,1061.9,19,23400,1232,-1100,ace
2024-03-08,21,17900,852.38,18,21600,1200,-3700,ace
2024-03-07,19,8500,447.37,16,13000,812,-4500,ace
2024-03-06,21,34600,1647.62,18,29200,1622,5400,ace
2024-03-05,21,20800,990.48,17,19700,1159,1100,ace
2024-03-04,23,26700,1160.87,17,23400,1376,3300,ace
2024-03-01,18,21300,1183.33,14,17200,1229,4100,ace
2024-02-29,24,23800,991.67,17,21700,1276,2100,ace
2024-02-28,25,19800,792.0,16,19500,1219,300,ace
2024-02-27,22,15100,686.36,13,16900,1300,-1800,ace
2024-02-26,34,35100,1032.35,17,32100,1888,3000,ace
2024-02-23,13,6900,530.77,5,5600,1120,1300,ace
2024-02-22,16,19800,1237.5,11,19300,1755,500,ace
2024-02-21,23,14200,617.39,16,13300,831,900,ace
2024-02-20,19,25100,1321.05,10,25700,2570,-600,ace
2024-02-19,14,10700,764.29,7,3000,429,7700,ace
2024-02-16,19,25200,1326.32,9,17900,1989,7300,ace
2024-02-15,20,14600,730.0,9,15000,1667,-400,ace
2024-02-07,28,69600,2485.71,18,61600,3422,8000,ace
2024-02-06,21,20300,966.67,12,25400,2117,-5100,ace
2024-02-05,30,60300,2010.0,25,57000,2280,3300,ace
2024-02-02,28,35000,1250.0,23,34100,1483,900,ace
2024-02-01,10,6600,660.0,7,7800,1114,-1200,ace
2024-01-31,14,19700,1407.14,11,20700,1882,-1000,ace
2024-01-30,14,30200,2157.14,14,66100,4721,-35900,ace
2024-01-29,12,12600,1050.0,4,4800,1200,7800,ace
2024-01-26,16,25900,1618.75,11,22700,2064,3200,ace
2024-01-25,16,23600,1475.0,11,29700,2700,-6100,ace
2024-01-24,25,22200,888.0,9,10700,1189,11500,ace
2024-01-23,23,36900,1604.35,16,31700,1981,5200,ace
2024-01-22,14,13800,985.71,7,12200,1743,1600,ace
2024-01-19,21,43500,2071.43,20,43600,2180,-100,ace
2024-01-18,16,14200,887.5,7,11700,1671,2500,ace
2024-01-17,23,39000,1695.65,16,39500,2469,-500,ace
2024-01-16,14,35000,2500.0,9,23100,2567,11900,ace
2024-01-15,10,27000,2700.0,10,23100,2310,3900,ace
2024-01-12,23,50000,2173.91,14,36900,2636,13100,ace
2024-01-11,24,46500,1937.5,16,27300,1706,19200,ace
2024-01-10,21,53000,2523.81,17,54800,3224,-1800,ace
2024-01-09,22,24200,1100.0,12,20000,1667,4200,ace
2024-01-08,21,42400,2019.05,13,54800,4215,-12400,ace
2024-01-05,12,22600,1883.33,12,21000,1750,1600,ace
2024-01-04,24,71100,2962.5,17,61100,3594,10000,ace
2024-01-03,17,28400,1670.59,13,24300,1869,4100,ace
2024-01-02,25,50300,2012.0,19,50500,2658,-200,ace
2024-09-12,30,25800,860.0,32,65400,2044,-39600,acl
2024-09-11,59,80000,1355.93,45,84500,1878,-4500,acl
2024-09-10,62,65400,1054.84,68,112800,1659,-47400,acl
2024-09-09,35,35800,1022.86,42,64400,1533,-28600,acl
2024-09-06,25,25500,1020.0,63,104800,1663,-79300,acl
2024-09-05,36,43600,1211.11,52,88200,1696,-44600,acl
2024-09-04,37,47900,1294.59,54,101500,1880,-53600,acl
2024-08-30,66,57800,875.76,58,112600,1941,-54800,acl
2024-08-29,51,53800,1054.9,46,101200,2200,-47400,acl
2024-08-28,50,39900,798.0,34,87900,2585,-48000,acl
2024-08-27,26,31300,1203.85,32,92900,2903,-61600,acl
2024-08-26,37,48700,1316.22,39,63700,1633,-15000,acl
2024-08-23,77,74500,967.53,64,103600,1619,-29100,acl
2024-08-22,62,50200,809.68,48,100700,2098,-50500,acl
2024-08-21,82,81300,991.46,62,126600,2042,-45300,acl
2024-08-20,50,50100,1002.0,46,102700,2233,-52600,acl
2024-08-19,40,40100,1002.5,50,81400,1628,-41300,acl
2024-08-16,77,80900,1050.65,58,63000,1086,17900,acl
2024-08-15,63,48100,763.49,41,74300,1812,-26200,acl
2024-08-14,36,32200,894.44,34,46100,1356,-13900,acl
2024-08-13,49,42900,875.51,31,68800,2219,-25900,acl
2024-08-12,44,31800,722.73,35,77500,2214,-45700,acl
2024-08-08,61,38300,627.87,49,72600,1482,-34300,acl
2024-08-07,60,33800,563.33,49,96100,1961,-62300,acl
2024-08-06,55,34700,630.91,50,79900,1598,-45200,acl
2024-08-05,83,56800,684.34,75,136700,1823,-79900,acl
2024-08-02,66,43200,654.55,50,43800,876,-600,acl
2024-08-01,127,108500,854.33,98,235400,2402,-126900,acl
2024-07-31,139,98500,708.63,85,136700,1608,-38200,acl
2024-07-30,81,66700,823.46,64,146600,2291,-79900,acl
2024-07-29,86,48200,560.47,73,134500,1842,-86300,acl
2024-07-26,39,37700,966.67,49,98200,2004,-60500,acl
2024-07-25,48,39400,820.83,57,93500,1640,-54100,acl
2024-07-24,56,35100,626.79,60,108700,1812,-73600,acl
2024-07-22,69,48500,702.9,51,67800,1329,-19300,acl
2024-07-19,60,35500,591.67,64,94300,1473,-58800,acl
2024-07-18,49,36100,736.73,68,134600,1979,-98500,acl
2024-07-17,44,41600,945.45,66,115900,1756,-74300,acl
2024-07-16,52,67600,1300.0,49,149900,3059,-82300,acl
2024-07-15,61,33300,545.9,89,141300,1588,-108000,acl
2024-07-12,70,97800,1397.14,61,116700,1913,-18900,acl
2024-07-11,62,80300,1295.16,83,152400,1836,-72100,acl
2024-07-10,78,61100,783.33,96,174900,1822,-113800,acl
2024-07-09,91,111000,1219.78,86,196600,2286,-85600,acl
2024-07-08,65,69900,1075.38,43,43000,1000,26900,acl
2024-07-05,67,45100,673.13,74,69100,934,-24000,acl
2024-07-04,84,60200,716.67,47,91400,1945,-31200,acl
2024-07-03,66,82700,1253.03,64,118200,1847,-35500,acl
2024-07-02,69,60100,871.01,96,179700,1872,-119600,acl
2024-07-01,113,81700,723.01,53,119800,2260,-38100,acl
2024-06-28,94,102100,1086.17,51,118300,2320,-16200,acl
2024-06-27,71,109300,1539.44,65,158400,2437,-49100,acl
2024-06-26,91,126300,1387.91,63,167700,2662,-41400,acl
2024-06-25,66,104800,1587.88,105,123700,1178,-18900,acl
2024-06-24,94,133200,1417.02,148,196700,1329,-63500,acl
2024-06-21,169,242700,1436.09,211,348300,1651,-105600,acl
2024-06-20,48,73600,1533.33,95,172200,1813,-98600,acl
2024-06-19,154,213500,1386.36,190,318700,1677,-105200,acl
2024-06-18,56,22400,400.0,84,135000,1607,-112600,acl
2024-06-17,89,115600,1298.88,99,166100,1678,-50500,acl
2024-06-14,73,109300,1497.26,104,141600,1362,-32300,acl
2024-06-13,79,83800,1060.76,114,139200,1221,-55400,acl
2024-06-12,91,89800,986.81,102,146800,1439,-57000,acl
2024-06-11,145,187700,1294.48,189,196900,1042,-9200,acl
2024-06-10,194,278200,1434.02,223,246100,1104,32100,acl
2024-06-07,195,207500,1064.1,173,204000,1179,3500,acl
2024-06-06,77,118400,1537.66,113,145000,1283,-26600,acl
2024-06-05,116,122700,1057.76,91,147700,1623,-25000,acl
2024-06-04,69,76100,1102.9,82,108300,1321,-32200,acl
2024-06-03,107,131100,1225.23,109,163100,1496,-32000,acl
2024-05-31,88,82600,938.64,90,151100,1679,-68500,acl
2024-05-30,54,36400,674.07,52,110600,2127,-74200,acl
2024-05-29,185,229400,1240.0,142,245000,1725,-15600,acl
2024-05-28,76,104200,1371.05,67,130100,1942,-25900,acl
2024-05-27,71,79300,1116.9,86,113500,1320,-34200,acl
2024-05-24,69,72700,1053.62,93,130100,1399,-57400,acl
2024-05-23,60,52600,876.67,74,104800,1416,-52200,acl
2024-05-22,74,90400,1221.62,105,143400,1366,-53000,acl
2024-05-21,72,77100,1070.83,70,118600,1694,-41500,acl
2024-05-20,118,92800,786.44,97,113400,1169,-20600,acl
2024-05-17,102,105800,1037.25,97,138900,1432,-33100,acl
2024-05-16,72,71700,995.83,64,152100,2377,-80400,acl
2024-05-15,107,167800,1568.22,88,145300,1651,22500,acl
2024-05-14,100,135300,1353.0,139,230300,1657,-95000,acl
2024-05-13,90,91700,1018.89,74,94200,1273,-2500,acl
2024-05-10,82,45100,550.0,74,78900,1066,-33800,acl
2024-05-09,177,197700,1116.95,222,230500,1038,-32800,acl
2024-05-08,51,26900,527.45,47,64000,1362,-37100,acl
2024-05-07,46,25500,554.35,55,42600,775,-17100,acl
2024-05-06,47,22000,468.09,63,38400,610,-16400,acl
2024-05-03,35,30700,877.14,47,37200,791,-6500,acl
2024-05-02,60,83300,1388.33,74,118500,1601,-35200,acl
2024-04-26,43,32700,760.47,29,42400,1462,-9700,acl
2024-04-25,41,26200,639.02,48,69100,1440,-42900,acl
2024-04-24,41,20500,500.0,52,77400,1488,-56900,acl
2024-04-23,21,33700,1604.76,43,81400,1893,-47700,acl
2024-04-22,36,13900,386.11,40,43500,1088,-29600,acl
2024-04-19,59,46100,781.36,58,59100,1019,-13000,acl
2024-04-17,46,40300,876.09,56,53600,957,-13300,acl
2024-04-16,61,46600,763.93,84,97900,1165,-51300,acl
2024-04-15,75,111100,1481.33,78,131700,1688,-20600,acl
2024-04-12,57,45700,801.75,91,174800,1921,-129100,acl
2024-04-11,56,55200,985.71,69,117500,1703,-62300,acl
2024-04-10,58,50400,868.97,43,99700,2319,-49300,acl
2024-04-09,35,29700,848.57,35,65900,1883,-36200,acl
2024-04-08,76,66200,871.05,49,94600,1931,-28400,acl
2024-04-05,66,65600,993.94,63,83100,1319,-17500,acl
2024-04-04,64,76000,1187.5,82,74600,910,1400,acl
2024-04-03,49,52500,1071.43,97,80200,827,-27700,acl
2024-04-02,40,30100,752.5,120,130200,1085,-100100,acl
2024-04-01,63,82500,1309.52,60,54200,903,28300,acl
2024-03-29,89,101200,1137.08,66,96500,1462,4700,acl
2024-03-28,50,42000,840.0,54,49600,919,-7600,acl
2024-03-27,83,65600,790.36,72,83400,1158,-17800,acl
2024-03-26,76,90100,1185.53,83,100900,1216,-10800,acl
2024-03-25,47,71200,1514.89,74,84800,1146,-13600,acl
2024-03-22,69,176800,2562.32,83,90100,1086,86700,acl
2024-03-21,87,95000,1091.95,114,125200,1098,-30200,acl
2024-03-20,99,55700,562.63,82,71900,877,-16200,acl
2024-03-19,63,37800,600.0,67,48200,719,-10400,acl
2024-03-18,98,79900,815.31,83,118500,1428,-38600,acl
2024-03-15,49,46400,946.94,75,78700,1049,-32300,acl
2024-03-14,83,159800,1925.3,116,258000,2224,-98200,acl
2024-03-13,83,125400,1510.84,103,167400,1625,-42000,acl
2024-03-12,142,129700,913.38,64,178700,2792,-49000,acl
2024-03-11,77,108700,1411.69,156,261300,1675,-152600,acl
2024-03-08,57,37800,663.16,88,157000,1784,-119200,acl
2024-03-07,96,96300,1003.12,89,95200,1070,1100,acl
2024-03-06,95,78300,824.21,116,201300,1735,-123000,acl
2024-03-05,106,135200,1275.47,154,244400,1587,-109200,acl
2024-03-04,105,115300,1098.1,151,193300,1280,-78000,acl
2024-03-01,104,81300,781.73,94,92000,979,-10700,acl
2024-02-29,105,97300,926.67,105,177600,1691,-80300,acl
2024-02-28,141,156300,1108.51,174,271100,1558,-114800,acl
2024-02-27,123,137900,1121.14,214,281300,1314,-143400,acl
2024-02-26,274,471900,1722.26,281,311900,1110,160000,acl
2024-02-23,140,273100,1950.71,176,218200,1240,54900,acl
2024-02-22,85,109600,1289.41,72,86100,1196,23500,acl
2024-02-21,71,146100,2057.75,51,78200,1533,67900,acl
2024-02-20,72,76500,1062.5,66,79700,1208,-3200,acl
2024-02-19,94,118000,1255.32,110,109700,997,8300,acl
2024-02-16,68,141000,2073.53,54,75500,1398,65500,acl
2024-02-15,46,87500,1902.17,67,99400,1484,-11900,acl
2024-02-07,0,0,0.0,0,0,0,0,acl
2024-02-06,33,87400,2648.48,48,64000,1333,23400,acl
2024-02-05,34,41600,1223.53,47,72800,1549,-31200,acl
2024-02-02,50,65000,1300.0,62,83100,1340,-18100,acl
2024-02-01,60,89500,1491.67,48,63100,1315,26400,acl
2024-01-31,70,74400,1062.86,61,76100,1248,-1700,acl
2024-01-30,51,76200,1494.12,65,79600,1225,-3400,acl
2024-01-29,63,89000,1412.7,65,118700,1826,-29700,acl
2024-01-26,52,80700,1551.92,61,68200,1118,12500,acl
2024-01-25,42,58700,1397.62,85,107700,1267,-49000,acl
2024-01-24,39,60000,1538.46,70,62200,889,-2200,acl
2024-01-23,53,87900,1658.49,67,61300,915,26600,acl
2024-01-22,63,118500,1880.95,113,83100,735,35400,acl
2024-01-19,55,112300,2041.82,85,104700,1232,7600,acl
2024-01-18,64,82800,1293.75,61,54200,889,28600,acl
2024-01-17,66,65000,984.85,56,70900,1266,-5900,acl
2024-01-16,61,105000,1721.31,83,98700,1189,6300,acl
2024-01-15,66,112500,1704.55,80,73100,914,39400,acl
2024-01-12,66,57800,875.76,50,63100,1262,-5300,acl
2024-01-11,94,160000,1702.13,81,151500,1870,8500,acl
2024-01-10,0,0,0.0,0,0,0,0,acl
2024-01-09,115,101700,884.35,66,132800,2012,-31100,acl
2024-01-08,81,76300,941.98,52,123600,2377,-47300,acl
2024-01-05,129,124400,964.34,73,123000,1685,1400,acl
2024-01-04,111,143300,1290.99,99,149400,1509,-6100,acl
2024-01-03,84,237100,2822.62,100,85800,858,151300,acl
2024-01-02,112,129800,1158.93,78,56200,721,73600,acl
2024-09-12,0,0,0.0,0,0,0,0,acm
2024-09-11,0,0,0.0,0,0,0,0,acm
2024-09-10,0,0,0.0,0,0,0,0,acm
2024-09-09,0,0,0.0,0,0,0,0,acm
2024-09-06,111,1822800,16421.62,89,1308100,14698,514700,acm
2024-09-05,0,0,0.0,0,0,0,0,acm
2024-09-04,0,0,0.0,0,0,0,0,acm
2024-08-30,104,772500,7427.88,132,1514300,11472,-741800,acm
2024-08-29,0,0,0.0,0,0,0,0,acm
2024-08-28,0,0,0.0,0,0,0,0,acm
2024-08-27,0,0,0.0,0,0,0,0,acm
2024-08-26,0,0,0.0,0,0,0,0,acm
2024-08-23,132,2149000,16280.3,106,1290500,12175,858500,acm
2024-08-22,0,0,0.0,0,0,0,0,acm
2024-08-21,0,0,0.0,0,0,0,0,acm
2024-08-20,0,0,0.0,0,0,0,0,acm
2024-08-19,0,0,0.0,0,0,0,0,acm
2024-08-16,144,12859500,89302.08,120,1511000,12592,11348500,acm
2024-08-15,0,0,0.0,0,0,0,0,acm
2024-08-14,0,0,0.0,0,0,0,0,acm
2024-08-13,0,0,0.0,0,0,0,0,acm
2024-08-12,0,0,0.0,0,0,0,0,acm
2024-08-09,98,3020600,30822.45,89,1136300,12767,1884300,acm
2024-08-08,0,0,0.0,0,0,0,0,acm
2024-08-07,0,0,0.0,0,0,0,0,acm
2024-08-06,0,0,0.0,0,0,0,0,acm
2024-08-05,0,0,0.0,0,0,0,0,acm
2024-08-02,112,1391500,12424.11,134,1571800,11730,-180300,acm
2024-08-01,0,0,0.0,0,0,0,0,acm
2024-07-31,0,0,0.0,0,0,0,0,acm
2024-07-30,0,0,0.0,0,0,0,0,acm
2024-07-29,0,0,0.0,0,0,0,0,acm
2024-07-26,111,1917400,17273.87,119,1504500,12643,412900,acm
2024-07-25,0,0,0.0,0,0,0,0,acm
2024-07-24,0,0,0.0,0,0,0,0,acm
2024-07-23,0,0,0.0,0,0,0,0,acm
2024-07-22,0,0,0.0,0,0,0,0,acm
2024-07-19,176,2706300,15376.7,136,2020300,14855,686000,acm
2024-07-18,0,0,0.0,0,0,0,0,acm
2024-07-17,0,0,0.0,0,0,0,0,acm
2024-07-16,0,0,0.0,0,0,0,0,acm
2024-07-15,0,0,0.0,0,0,0,0,acm
2024-07-12,306,5225200,17075.82,88,1393900,15840,3831300,acm
2024-07-11,0,0,0.0,0,0,0,0,acm
2024-07-10,0,0,0.0,0,0,0,0,acm
2024-07-09,0,0,0.0,0,0,0,0,acm
2024-07-08,0,0,0.0,0,0,0,0,acm
2024-07-05,213,28045100,131667.14,152,2480200,16317,25564900,acm
2024-07-04,0,0,0.0,0,0,0,0,acm
2024-07-03,0,0,0.0,0,0,0,0,acm
2024-07-02,0,0,0.0,0,0,0,0,acm
2024-07-01,0,0,0.0,0,0,0,0,acm
2024-06-28,148,1009200,6818.92,134,1163700,8684,-154500,acm
2024-06-27,0,0,0.0,0,0,0,0,acm
2024-06-26,0,0,0.0,0,0,0,0,acm
2024-06-25,0,0,0.0,0,0,0,0,acm
2024-06-24,0,0,0.0,0,0,0,0,acm
2024-06-21,242,1108500,4580.58,244,2425400,9940,-1316900,acm
2024-06-20,0,0,0.0,0,0,0,0,acm
2024-06-19,0,0,0.0,0,0,0,0,acm
2024-06-18,0,0,0.0,0,0,0,0,acm
2024-06-17,0,0,0.0,0,0,0,0,acm
2024-06-14,279,1104100,3957.35,275,2830400,10292,-1726300,acm
2024-06-13,0,0,0.0,0,0,0,0,acm
2024-06-12,0,0,0.0,0,0,0,0,acm
2024-06-11,0,0,0.0,0,0,0,0,acm
2024-06-10,0,0,0.0,0,0,0,0,acm
2024-06-07,511,6254100,12238.94,177,4871500,27523,1382600,acm
2024-06-06,0,0,0.0,0,0,0,0,acm
2024-06-05,0,0,0.0,0,0,0,0,acm
2024-06-04,0,0,0.0,0,0,0,0,acm
2024-06-03,0,0,0.0,0,0,0,0,acm
2024-05-31,217,16843300,77618.89,91,1247500,13709,15595800,acm
2024-05-30,0,0,0.0,0,0,0,0,acm
2024-05-29,0,0,0.0,0,0,0,0,acm
2024-05-28,0,0,0.0,0,0,0,0,acm
2024-05-27,0,0,0.0,0,0,0,0,acm
2024-05-24,214,13377000,62509.35,216,2044400,9465,11332600,acm
2024-05-23,0,0,0.0,0,0,0,0,acm
2024-05-22,0,0,0.0,0,0,0,0,acm
2024-05-21,0,0,0.0,0,0,0,0,acm
2024-05-20,0,0,0.0,0,0,0,0,acm
2024-05-17,311,5862200,18849.52,127,1196500,9421,4665700,acm
2024-05-16,0,0,0.0,0,0,0,0,acm
2024-05-15,0,0,0.0,0,0,0,0,acm
2024-05-14,0,0,0.0,0,0,0,0,acm
2024-05-13,0,0,0.0,0,0,0,0,acm
2024-05-10,199,2269700,11405.53,166,2028300,12219,241400,acm
2024-05-09,0,0,0.0,0,0,0,0,acm
2024-05-08,0,0,0.0,0,0,0,0,acm
2024-05-07,0,0,0.0,0,0,0,0,acm
2024-05-06,0,0,0.0,0,0,0,0,acm
2024-05-03,131,2531100,19321.37,68,600200,8826,1930900,acm
2024-05-02,0,0,0.0,0,0,0,0,acm
2024-04-26,123,1632700,13273.98,133,1485200,11167,147500,acm
2024-04-25,0,0,0.0,0,0,0,0,acm
2024-04-24,0,0,0.0,0,0,0,0,acm
2024-04-23,0,0,0.0,0,0,0,0,acm
2024-04-22,0,0,0.0,0,0,0,0,acm
2024-04-19,118,2487400,21079.66,115,1986000,17270,501400,acm
2024-04-17,0,0,0.0,0,0,0,0,acm
2024-04-16,0,0,0.0,0,0,0,0,acm
2024-04-15,0,0,0.0,0,0,0,0,acm
2024-04-12,184,2675400,14540.22,150,1876500,12510,798900,acm
2024-04-11,0,0,0.0,0,0,0,0,acm
2024-04-10,0,0,0.0,0,0,0,0,acm
2024-04-09,0,0,0.0,0,0,0,0,acm
2024-04-08,0,0,0.0,0,0,0,0,acm
2024-04-05,170,2551300,15007.65,177,1330500,7517,1220800,acm
2024-04-04,0,0,0.0,0,0,0,0,acm
2024-04-03,0,0,0.0,0,0,0,0,acm
2024-04-02,0,0,0.0,0,0,0,0,acm
2024-04-01,0,0,0.0,0,0,0,0,acm
2024-03-29,217,3322100,15309.22,157,1420200,9046,1901900,acm
2024-03-28,0,0,0.0,0,0,0,0,acm
2024-03-27,0,0,0.0,0,0,0,0,acm
2024-03-26,0,0,0.0,0,0,0,0,acm
2024-03-25,0,0,0.0,0,0,0,0,acm
2024-03-22,383,4806300,12549.09,111,699800,6305,4106500,acm
2024-03-21,0,0,0.0,0,0,0,0,acm
2024-03-20,0,0,0.0,0,0,0,0,acm
2024-03-19,0,0,0.0,0,0,0,0,acm
2024-03-18,0,0,0.0,0,0,0,0,acm
2024-03-15,251,2104000,8382.47,154,1603400,10412,500600,acm
2024-03-14,0,0,0.0,0,0,0,0,acm
2024-03-13,0,0,0.0,0,0,0,0,acm
2024-03-12,0,0,0.0,0,0,0,0,acm
2024-03-11,0,0,0.0,0,0,0,0,acm
2024-03-08,267,2579000,9659.18,169,1520100,8995,1058900,acm
2024-03-07,0,0,0.0,0,0,0,0,acm
2024-03-06,0,0,0.0,0,0,0,0,acm
2024-03-05,0,0,0.0,0,0,0,0,acm
2024-03-04,0,0,0.0,0,0,0,0,acm
2024-03-01,294,2528700,8601.02,169,1860100,11007,668600,acm
2024-02-29,0,0,0.0,0,0,0,0,acm
2024-02-28,0,0,0.0,0,0,0,0,acm
2024-02-27,0,0,0.0,0,0,0,0,acm
2024-02-26,0,0,0.0,0,0,0,0,acm
2024-02-23,305,3907000,12809.84,165,923300,5596,2983700,acm
2024-02-22,0,0,0.0,0,0,0,0,acm
2024-02-21,0,0,0.0,0,0,0,0,acm
2024-02-20,0,0,0.0,0,0,0,0,acm
2024-02-19,0,0,0.0,0,0,0,0,acm
2024-02-16,119,1871700,15728.57,120,1333800,11115,537900,acm
2024-02-15,0,0,0.0,0,0,0,0,acm
2024-02-07,0,0,0.0,0,0,0,0,acm
2024-02-06,0,0,0.0,0,0,0,0,acm
2024-02-05,0,0,0.0,0,0,0,0,acm
2024-02-02,122,816100,6689.34,136,1489300,10951,-673200,acm
2024-02-01,0,0,0.0,0,0,0,0,acm
2024-01-31,0,0,0.0,0,0,0,0,acm
2024-01-30,0,0,0.0,0,0,0,0,acm
2024-01-29,0,0,0.0,0,0,0,0,acm
2024-01-26,138,1178700,8541.3,147,1619600,11018,-440900,acm
2024-01-25,0,0,0.0,0,0,0,0,acm
2024-01-24,0,0,0.0,0,0,0,0,acm
2024-01-23,0,0,0.0,0,0,0,0,acm
2024-01-22,0,0,0.0,0,0,0,0,acm
2024-01-19,118,2158100,18288.98,151,1585000,10497,573100,acm
2024-01-18,0,0,0.0,0,0,0,0,acm
2024-01-17,0,0,0.0,0,0,0,0,acm
2024-01-16,0,0,0.0,0,0,0,0,acm
2024-01-15,0,0,0.0,0,0,0,0,acm
2024-01-12,111,702400,6327.93,151,1719000,11384,-1016600,acm
2024-01-11,0,0,0.0,0,0,0,0,acm
2024-01-10,0,0,0.0,0,0,0,0,acm
2024-01-09,0,0,0.0,0,0,0,0,acm
2024-01-08,0,0,0.0,0,0,0,0,acm
2024-01-05,141,616000,4368.79,135,1694700,12553,-1078700,acm
2024-01-04,0,0,0.0,0,0,0,0,acm
2024-01-03,0,0,0.0,0,0,0,0,acm
2024-01-02,0,0,0.0,0,0,0,0,acm
2024-09-12,217,93500,430.88,242,137200,567,-43700,acv
2024-09-11,301,212000,704.32,259,153600,593,58400,acv
2024-09-10,288,275900,957.99,215,226500,1053,49400,acv
2024-09-09,273,124800,457.14,148,108600,734,16200,acv
2024-09-06,522,271600,520.31,225,215800,959,55800,acv
2024-09-05,387,162800,420.67,271,272200,1004,-109400,acv
2024-09-04,373,204600,548.53,256,259400,1013,-54800,acv
2024-08-30,215,197200,917.21,245,199900,816,-2700,acv
2024-08-29,326,166700,511.35,310,240800,777,-74100,acv
2024-08-28,277,142600,514.8,290,245300,846,-102700,acv
2024-08-27,567,277500,489.42,312,276600,887,900,acv
2024-08-26,649,293700,452.54,390,359900,923,-66200,acv
2024-08-23,646,297300,460.22,609,352500,579,-55200,acv
2024-08-22,286,184300,644.41,471,393700,836,-209400,acv
2024-08-21,340,242100,712.06,471,351500,746,-109400,acv
2024-08-20,406,238900,588.42,540,376700,698,-137800,acv
2024-08-19,568,334600,589.08,604,377400,625,-42800,acv
2024-08-16,519,353100,680.35,672,398600,593,-45500,acv
2024-08-15,366,204900,559.84,350,261400,747,-56500,acv
2024-08-14,501,249200,497.41,376,292600,778,-43400,acv
2024-08-13,562,351700,625.8,888,444700,501,-93000,acv
2024-08-12,452,214600,474.78,400,270500,676,-55900,acv
2024-08-09,882,524100,594.22,895,476700,533,47400,acv
2024-08-08,613,279100,455.3,406,317800,783,-38700,acv
2024-08-07,640,315300,492.66,710,336900,475,-21600,acv
2024-08-06,1917,956900,499.17,1701,955700,562,1200,acv
2024-08-05,669,320500,479.07,430,421400,980,-100900,acv
2024-08-02,514,343700,668.68,452,344800,763,-1100,acv
2024-08-01,695,429800,618.42,531,501600,945,-71800,acv
2024-07-31,954,516900,541.82,782,585400,749,-68500,acv
2024-07-30,965,337300,349.53,831,453800,546,-116500,acv
2024-07-29,918,491400,535.29,722,600000,831,-108600,acv
2024-07-26,1254,483200,385.33,853,512600,601,-29400,acv
2024-07-25,1129,554000,490.7,889,535900,603,18100,acv
2024-07-24,589,384600,652.97,504,358600,712,26000,acv
2024-07-23,613,366700,598.21,565,391200,692,-24500,acv
2024-07-22,688,463700,673.98,611,409900,671,53800,acv
2024-07-19,442,261500,591.63,403,297600,738,-36100,acv
2024-07-18,1219,645700,529.7,681,622600,914,23100,acv
2024-07-17,2212,1103400,498.82,1387,1109700,800,-6300,acv
2024-07-16,1276,625400,490.13,749,718300,959,-92900,acv
2024-07-15,1086,491400,452.49,497,518400,1043,-27000,acv
2024-07-12,657,385700,587.06,650,415400,639,-29700,acv
2024-07-11,1358,736700,542.49,562,556900,991,179800,acv
2024-07-10,1376,659100,479.0,585,650300,1112,8800,acv
2024-07-09,1154,540300,468.2,537,558500,1040,-18200,acv
2024-07-08,686,376000,548.1,776,478400,616,-102400,acv
2024-07-05,843,476400,565.12,814,551900,678,-75500,acv
2024-07-04,856,428300,500.35,808,475400,588,-47100,acv
2024-07-03,1008,602800,598.02,521,603800,1159,-1000,acv
2024-07-02,498,319900,642.37,454,283500,624,36400,acv
2024-07-01,1358,776100,571.5,958,700200,731,75900,acv
2024-06-28,860,432300,502.67,614,640400,1043,-208100,acv
2024-06-27,877,546200,622.81,559,655500,1173,-109300,acv
2024-06-26,751,424200,564.85,796,550500,692,-126300,acv
2024-06-25,808,460200,569.55,486,448500,923,11700,acv
2024-06-24,2763,1353600,489.9,1508,1337900,887,15700,acv
2024-06-21,895,644600,720.22,850,653800,769,-9200,acv
2024-06-20,883,633400,717.33,863,627500,727,5900,acv
2024-06-19,1193,624600,523.55,649,581900,897,42700,acv
2024-06-18,618,403400,652.75,638,441000,691,-37600,acv
2024-06-17,1360,821400,603.97,1047,704000,672,117400,acv
2024-06-14,1835,1118600,609.59,1406,1283400,913,-164800,acv
2024-06-13,1123,936900,834.28,1220,682300,559,254600,acv
2024-06-12,517,439500,850.1,563,381100,677,58400,acv
2024-06-11,675,650500,963.7,799,653700,818,-3200,acv
2024-06-10,965,797600,826.53,959,656000,684,141600,acv
2024-06-07,737,634700,861.19,959,641100,669,-6400,acv
2024-06-06,956,530800,555.23,549,456400,831,74400,acv
2024-06-05,1636,854900,522.56,1135,933100,822,-78200,acv
2024-06-04,938,669100,713.33,764,629300,824,39800,acv
2024-06-03,839,747500,890.94,956,623000,652,124500,acv
2024-05-31,926,781600,844.06,1314,822100,626,-40500,acv
2024-05-30,1191,710100,596.22,945,674100,713,36000,acv
2024-05-29,849,718500,846.29,1413,696900,493,21600,acv
2024-05-28,1117,1043300,934.02,1398,996900,713,46400,acv
2024-05-27,760,556800,732.63,404,470400,1164,86400,acv
2024-05-24,838,767700,916.11,1062,828400,780,-60700,acv
2024-05-23,814,521100,640.17,531,461800,870,59300,acv
2024-05-22,875,542400,619.89,468,539500,1153,2900,acv
2024-05-21,937,446700,476.73,518,533200,1029,-86500,acv
2024-05-20,662,568200,858.31,1108,668300,603,-100100,acv
2024-05-17,1131,1287900,1138.73,1731,1265800,731,22100,acv
2024-05-16,873,619400,709.51,606,698400,1152,-79000,acv
2024-05-15,618,530800,858.9,831,646500,778,-115700,acv
2024-05-14,649,585000,901.39,643,598600,931,-13600,acv
2024-05-13,1044,800900,767.15,520,722400,1389,78500,acv
2024-05-10,803,619700,771.73,519,490700,945,129000,acv
2024-05-09,652,749900,1150.15,1081,753700,697,-3800,acv
2024-05-08,866,908800,1049.42,698,668100,957,240700,acv
2024-05-07,891,1169000,1312.01,773,695500,900,473500,acv
2024-05-06,850,893300,1050.94,820,804400,981,88900,acv
2024-05-03,796,1306600,1641.46,864,842700,975,463900,acv
2024-05-02,1002,1391900,1389.12,1373,1182500,861,209400,acv
2024-04-26,295,355700,1205.76,478,343900,719,11800,acv
2024-04-25,677,501700,741.06,469,515800,1100,-14100,acv
2024-04-24,634,416300,656.62,673,498400,741,-82100,acv
2024-04-23,347,370300,1067.15,360,449800,1249,-79500,acv
2024-04-22,280,410900,1467.5,286,361800,1265,49100,acv
2024-04-19,354,962900,2720.06,406,530400,1306,432500,acv
2024-04-17,554,965300,1742.42,559,810700,1450,154600,acv
2024-04-16,458,676800,1477.73,371,419700,1131,257100,acv
2024-04-15,1127,1634900,1450.67,933,1441400,1545,193500,acv
2024-04-12,274,407300,1486.5,354,535400,1512,-128100,acv
2024-04-11,375,416100,1109.6,514,590100,1148,-174000,acv
2024-04-10,326,587000,1800.61,446,702600,1575,-115600,acv
2024-04-09,308,410800,1333.77,287,479400,1670,-68600,acv
2024-04-08,244,308100,1262.7,256,449700,1757,-141600,acv
2024-04-05,409,635100,1552.81,491,578800,1179,56300,acv
2024-04-04,322,321500,998.45,261,439100,1682,-117600,acv
2024-04-03,498,662600,1330.52,327,724900,2217,-62300,acv
2024-04-02,272,280800,1032.35,367,476600,1299,-195800,acv
2024-04-01,317,301900,952.37,330,470200,1425,-168300,acv
2024-03-29,265,373000,1407.55,388,564800,1456,-191800,acv
2024-03-28,257,348200,1354.86,426,455800,1070,-107600,acv
2024-03-27,502,590600,1176.49,395,490200,1241,100400,acv
2024-03-26,374,394600,1055.08,285,330100,1158,64500,acv
2024-03-25,485,493400,1017.32,393,503200,1280,-9800,acv
2024-03-22,450,434100,964.67,418,582000,1392,-147900,acv
2024-03-21,388,433800,1118.04,298,453500,1522,-19700,acv
2024-03-20,585,619300,1058.63,284,548400,1931,70900,acv
2024-03-19,613,568500,927.41,983,636800,648,-68300,acv
2024-03-18,770,706900,918.05,487,640200,1315,66700,acv
2024-03-15,446,628300,1408.74,469,630900,1345,-2600,acv
2024-03-14,353,405900,1149.86,303,316100,1043,89800,acv
2024-03-13,564,936000,1659.57,761,743500,977,192500,acv
2024-03-12,657,1199900,1826.33,822,1036900,1261,163000,acv
2024-03-11,302,544700,1803.64,334,460500,1379,84200,acv
2024-03-08,464,539300,1162.28,335,439500,1312,99800,acv
2024-03-07,557,716100,1285.64,264,511700,1938,204400,acv
2024-03-06,513,569900,1110.92,332,462300,1392,107600,acv
2024-03-05,350,342100,977.43,325,398700,1227,-56600,acv
2024-03-04,663,1093100,1648.72,534,847400,1587,245700,acv
2024-03-01,378,461900,1221.96,397,387300,976,74600,acv
2024-02-29,341,523600,1535.48,368,402000,1092,121600,acv
2024-02-28,332,675800,2035.54,549,468900,854,206900,acv
2024-02-27,381,815100,2139.37,465,559100,1202,256000,acv
2024-02-26,318,494700,1555.66,250,296100,1184,198600,acv
2024-02-23,399,454100,1138.1,329,479700,1458,-25600,acv
2024-02-22,385,402300,1044.94,302,350200,1160,52100,acv
2024-02-21,501,868100,1732.73,530,621700,1173,246400,acv
2024-02-20,314,451600,1438.22,362,430100,1188,21500,acv
2024-02-19,281,391300,1392.53,399,430600,1079,-39300,acv
2024-02-16,390,679000,1741.03,504,605800,1202,73200,acv
2024-02-15,272,354700,1304.04,339,358800,1058,-4100,acv
2024-02-07,315,301300,956.51,369,350700,950,-49400,acv
2024-02-06,286,281700,984.97,353,336700,954,-55000,acv
2024-02-05,456,604300,1325.22,497,527900,1062,76400,acv
2024-02-02,541,627000,1158.96,677,625700,924,1300,acv
2024-02-01,452,668600,1479.2,764,592000,775,76600,acv
2024-01-31,446,1097100,2459.87,1469,912600,621,184500,acv
2024-01-30,503,586100,1165.21,859,506200,589,79900,acv
2024-01-29,289,302500,1046.71,788,286300,363,16200,acv
2024-01-26,566,537100,948.94,1007,472300,469,64800,acv
2024-01-25,585,518500,886.32,882,425700,483,92800,acv
2024-01-24,226,252300,1116.37,508,190200,374,62100,acv
2024-01-23,261,230400,882.76,444,148400,334,82000,acv
2024-01-22,221,181700,822.17,523,174500,334,7200,acv
2024-01-19,220,230500,1047.73,459,230700,503,-200,acv
2024-01-18,165,180400,1093.33,406,159600,393,20800,acv
2024-01-17,222,216300,974.32,485,161000,332,55300,acv
2024-01-16,278,210100,755.76,441,152100,345,58000,acv
2024-01-15,176,188700,1072.16,467,145100,311,43600,acv
2024-01-12,281,208300,741.28,516,176600,342,31700,acv
2024-01-11,289,257600,891.35,645,249600,387,8000,acv
2024-01-10,235,154400,657.02,472,147600,313,6800,acv
2024-01-09,273,274000,1003.66,720,278000,386,-4000,acv
2024-01-08,232,185400,799.14,588,194600,331,-9200,acv
2024-01-05,351,157400,448.43,820,191500,234,-34100,acv
2024-01-04,385,237100,615.84,667,269400,404,-32300,acv
2024-01-03,280,242600,866.43,396,233700,590,8900,acv
2024-01-02,433,196700,454.27,280,215100,768,-18400,acv
2024-09-12,7,2300,328.57,3,700,233,1600,adc
2024-09-11,9,3500,388.89,3,700,233,2800,adc
2024-09-10,7,3200,457.14,5,800,160,2400,adc
2024-09-09,12,4500,375.0,6,2100,350,2400,adc
2024-09-06,9,3500,388.89,3,300,100,3200,adc
2024-09-05,10,4600,460.0,3,300,100,4300,adc
2024-09-04,13,3300,253.85,3,700,233,2600,adc
2024-08-30,6,2300,383.33,4,1200,300,1100,adc
2024-08-29,7,3300,471.43,4,1000,250,2300,adc
2024-08-28,11,3100,281.82,4,900,225,2200,adc
2024-08-27,14,5200,371.43,3,1100,367,4100,adc
2024-08-26,13,6100,469.23,5,900,180,5200,adc
2024-08-23,10,3700,370.0,4,400,100,3300,adc
2024-08-22,12,3300,275.0,14,5500,393,-2200,adc
2024-08-21,2,10100,5050.0,5,1100,220,9000,adc
2024-08-20,8,5700,712.5,6,2400,400,3300,adc
2024-08-19,4,3500,875.0,3,1300,433,2200,adc
2024-08-16,5,4200,840.0,3,1300,433,2900,adc
2024-08-15,9,1900,211.11,3,1300,433,600,adc
2024-08-14,8,3400,425.0,3,1800,600,1600,adc
2024-08-13,4,2500,625.0,5,2800,560,-300,adc
2024-08-12,4,3600,900.0,4,3400,850,200,adc
2024-08-09,8,2200,275.0,6,4100,683,-1900,adc
2024-08-08,7,3500,500.0,4,2800,700,700,adc
2024-08-07,6,1700,283.33,4,2800,700,-1100,adc
2024-08-06,12,4200,350.0,6,4000,667,200,adc
2024-08-05,8,1000,125.0,4,2900,725,-1900,adc
2024-08-02,5,6300,1260.0,3,2900,967,3400,adc
2024-08-01,11,3800,345.45,7,5800,829,-2000,adc
2024-07-31,17,9600,564.71,4,3300,825,6300,adc
2024-07-30,8,2200,275.0,5,2500,500,-300,adc
2024-07-29,4,2200,550.0,6,2500,417,-300,adc
2024-07-26,5,7200,1440.0,5,3400,680,3800,adc
2024-07-25,7,2400,342.86,7,3600,514,-1200,adc
2024-07-24,3,1200,400.0,4,1400,350,-200,adc
2024-07-23,5,1400,280.0,5,3400,680,-2000,adc
2024-07-22,8,1500,187.5,7,3500,500,-2000,adc
2024-07-19,4,1600,400.0,4,500,125,1100,adc
2024-07-18,6,1500,250.0,4,3400,850,-1900,adc
2024-07-17,8,3100,387.5,4,800,200,2300,adc
2024-07-16,8,2300,287.5,8,5200,650,-2900,adc
2024-07-15,7,3200,457.14,6,4500,750,-1300,adc
2024-07-12,4,4100,1025.0,8,3000,375,1100,adc
2024-07-11,19,10300,542.11,8,5800,725,4500,adc
2024-07-10,6,2300,383.33,5,4600,920,-2300,adc
2024-07-09,5,1700,340.0,3,3500,1167,-1800,adc
2024-07-08,6,1700,283.33,4,3700,925,-2000,adc
2024-07-05,7,4400,628.57,6,6600,1100,-2200,adc
2024-07-04,10,3600,360.0,7,4200,600,-600,adc
2024-07-03,9,4700,522.22,7,6500,929,-1800,adc
2024-07-02,6,3400,566.67,3,2700,900,700,adc
2024-07-01,6,3400,566.67,3,2500,833,900,adc
2024-06-28,22,13300,604.55,17,12800,753,500,adc
2024-06-27,17,4400,258.82,5,2600,520,1800,adc
2024-06-26,17,7500,441.18,13,13500,1038,-6000,adc
2024-06-25,9,5200,577.78,4,2900,725,2300,adc
2024-06-24,10,4000,400.0,3,1700,567,2300,adc
2024-06-21,10,3400,340.0,4,9600,2400,-6200,adc
2024-06-20,9,4900,544.44,5,9600,1920,-4700,adc
2024-06-19,12,5800,483.33,9,11800,1311,-6000,adc
2024-06-18,13,4300,330.77,4,2000,500,2300,adc
2024-06-17,6,2700,450.0,4,2000,500,700,adc
2024-06-14,16,8300,518.75,5,10800,2160,-2500,adc
2024-06-13,8,4000,500.0,4,2600,650,1400,adc
2024-06-12,4,2200,550.0,3,600,200,1600,adc
2024-06-11,10,5400,540.0,4,4700,1175,700,adc
2024-06-10,29,18500,637.93,7,7200,1029,11300,adc
2024-06-07,7,4300,614.29,4,3600,900,700,adc
2024-06-06,8,4600,575.0,5,4600,920,0,adc
2024-06-05,11,6700,609.09,6,8700,1450,-2000,adc
2024-06-04,13,5600,430.77,5,3600,720,2000,adc
2024-06-03,17,19100,1123.53,12,9000,750,10100,adc
2024-05-31,13,10800,830.77,9,11300,1256,-500,adc
2024-05-30,10,7000,700.0,8,11100,1388,-4100,adc
2024-05-29,28,34000,1214.29,18,17800,989,16200,adc
2024-05-28,13,8000,615.38,5,1700,340,6300,adc
2024-05-27,13,9500,730.77,4,2800,700,6700,adc
2024-05-24,14,3400,242.86,5,5800,1160,-2400,adc
2024-05-23,13,3300,253.85,6,5300,883,-2000,adc
2024-05-22,19,9000,473.68,10,9200,920,-200,adc
2024-05-21,17,5500,323.53,9,13600,1511,-8100,adc
2024-05-20,13,4300,330.77,7,5000,714,-700,adc
2024-05-17,14,5000,357.14,7,2600,371,2400,adc
2024-05-16,11,4500,409.09,9,3100,344,1400,adc
2024-05-15,14,13000,928.57,10,11000,1100,2000,adc
2024-05-14,9,4200,466.67,9,10300,1144,-6100,adc
2024-05-13,10,7600,760.0,10,8300,830,-700,adc
2024-05-10,9,3800,422.22,9,8500,944,-4700,adc
2024-05-09,17,15300,900.0,13,13700,1054,1600,adc
2024-05-08,9,5400,600.0,7,3600,514,1800,adc
2024-05-07,13,4700,361.54,8,3800,475,900,adc
2024-05-06,11,5600,509.09,8,3800,475,1800,adc
2024-05-03,41,15700,382.93,21,15100,719,600,adc
2024-05-02,9,4400,488.89,10,4100,410,300,adc
2024-04-26,10,5700,570.0,6,3700,617,2000,adc
2024-04-25,10,3600,360.0,8,3100,388,500,adc
2024-04-24,14,6200,442.86,9,4900,544,1300,adc
2024-04-23,9,4600,511.11,6,2700,450,1900,adc
2024-04-22,8,3200,400.0,7,3800,543,-600,adc
2024-04-19,13,4300,330.77,9,13300,1478,-9000,adc
2024-04-17,12,5600,466.67,9,13200,1467,-7600,adc
2024-04-16,13,4200,323.08,10,14100,1410,-9900,adc
2024-04-15,22,6700,304.55,5,21500,4300,-14800,adc
2024-04-12,49,17300,353.06,16,30300,1894,-13000,adc
2024-04-11,11,10700,972.73,6,22200,3700,-11500,adc
2024-04-10,15,6500,433.33,4,11800,2950,-5300,adc
2024-04-09,16,9400,587.5,11,15600,1418,-6200,adc
2024-04-08,9,4900,544.44,8,14900,1862,-10000,adc
2024-04-05,17,7600,447.06,14,7000,500,600,adc
2024-04-04,5,2500,500.0,4,1400,350,1100,adc
2024-04-03,12,4700,391.67,6,1200,200,3500,adc
2024-04-02,7,5200,742.86,4,2500,625,2700,adc
2024-04-01,11,19100,1736.36,7,3000,429,16100,adc
2024-03-29,8,6400,800.0,8,2000,250,4400,adc
2024-03-28,9,6700,744.44,14,7400,529,-700,adc
2024-03-27,10,4500,450.0,11,7000,636,-2500,adc
2024-03-26,10,4600,460.0,5,1400,280,3200,adc
2024-03-25,10,4700,470.0,10,3900,390,800,adc
2024-03-22,6,2200,366.67,10,1900,190,300,adc
2024-03-21,11,4200,381.82,5,2500,500,1700,adc
2024-03-20,11,13300,1209.09,13,8800,677,4500,adc
2024-03-19,15,12500,833.33,14,19200,1371,-6700,adc
2024-03-18,23,8900,386.96,24,12000,500,-3100,adc
2024-03-15,11,1800,163.64,8,8700,1088,-6900,adc
2024-03-14,15,8700,580.0,10,4700,470,4000,adc
2024-03-13,19,3700,194.74,9,3300,367,400,adc
2024-03-12,18,8800,488.89,10,2800,280,6000,adc
2024-03-11,10,6500,650.0,10,5200,520,1300,adc
2024-03-08,16,15200,950.0,9,17600,1956,-2400,adc
2024-03-07,21,4600,219.05,8,5900,738,-1300,adc
2024-03-06,32,9800,306.25,17,6900,406,2900,adc
2024-03-05,16,5000,312.5,4,600,150,4400,adc
2024-03-04,16,2000,125.0,5,1800,360,200,adc
2024-03-01,22,7400,336.36,13,5900,454,1500,adc
2024-02-29,31,14500,467.74,12,9000,750,5500,adc
2024-02-28,16,3900,243.75,5,1400,280,2500,adc
2024-02-27,10,6100,610.0,6,2500,417,3600,adc
2024-02-26,9,6500,722.22,5,3500,700,3000,adc
2024-02-23,15,5200,346.67,4,1100,275,4100,adc
2024-02-22,17,7300,429.41,7,2300,329,5000,adc
2024-02-21,5,2400,480.0,4,1100,275,1300,adc
2024-02-20,7,4200,600.0,4,2300,575,1900,adc
2024-02-19,10,9600,960.0,9,6000,667,3600,adc
2024-02-16,10,8600,860.0,13,8800,677,-200,adc
2024-02-15,9,11100,1233.33,6,2600,433,8500,adc
2024-02-07,9,2500,277.78,5,2800,560,-300,adc
2024-02-06,7,3000,428.57,6,3300,550,-300,adc
2024-02-05,9,2700,300.0,5,3200,640,-500,adc
2024-02-02,7,3700,528.57,7,4600,657,-900,adc
2024-02-01,6,2700,450.0,5,2600,520,100,adc
2024-01-31,10,3600,360.0,6,3900,650,-300,adc
2024-01-30,5,1900,380.0,3,1200,400,700,adc
2024-01-29,8,3600,450.0,6,2900,483,700,adc
2024-01-26,8,5800,725.0,3,1700,567,4100,adc
2024-01-25,14,19600,1400.0,6,11400,1900,8200,adc
2024-01-24,12,7800,650.0,9,3300,367,4500,adc
2024-01-23,9,5100,566.67,5,6200,1240,-1100,adc
2024-01-22,11,6800,618.18,7,5200,743,1600,adc
2024-01-19,12,6000,500.0,6,4900,817,1100,adc
2024-01-18,12,6900,575.0,4,3200,800,3700,adc
2024-01-17,9,3900,433.33,5,3900,780,0,adc
2024-01-16,15,8700,580.0,9,10400,1156,-1700,adc
2024-01-15,10,4200,420.0,8,8000,1000,-3800,adc
2024-01-12,10,9900,990.0,5,4900,980,5000,adc
2024-01-11,14,9200,657.14,6,3800,633,5400,adc
2024-01-10,10,5400,540.0,5,3600,720,1800,adc
2024-01-09,13,4200,323.08,9,4100,456,100,adc
2024-01-08,28,9800,350.0,17,11600,682,-1800,adc
2024-01-05,9,5800,644.44,10,7200,720,-1400,adc
2024-01-04,11,3600,327.27,11,6200,564,-2600,adc
2024-01-03,16,13700,856.25,9,6300,700,7400,adc
2024-01-02,9,5500,611.11,4,8900,2225,-3400,adc
2024-09-12,33,16200,490.91,38,36800,968,-20600,adp
2024-09-11,33,117300,3554.55,32,133300,4166,-16000,adp
2024-09-10,37,32300,872.97,18,35900,1994,-3600,adp
2024-09-09,36,21100,586.11,40,43700,1092,-22600,adp
2024-09-06,60,27300,455.0,28,27700,989,-400,adp
2024-09-05,43,23300,541.86,36,36000,1000,-12700,adp
2024-09-04,47,25200,536.17,31,26800,865,-1600,adp
2024-08-30,96,90700,944.79,84,96900,1154,-6200,adp
2024-08-29,46,33700,732.61,30,34900,1163,-1200,adp
2024-08-28,22,26200,1190.91,27,33400,1237,-7200,adp
2024-08-27,43,37000,860.47,36,28900,803,8100,adp
2024-08-26,51,35100,688.24,45,41300,918,-6200,adp
2024-08-23,47,28100,597.87,46,30700,667,-2600,adp
2024-08-22,48,30100,627.08,48,42400,883,-12300,adp
2024-08-21,36,37300,1036.11,30,36100,1203,1200,adp
2024-08-20,43,37100,862.79,33,36100,1094,1000,adp
2024-08-19,63,50800,806.35,53,39500,745,11300,adp
2024-08-16,68,28700,422.06,38,39600,1042,-10900,adp
2024-08-15,113,89300,790.27,30,52000,1733,37300,adp
2024-08-14,120,44500,370.83,84,67400,802,-22900,adp
2024-08-13,57,19700,345.61,37,33900,916,-14200,adp
2024-08-12,33,20100,609.09,32,20400,638,-300,adp
2024-08-08,49,15800,322.45,47,38000,809,-22200,adp
2024-08-07,64,37000,578.12,56,57800,1032,-20800,adp
2024-08-06,19,5600,294.74,19,14000,737,-8400,adp
2024-08-05,15,6100,406.67,25,71400,2856,-65300,adp
2024-08-02,4,500,125.0,12,25200,2100,-24700,adp
2024-08-01,5,1200,240.0,18,14400,800,-13200,adp
2024-07-31,25,11000,440.0,21,17100,814,-6100,adp
2024-07-30,22,10600,481.82,19,13100,689,-2500,adp
2024-07-29,17,7900,464.71,15,10700,713,-2800,adp
2024-07-26,29,12400,427.59,21,8900,424,3500,adp
2024-07-25,24,13700,570.83,19,10400,547,3300,adp
2024-07-24,32,28700,896.88,58,51900,895,-23200,adp
2024-07-22,49,59400,1212.24,17,13100,771,46300,adp
2024-07-19,21,15900,757.14,16,16900,1056,-1000,adp
2024-07-18,23,13100,569.57,8,4500,562,8600,adp
2024-07-17,8,2600,325.0,9,13000,1444,-10400,adp
2024-07-16,16,5800,362.5,11,13400,1218,-7600,adp
2024-07-15,9,3700,411.11,13,14500,1115,-10800,adp
2024-07-12,9,4100,455.56,12,14300,1192,-10200,adp
2024-07-11,7,3400,485.71,8,11300,1412,-7900,adp
2024-07-10,6,2300,383.33,9,14000,1556,-11700,adp
2024-07-09,13,5800,446.15,8,13600,1700,-7800,adp
2024-07-08,16,13000,812.5,9,24300,2700,-11300,adp
2024-07-05,10,7200,720.0,8,13000,1625,-5800,adp
2024-07-04,12,3500,291.67,10,18700,1870,-15200,adp
2024-07-03,11,4600,418.18,15,23000,1533,-18400,adp
2024-07-02,17,6500,382.35,17,9800,576,-3300,adp
2024-07-01,12,3300,275.0,5,4500,900,-1200,adp
2024-06-28,9,3600,400.0,16,19200,1200,-15600,adp
2024-06-27,12,3600,300.0,11,19200,1745,-15600,adp
2024-06-26,23,8400,365.22,16,20100,1256,-11700,adp
2024-06-25,16,5300,331.25,16,19000,1188,-13700,adp
2024-06-24,15,8700,580.0,12,19800,1650,-11100,adp
2024-06-21,19,8900,468.42,18,19900,1106,-11000,adp
2024-06-20,10,4100,410.0,9,17200,1911,-13100,adp
2024-06-19,20,7800,390.0,17,21900,1288,-14100,adp
2024-06-18,11,6500,590.91,17,25600,1506,-19100,adp
2024-06-17,12,6200,516.67,14,23200,1657,-17000,adp
2024-06-14,10,2800,280.0,16,23400,1462,-20600,adp
2024-06-13,20,6200,310.0,22,26400,1200,-20200,adp
2024-06-12,10,3600,360.0,11,19800,1800,-16200,adp
2024-06-11,10,3300,330.0,7,19100,2729,-15800,adp
2024-06-10,16,2900,181.25,18,23200,1289,-20300,adp
2024-06-07,18,8700,483.33,24,23000,958,-14300,adp
2024-06-06,11,3600,327.27,17,19200,1129,-15600,adp
2024-06-05,16,4800,300.0,9,2700,300,2100,adp
2024-06-04,23,12400,539.13,4,600,150,11800,adp
2024-06-03,15,10500,700.0,19,8300,437,2200,adp
2024-05-31,17,9500,558.82,12,5100,425,4400,adp
2024-05-30,16,7100,443.75,14,4900,350,2200,adp
2024-05-29,12,4100,341.67,18,5800,322,-1700,adp
2024-05-28,12,6500,541.67,8,1800,225,4700,adp
2024-05-27,12,8400,700.0,10,4700,470,3700,adp
2024-05-24,22,8500,386.36,20,10800,540,-2300,adp
2024-05-23,18,7500,416.67,13,4600,354,2900,adp
2024-05-22,19,4900,257.89,15,3000,200,1900,adp
2024-05-21,24,6200,258.33,12,6100,508,100,adp
2024-05-20,19,7300,384.21,19,8900,468,-1600,adp
2024-05-17,29,13300,458.62,16,8300,519,5000,adp
2024-05-16,32,10500,328.12,27,12800,474,-2300,adp
2024-05-15,17,7100,417.65,6,4000,667,3100,adp
2024-05-14,21,2800,133.33,8,5600,700,-2800,adp
2024-05-13,18,3900,216.67,13,9100,700,-5200,adp
2024-05-10,17,2600,152.94,11,5300,482,-2700,adp
2024-05-09,8,2000,250.0,10,6900,690,-4900,adp
2024-05-08,17,5700,335.29,15,9600,640,-3900,adp
2024-05-07,9,4000,444.44,11,6600,600,-2600,adp
2024-05-06,18,5900,327.78,10,5400,540,500,adp
2024-05-03,15,18800,1253.33,6,8000,1333,10800,adp
2024-05-02,11,8700,790.91,8,6500,812,2200,adp
2024-04-26,8,4900,612.5,9,4400,489,500,adp
2024-04-25,11,6600,600.0,10,4300,430,2300,adp
2024-04-24,18,13900,772.22,16,13100,819,800,adp
2024-04-23,13,11200,861.54,11,6300,573,4900,adp
2024-04-22,52,41400,796.15,22,14700,668,26700,adp
2024-04-19,63,47700,757.14,40,33000,825,14700,adp
2024-04-17,10,11600,1160.0,15,15600,1040,-4000,adp
2024-04-16,14,10500,750.0,10,8600,860,1900,adp
2024-04-15,8,8700,1087.5,5,6400,1280,2300,adp
2024-04-12,12,9100,758.33,17,12200,718,-3100,adp
2024-04-11,14,12600,900.0,12,10900,908,1700,adp
2024-04-10,12,9500,791.67,9,9700,1078,-200,adp
2024-04-09,16,11500,718.75,8,8300,1038,3200,adp
2024-04-08,21,9200,438.1,8,8400,1050,800,adp
2024-04-05,12,9600,800.0,11,7500,682,2100,adp
2024-04-04,13,6800,523.08,16,8800,550,-2000,adp
2024-04-03,19,7900,415.79,14,6300,450,1600,adp
2024-04-02,10,4800,480.0,9,3300,367,1500,adp
2024-04-01,10,3400,340.0,5,2500,500,900,adp
2024-03-29,6,4000,666.67,4,2100,525,1900,adp
2024-03-28,5,3700,740.0,6,2600,433,1100,adp
2024-03-27,8,5000,625.0,5,2600,520,2400,adp
2024-03-26,7,8200,1171.43,4,2500,625,5700,adp
2024-03-25,27,20200,748.15,10,3900,390,16300,adp
2024-03-22,11,4100,372.73,4,1600,400,2500,adp
2024-03-21,9,4800,533.33,5,1700,340,3100,adp
2024-03-20,6,5000,833.33,4,1900,475,3100,adp
2024-03-19,7,2000,285.71,11,6600,600,-4600,adp
2024-03-18,12,5100,425.0,18,10400,578,-5300,adp
2024-03-15,10,5100,510.0,9,5300,589,-200,adp
2024-03-14,12,3900,325.0,9,6300,700,-2400,adp
2024-03-13,10,5600,560.0,10,5100,510,500,adp
2024-03-12,16,7000,437.5,8,4400,550,2600,adp
2024-03-11,13,5500,423.08,6,2700,450,2800,adp
2024-03-08,7,8800,1257.14,11,6600,600,2200,adp
2024-03-07,3,1200,400.0,10,7100,710,-5900,adp
2024-03-06,7,5400,771.43,9,6000,667,-600,adp
2024-03-05,14,7600,542.86,11,7300,664,300,adp
2024-03-04,22,16300,740.91,8,5400,675,10900,adp
2024-03-01,25,16600,664.0,13,6900,531,9700,adp
2024-02-29,11,16700,1518.18,10,7800,780,8900,adp
2024-02-28,21,19100,909.52,12,6100,508,13000,adp
2024-02-27,21,12900,614.29,12,6000,500,6900,adp
2024-02-26,9,14700,1633.33,7,3900,557,10800,adp
2024-02-23,10,5700,570.0,5,2200,440,3500,adp
2024-02-22,14,14700,1050.0,6,3600,600,11100,adp
2024-02-21,7,14800,2114.29,10,13300,1330,1500,adp
2024-02-20,9,16100,1788.89,6,2400,400,13700,adp
2024-02-19,4,8500,2125.0,8,4200,525,4300,adp
2024-02-16,10,25300,2530.0,8,6800,850,18500,adp
2024-02-15,19,24200,1273.68,7,7100,1014,17100,adp
2024-02-07,0,0,0.0,0,0,0,0,adp
2024-02-06,12,9000,750.0,11,9600,873,-600,adp
2024-02-05,13,18200,1400.0,10,14500,1450,3700,adp
2024-02-02,7,5800,828.57,8,3500,438,2300,adp
2024-02-01,18,20700,1150.0,6,1100,183,19600,adp
2024-01-31,12,12900,1075.0,9,3500,389,9400,adp
2024-01-30,2,1000,500.0,6,1200,200,-200,adp
2024-01-29,4,1000,250.0,10,3000,300,-2000,adp
2024-01-26,5,2900,580.0,11,4300,391,-1400,adp
2024-01-25,12,7300,608.33,10,9400,940,-2100,adp
2024-01-24,3,2800,933.33,14,4700,336,-1900,adp
2024-01-23,10,5800,580.0,17,3200,188,2600,adp
2024-01-22,15,8200,546.67,11,3100,282,5100,adp
2024-01-19,22,14400,654.55,7,1400,200,13000,adp
2024-01-18,13,8700,669.23,13,11700,900,-3000,adp
2024-01-17,9,11100,1233.33,11,8500,773,2600,adp
2024-01-16,9,14100,1566.67,12,7100,592,7000,adp
2024-01-15,16,6500,406.25,9,8800,978,-2300,adp
2024-01-12,24,89400,3725.0,9,71200,7911,18200,adp
2024-01-11,17,9800,576.47,7,3000,429,6800,adp
2024-01-10,0,0,0.0,0,0,0,0,adp
2024-01-09,13,5700,438.46,5,1000,200,4700,adp
2024-01-08,16,5600,350.0,10,7900,790,-2300,adp
2024-01-05,31,10700,345.16,9,4300,478,6400,adp
2024-01-04,21,9200,438.1,5,2900,580,6300,adp
2024-01-03,25,7600,304.0,5,2800,560,4800,adp
2024-01-02,30,12800,426.67,12,5500,458,7300,adp
2024-09-12,203,282400,1391.13,153,285200,1864,-2800,ads
2024-09-11,346,509000,1471.1,190,558000,2937,-49000,ads
2024-09-10,284,400700,1410.92,189,401800,2126,-1100,ads
2024-09-09,276,439400,1592.03,178,302900,1702,136500,ads
2024-09-06,268,513000,1914.18,195,497900,2553,15100,ads
2024-09-05,322,730700,2269.25,184,528200,2871,202500,ads
2024-09-04,281,398400,1417.79,163,454400,2788,-56000,ads
2024-08-30,183,308000,1683.06,174,390400,2244,-82400,ads
2024-08-29,210,297200,1415.24,189,296400,1568,800,ads
2024-08-28,270,483000,1788.89,210,416700,1984,66300,ads
2024-08-27,290,490500,1691.38,167,332000,1988,158500,ads
2024-08-26,231,352400,1525.54,225,355700,1581,-3300,ads
2024-08-23,369,463700,1256.64,226,450100,1992,13600,ads
2024-08-22,364,573900,1576.65,246,599600,2437,-25700,ads
2024-08-21,418,554300,1326.08,229,587700,2566,-33400,ads
2024-08-20,339,555600,1638.94,240,542400,2260,13200,ads
2024-08-19,490,727100,1483.88,304,643000,2115,84100,ads
2024-08-16,333,576400,1730.93,251,533300,2125,43100,ads
2024-08-15,320,438900,1371.56,204,576800,2827,-137900,ads
2024-08-14,259,359700,1388.8,245,548300,2238,-188600,ads
2024-08-13,465,647300,1392.04,364,1004500,2760,-357200,ads
2024-08-12,497,789900,1589.34,329,765000,2325,24900,ads
2024-08-08,837,2011300,2402.99,456,1279600,2806,731700,ads
2024-08-07,177,437300,2470.62,179,431200,2409,6100,ads
2024-08-06,300,540000,1800.0,185,397700,2150,142300,ads
2024-08-05,450,866400,1925.33,331,875600,2645,-9200,ads
2024-08-02,267,810700,3036.33,232,541200,2333,269500,ads
2024-08-01,327,706900,2161.77,300,965400,3218,-258500,ads
2024-07-31,241,488200,2025.73,213,474800,2229,13400,ads
2024-07-30,158,351700,2225.95,267,732300,2743,-380600,ads
2024-07-29,262,600600,2292.37,279,622500,2231,-21900,ads
2024-07-26,204,525200,2574.51,246,552400,2246,-27200,ads
2024-07-25,208,522500,2512.02,209,460100,2201,62400,ads
2024-07-24,387,1115200,2881.65,325,623000,1917,492200,ads
2024-07-22,669,1182300,1767.26,360,997200,2770,185100,ads
2024-07-19,427,817900,1915.46,232,712200,3070,105700,ads
2024-07-18,504,870400,1726.98,357,928000,2599,-57600,ads
2024-07-17,975,1359600,1394.46,544,1783100,3278,-423500,ads
2024-07-16,360,748300,2078.61,300,776500,2588,-28200,ads
2024-07-15,398,831900,2090.2,248,644500,2599,187400,ads
2024-07-12,656,1069500,1630.34,334,1270900,3805,-201400,ads
2024-07-11,511,961200,1881.02,360,1198900,3330,-237700,ads
2024-07-10,425,902000,2122.35,431,1266600,2939,-364600,ads
2024-07-09,445,1220700,2743.15,340,882800,2596,337900,ads
2024-07-08,394,808900,2053.05,393,854700,2175,-45800,ads
2024-07-05,593,1585900,2674.37,481,1076200,2237,509700,ads
2024-07-04,413,1153200,2792.25,316,1352700,4281,-199500,ads
2024-07-03,304,581000,1911.18,248,584100,2355,-3100,ads
2024-07-02,381,780700,2049.08,273,649700,2380,131000,ads
2024-07-01,505,1047600,2074.46,275,741800,2697,305800,ads
2024-06-28,547,1049200,1918.1,468,1377900,2944,-328700,ads
2024-06-27,438,813500,1857.31,346,1131800,3271,-318300,ads
2024-06-26,569,946400,1663.27,361,1013400,2807,-67000,ads
2024-06-25,386,726100,1881.09,308,645300,2095,80800,ads
2024-06-24,911,1701300,1867.51,580,1731300,2985,-30000,ads
2024-06-21,703,2122700,3019.49,787,2028200,2577,94500,ads
2024-06-20,858,1428700,1665.15,542,1602400,2956,-173700,ads
2024-06-19,706,1249700,1770.11,531,1463300,2756,-213600,ads
2024-06-18,624,1322200,2118.91,434,997400,2298,324800,ads
2024-06-17,1081,2583400,2389.82,694,2229800,3213,353600,ads
2024-06-14,1454,2385700,1640.78,815,3390500,4160,-1004800,ads
2024-06-13,873,1505600,1724.63,619,2093300,3382,-587700,ads
2024-06-12,1149,2462900,2143.52,588,1789900,3044,673000,ads
2024-06-11,1418,2522300,1778.77,697,2562800,3677,-40500,ads
2024-06-10,1229,2794000,2273.39,810,3340800,4124,-546800,ads
2024-06-07,735,1741700,2369.66,774,2072500,2678,-330800,ads
2024-06-06,1415,3218500,2274.56,1175,3553200,3024,-334700,ads
2024-06-05,1088,2604600,2393.93,861,2705700,3143,-101100,ads
2024-06-04,1439,4611500,3204.66,1095,3437700,3139,1173800,ads
2024-06-03,1162,2512600,2162.31,979,3223200,3292,-710600,ads
2024-05-31,1940,7587400,3911.03,1072,5084800,4743,2502600,ads
2024-05-30,759,1624800,2140.71,618,2036200,3295,-411400,ads
2024-05-29,672,1754000,2610.12,702,2299200,3275,-545200,ads
2024-05-28,700,1631200,2330.29,551,1646000,2987,-14800,ads
2024-05-27,512,1043400,2037.89,395,1090500,2761,-47100,ads
2024-05-24,1365,3435600,2516.92,1033,3880400,3756,-444800,ads
2024-05-23,967,2203700,2278.9,438,1710200,3905,493500,ads
2024-05-22,1000,2589700,2589.7,766,2739200,3576,-149500,ads
2024-05-21,1170,4599100,3930.85,1254,4081000,3254,518100,ads
2024-05-20,456,1852800,4063.16,532,1617600,3041,235200,ads
2024-05-17,662,2276100,3438.22,763,2033600,2665,242500,ads
2024-05-16,374,933300,2495.45,402,1024000,2547,-90700,ads
2024-05-15,620,2199600,3547.74,696,2175700,3126,23900,ads
2024-05-14,260,562400,2163.08,310,870100,2807,-307700,ads
2024-05-13,344,659300,1916.57,375,1067400,2846,-408100,ads
2024-05-10,262,1017000,3881.68,343,1153200,3362,-136200,ads
2024-05-09,319,669800,2099.69,448,1012700,2260,-342900,ads
2024-05-08,480,1287300,2681.88,424,1306900,3082,-19600,ads
2024-05-07,332,680300,2049.1,348,1058600,3042,-378300,ads
2024-05-06,430,1707900,3971.86,478,1483000,3103,224900,ads
2024-05-03,200,1113400,5567.0,266,1162300,4370,-48900,ads
2024-05-02,287,550900,1919.51,237,563700,2378,-12800,ads
2024-04-26,279,669200,2398.57,281,721800,2569,-52600,ads
2024-04-25,196,481200,2455.1,277,636400,2297,-155200,ads
2024-04-24,276,783300,2838.04,282,659500,2339,123800,ads
2024-04-23,381,1676000,4398.95,439,1783800,4063,-107800,ads
2024-04-22,345,1023600,2966.96,281,876300,3119,147300,ads
2024-04-19,575,2082200,3621.22,464,2323700,5008,-241500,ads
2024-04-17,496,1122700,2263.51,356,1453500,4083,-330800,ads
2024-04-16,584,1354600,2319.52,464,1384300,2983,-29700,ads
2024-04-15,628,1352000,2152.87,526,1354300,2575,-2300,ads
2024-04-12,360,1313800,3649.44,331,943000,2849,370800,ads
2024-04-11,477,1145000,2400.42,280,823600,2941,321400,ads
2024-04-10,240,762900,3178.75,306,918200,3001,-155300,ads
2024-04-09,541,1276700,2359.89,393,1053600,2681,223100,ads
2024-04-08,444,829900,1869.14,334,922100,2761,-92200,ads
2024-04-05,728,1831000,2515.11,507,1959100,3864,-128100,ads
2024-04-04,636,1515300,2382.55,564,1659000,2941,-143700,ads
2024-04-03,752,1885500,2507.31,615,1699500,2763,186000,ads
2024-04-02,877,2335400,2662.94,534,1520100,2847,815300,ads
2024-04-01,888,1824700,2054.84,566,1646400,2909,178300,ads
2024-03-29,833,2033300,2440.94,541,1732200,3202,301100,ads
2024-03-28,967,1919900,1985.42,634,1809400,2854,110500,ads
2024-03-27,1503,4925200,3276.91,1049,3009000,2868,1916200,ads
2024-03-26,628,1646000,2621.02,430,1215500,2827,430500,ads
2024-03-25,659,1367600,2075.27,516,1771900,3434,-404300,ads
2024-03-22,627,1924400,3069.22,804,2059700,2562,-135300,ads
2024-03-21,854,3335600,3905.85,637,1892800,2971,1442800,ads
2024-03-20,636,1780000,2798.74,510,1671100,3277,108900,ads
2024-03-19,480,1060400,2209.17,458,1431500,3126,-371100,ads
2024-03-18,1023,2297600,2245.94,937,3057700,3263,-760100,ads
2024-03-15,804,3254700,4048.13,579,1765700,3050,1489000,ads
2024-03-14,965,2457000,2546.11,839,2203300,2626,253700,ads
2024-03-13,985,4216200,4280.41,995,2431700,2444,1784500,ads
2024-03-12,307,815100,2655.05,302,723300,2395,91800,ads
2024-03-11,575,1322700,2300.35,483,1415400,2930,-92700,ads
2024-03-08,614,1138000,1853.42,387,1275500,3296,-137500,ads
2024-03-07,576,1042300,1809.55,272,1258400,4626,-216100,ads
2024-03-06,408,928400,2275.49,317,1043200,3291,-114800,ads
2024-03-05,383,764400,1995.82,278,1024800,3686,-260400,ads
2024-03-04,534,1577200,2953.56,398,1242300,3121,334900,ads
2024-03-01,506,820700,1621.94,242,816500,3374,4200,ads
2024-02-29,448,719700,1606.47,286,1053500,3684,-333800,ads
2024-02-28,353,565300,1601.42,412,1111200,2697,-545900,ads
2024-02-27,313,824500,2634.19,375,1247000,3325,-422500,ads
2024-02-26,389,826400,2124.42,265,812400,3066,14000,ads
2024-02-23,518,1106800,2136.68,615,1585700,2578,-478900,ads
2024-02-22,701,2118400,3021.97,618,1331800,2155,786600,ads
2024-02-21,284,483800,1703.52,197,422000,2142,61800,ads
2024-02-20,435,842600,1937.01,302,633400,2097,209200,ads
2024-02-19,368,665000,1807.07,336,856700,2550,-191700,ads
2024-02-16,295,666300,2258.64,299,762800,2551,-96500,ads
2024-02-15,454,908300,2000.66,335,972800,2904,-64500,ads
2024-02-07,0,0,0.0,0,0,0,0,ads
2024-02-06,277,553400,1997.83,281,586300,2086,-32900,ads
2024-02-05,220,650100,2955.0,172,643100,3739,7000,ads
2024-02-02,226,578300,2558.85,250,674700,2699,-96400,ads
2024-02-01,230,592500,2576.09,235,561400,2389,31100,ads
2024-01-31,393,1277400,3250.38,331,1340200,4049,-62800,ads
2024-01-30,380,688600,1812.11,301,831800,2763,-143200,ads
2024-01-29,413,588400,1424.7,247,746700,3023,-158300,ads
2024-01-26,249,434800,1746.18,232,573700,2473,-138900,ads
2024-01-25,317,550500,1736.59,230,615600,2677,-65100,ads
2024-01-24,278,1023600,3682.01,301,1220200,4054,-196600,ads
2024-01-23,280,492700,1759.64,247,913900,3700,-421200,ads
2024-01-22,305,394400,1293.11,269,511000,1900,-116600,ads
2024-01-19,257,682700,2656.42,250,562500,2250,120200,ads
2024-01-18,340,1280700,3766.76,373,972000,2606,308700,ads
2024-01-17,377,610300,1618.83,263,606700,2307,3600,ads
2024-01-16,353,576100,1632.01,187,451700,2416,124400,ads
2024-01-15,352,641400,1822.16,289,778900,2695,-137500,ads
2024-01-12,1022,1297400,1269.47,479,1393000,2908,-95600,ads
2024-01-11,324,545500,1683.64,229,634300,2770,-88800,ads
2024-01-10,0,0,0.0,0,0,0,0,ads
2024-01-09,365,641900,1758.63,378,725800,1920,-83900,ads
2024-01-08,559,1209500,2163.69,584,1249500,2140,-40000,ads
2024-01-05,517,1540400,2979.5,450,1094600,2432,445800,ads
2024-01-04,402,1108400,2757.21,545,1248600,2291,-140200,ads
2024-01-03,789,3122100,3957.03,837,1969300,2353,1152800,ads
2024-01-02,312,575200,1843.59,221,591600,2677,-16400,ads
2024-09-12,74,104100,1406.76,85,263400,3099,-159300,afx
2024-09-11,68,113000,1661.76,102,251900,2470,-138900,afx
2024-09-10,76,106300,1398.68,110,303100,2755,-196800,afx
2024-09-09,52,109900,2113.46,62,197500,3185,-87600,afx
2024-09-06,55,89100,1620.0,63,170900,2713,-81800,afx
2024-09-05,43,80000,1860.47,65,192400,2960,-112400,afx
2024-09-04,53,83500,1575.47,52,217000,4173,-133500,afx
2024-08-30,21,94700,4509.52,37,171400,4632,-76700,afx
2024-08-29,43,95800,2227.91,49,210000,4286,-114200,afx
2024-08-28,32,80100,2503.12,49,208200,4249,-128100,afx
2024-08-27,34,54800,1611.76,42,180400,4295,-125600,afx
2024-08-26,41,66600,1624.39,72,242800,3372,-176200,afx
2024-08-23,50,128800,2576.0,81,289500,3574,-160700,afx
2024-08-22,62,162700,2624.19,89,283000,3180,-120300,afx
2024-08-21,96,235800,2456.25,103,350600,3404,-114800,afx
2024-08-20,72,187600,2605.56,70,265600,3794,-78000,afx
2024-08-19,60,159400,2656.67,72,267600,3717,-108200,afx
2024-08-16,51,98300,1927.45,77,319300,4147,-221000,afx
2024-08-15,51,78700,1543.14,76,271700,3575,-193000,afx
2024-08-14,40,71200,1780.0,66,314000,4758,-242800,afx
2024-08-13,65,69400,1067.69,73,273900,3752,-204500,afx
2024-08-12,67,83800,1250.75,69,224200,3249,-140400,afx
2024-08-09,35,66500,1900.0,48,134600,2804,-68100,afx
2024-08-08,79,95000,1202.53,49,75300,1537,19700,afx
2024-08-07,83,214700,2586.75,55,308200,5604,-93500,afx
2024-08-06,67,120600,1800.0,56,262000,4679,-141400,afx
2024-08-05,101,397500,3935.64,75,428800,5717,-31300,afx
2024-08-02,50,67500,1350.0,61,108400,1777,-40900,afx
2024-08-01,142,176000,1239.44,84,302400,3600,-126400,afx
2024-07-31,46,118400,2573.91,45,181800,4040,-63400,afx
2024-07-30,74,145100,1960.81,68,255400,3756,-110300,afx
2024-07-29,59,95200,1613.56,59,170800,2895,-75600,afx
2024-07-26,65,66700,1026.15,50,67700,1354,-1000,afx
2024-07-25,43,77200,1795.35,50,197600,3952,-120400,afx
2024-07-24,73,151900,2080.82,53,221300,4175,-69400,afx
2024-07-23,72,107500,1493.06,72,172500,2396,-65000,afx
2024-07-22,91,108900,1196.7,73,147300,2018,-38400,afx
2024-07-19,55,77500,1409.09,54,105900,1961,-28400,afx
2024-07-18,60,84700,1411.67,73,174400,2389,-89700,afx
2024-07-17,87,133000,1528.74,94,222500,2367,-89500,afx
2024-07-16,74,98700,1333.78,87,175600,2018,-76900,afx
2024-07-15,62,72900,1175.81,62,103300,1666,-30400,afx
2024-07-12,63,70800,1123.81,58,110000,1897,-39200,afx
2024-07-11,97,138700,1429.9,88,221700,2519,-83000,afx
2024-07-10,64,49400,771.88,81,137400,1696,-88000,afx
2024-07-09,105,145000,1380.95,74,178900,2418,-33900,afx
2024-07-08,76,90100,1185.53,60,136200,2270,-46100,afx
2024-07-05,83,89500,1078.31,75,160300,2137,-70800,afx
2024-07-04,75,168300,2244.0,95,249400,2625,-81100,afx
2024-07-03,76,135000,1776.32,74,148700,2009,-13700,afx
2024-07-02,132,145800,1104.55,78,128000,1641,17800,afx
2024-07-01,81,103100,1272.84,47,160100,3406,-57000,afx
2024-06-28,166,188300,1134.34,62,163600,2639,24700,afx
2024-06-27,137,147500,1076.64,63,162700,2583,-15200,afx
2024-06-26,123,154400,1255.28,86,245400,2853,-91000,afx
2024-06-25,71,112100,1578.87,90,239400,2660,-127300,afx
2024-06-24,110,138700,1260.91,118,347400,2944,-208700,afx
2024-06-21,123,219000,1780.49,82,330200,4027,-111200,afx
2024-06-20,83,146600,1766.27,65,135700,2088,10900,afx
2024-06-19,61,118100,1936.07,69,153400,2223,-35300,afx
2024-06-18,72,179000,2486.11,65,183100,2817,-4100,afx
2024-06-17,114,144100,1264.04,59,134900,2286,9200,afx
2024-06-14,123,142300,1156.91,90,230600,2562,-88300,afx
2024-06-13,87,143000,1643.68,127,332600,2619,-189600,afx
2024-06-12,100,176800,1768.0,199,550000,2764,-373200,afx
2024-06-11,163,700900,4300.0,223,688800,3089,12100,afx
2024-06-10,87,146900,1688.51,84,255400,3040,-108500,afx
2024-06-07,72,97300,1351.39,97,152400,1571,-55100,afx
2024-06-06,55,106100,1929.09,69,120900,1752,-14800,afx
2024-06-05,81,137200,1693.83,79,125700,1591,11500,afx
2024-06-04,65,113400,1744.62,80,173900,2174,-60500,afx
2024-06-03,59,149000,2525.42,82,179800,2193,-30800,afx
2024-05-31,76,196500,2585.53,75,125600,1675,70900,afx
2024-05-30,78,125800,1612.82,61,134400,2203,-8600,afx
2024-05-29,68,187200,2752.94,101,226800,2246,-39600,afx
2024-05-28,51,135700,2660.78,93,179600,1931,-43900,afx
2024-05-27,55,105000,1909.09,86,109200,1270,-4200,afx
2024-05-24,79,153900,1948.1,109,190000,1743,-36100,afx
2024-05-23,67,171500,2559.7,86,156200,1816,15300,afx
2024-05-22,98,122000,1244.9,114,198500,1741,-76500,afx
2024-05-21,56,82500,1473.21,118,205900,1745,-123400,afx
2024-05-20,73,141800,1942.47,133,257900,1939,-116100,afx
2024-05-17,81,229800,2837.04,91,189800,2086,40000,afx
2024-05-16,91,166000,1824.18,140,307400,2196,-141400,afx
2024-05-15,69,200200,2901.45,155,355800,2295,-155600,afx
2024-05-14,171,395900,2315.2,232,506800,2184,-110900,afx
2024-05-13,96,178200,1856.25,65,167800,2582,10400,afx
2024-05-10,91,150500,1653.85,66,117500,1780,33000,afx
2024-05-09,96,211900,2207.29,72,179400,2492,32500,afx
2024-05-08,75,151800,2024.0,74,204600,2765,-52800,afx
2024-05-07,78,191600,2456.41,81,187200,2311,4400,afx
2024-05-06,67,221500,3305.97,91,254000,2791,-32500,afx
2024-05-03,91,208300,2289.01,58,231600,3993,-23300,afx
2024-05-02,60,114400,1906.67,54,129100,2391,-14700,afx
2024-04-26,72,101200,1405.56,57,214400,3761,-113200,afx
2024-04-25,62,89300,1440.32,50,82000,1640,7300,afx
2024-04-24,61,100600,1649.18,54,175300,3246,-74700,afx
2024-04-23,110,200200,1820.0,70,204500,2921,-4300,afx
2024-04-22,60,101100,1685.0,48,85500,1781,15600,afx
2024-04-19,82,137200,1673.17,66,145100,2198,-7900,afx
2024-04-17,133,195000,1466.17,89,234200,2631,-39200,afx
2024-04-16,165,234700,1422.42,117,320100,2736,-85400,afx
2024-04-15,105,152300,1450.48,135,318800,2361,-166500,afx
2024-04-12,137,424600,3099.27,207,496300,2398,-71700,afx
2024-04-11,99,378100,3819.19,106,189300,1786,188800,afx
2024-04-10,77,201700,2619.48,97,247400,2551,-45700,afx
2024-04-09,133,209600,1575.94,82,195000,2378,14600,afx
2024-04-08,100,174000,1740.0,74,188100,2542,-14100,afx
2024-04-05,106,188500,1778.3,87,249800,2871,-61300,afx
2024-04-04,147,319200,2171.43,159,423400,2663,-104200,afx
2024-04-03,157,294300,1874.52,238,576200,2421,-281900,afx
2024-04-02,301,1781300,5917.94,278,1891500,6804,-110200,afx
2024-04-01,91,188500,2071.43,93,239000,2570,-50500,afx
2024-03-29,65,191400,2944.62,81,183000,2259,8400,afx
2024-03-28,80,199100,2488.75,128,228100,1782,-29000,afx
2024-03-27,81,253700,3132.1,175,272000,1554,-18300,afx
2024-03-26,97,207600,2140.21,83,252900,3047,-45300,afx
2024-03-25,94,169500,1803.19,115,298500,2596,-129000,afx
2024-03-22,133,237900,1788.72,90,214400,2382,23500,afx
2024-03-21,103,212500,2063.11,111,353100,3181,-140600,afx
2024-03-20,85,216100,2542.35,79,188400,2385,27700,afx
2024-03-19,86,134300,1561.63,65,147700,2272,-13400,afx
2024-03-18,200,269500,1347.5,110,255900,2326,13600,afx
2024-03-15,117,157400,1345.3,97,258100,2661,-100700,afx
2024-03-14,109,162600,1491.74,92,242700,2638,-80100,afx
2024-03-13,199,234200,1176.88,101,212900,2108,21300,afx
2024-03-12,169,227100,1343.79,94,271300,2886,-44200,afx
2024-03-11,113,178400,1578.76,88,267900,3044,-89500,afx
2024-03-08,147,224300,1525.85,121,281000,2322,-56700,afx
2024-03-07,144,178900,1242.36,105,243300,2317,-64400,afx
2024-03-06,172,262500,1526.16,105,354800,3379,-92300,afx
2024-03-05,143,277000,1937.06,112,323100,2885,-46100,afx
2024-03-04,161,250700,1557.14,130,365500,2812,-114800,afx
2024-03-01,123,200700,1631.71,103,206400,2004,-5700,afx
2024-02-29,154,162800,1057.14,118,299500,2538,-136700,afx
2024-02-28,143,313900,2195.1,123,312900,2544,1000,afx
2024-02-27,176,269100,1528.98,114,305000,2675,-35900,afx
2024-02-26,119,230200,1934.45,168,371600,2212,-141400,afx
2024-02-23,276,492000,1782.61,301,670200,2227,-178200,afx
2024-02-22,178,372900,2094.94,191,464800,2434,-91900,afx
2024-02-21,131,227200,1734.35,120,264800,2207,-37600,afx
2024-02-20,155,168700,1088.39,117,255900,2187,-87200,afx
2024-02-19,138,252000,1826.09,117,326600,2791,-74600,afx
2024-02-16,81,98900,1220.99,102,272600,2673,-173700,afx
2024-02-15,79,151500,1917.72,77,166900,2168,-15400,afx
2024-02-07,87,141400,1625.29,78,188500,2417,-47100,afx
2024-02-06,96,157900,1644.79,75,216200,2883,-58300,afx
2024-02-05,66,151000,2287.88,68,245700,3613,-94700,afx
2024-02-02,95,154200,1623.16,91,228700,2513,-74500,afx
2024-02-01,90,159400,1771.11,68,209400,3079,-50000,afx
2024-01-31,78,128900,1652.56,84,152700,1818,-23800,afx
2024-01-30,85,129800,1527.06,87,175700,2020,-45900,afx
2024-01-29,70,132100,1887.14,79,192000,2430,-59900,afx
2024-01-26,76,130400,1715.79,73,160900,2204,-30500,afx
2024-01-25,145,227000,1565.52,76,221000,2908,6000,afx
2024-01-24,77,174700,2268.83,84,224800,2676,-50100,afx
2024-01-23,107,215700,2015.89,142,311700,2195,-96000,afx
2024-01-22,60,67400,1123.33,134,202700,1513,-135300,afx
2024-01-19,234,580400,2480.34,244,546900,2241,33500,afx
2024-01-18,70,176500,2521.43,90,221900,2466,-45400,afx
2024-01-17,64,153600,2400.0,89,288800,3245,-135200,afx
2024-01-16,47,123200,2621.28,99,239500,2419,-116300,afx
2024-01-15,46,121100,2632.61,84,213800,2545,-92700,afx
2024-01-12,68,162600,2391.18,132,322700,2445,-160100,afx
2024-01-11,142,443000,3119.72,129,409000,3171,34000,afx
2024-01-10,123,191900,1560.16,91,337700,3711,-145800,afx
2024-01-09,95,165500,1742.11,82,326900,3987,-161400,afx
2024-01-08,141,250200,1774.47,104,434000,4173,-183800,afx
2024-01-05,85,237700,2796.47,110,361000,3282,-123300,afx
2024-01-04,94,197300,2098.94,102,221200,2169,-23900,afx
2024-01-03,81,188600,2328.4,91,302900,3329,-114300,afx
2024-01-02,119,236000,1983.19,111,244400,2202,-8400,afx
2024-09-12,0,0,0.0,0,0,0,0,agf
2024-09-11,0,0,0.0,0,0,0,0,agf
2024-09-10,0,0,0.0,0,0,0,0,agf
2024-09-09,0,0,0.0,0,0,0,0,agf
2024-09-06,14,26400,1885.71,9,22800,2533,3600,agf
2024-09-05,0,0,0.0,0,0,0,0,agf
2024-09-04,0,0,0.0,0,0,0,0,agf
2024-08-30,24,55700,2320.83,19,35100,1847,20600,agf
2024-08-29,0,0,0.0,0,0,0,0,agf
2024-08-28,0,0,0.0,0,0,0,0,agf
2024-08-27,0,0,0.0,0,0,0,0,agf
2024-08-26,0,0,0.0,0,0,0,0,agf
2024-08-23,16,55100,3443.75,19,42700,2247,12400,agf
2024-08-22,0,0,0.0,0,0,0,0,agf
2024-08-21,0,0,0.0,0,0,0,0,agf
2024-08-20,0,0,0.0,0,0,0,0,agf
2024-08-19,0,0,0.0,0,0,0,0,agf
2024-08-16,5,1400,280.0,10,9300,930,-7900,agf
2024-08-15,0,0,0.0,0,0,0,0,agf
2024-08-14,0,0,0.0,0,0,0,0,agf
2024-08-13,0,0,0.0,0,0,0,0,agf
2024-08-12,0,0,0.0,0,0,0,0,agf
2024-08-09,7,6700,957.14,16,9500,594,-2800,agf
2024-08-08,0,0,0.0,0,0,0,0,agf
2024-08-07,0,0,0.0,0,0,0,0,agf
2024-08-06,0,0,0.0,0,0,0,0,agf
2024-08-05,0,0,0.0,0,0,0,0,agf
2024-08-02,6,2500,416.67,13,16800,1292,-14300,agf
2024-08-01,0,0,0.0,0,0,0,0,agf
2024-07-31,0,0,0.0,0,0,0,0,agf
2024-07-30,0,0,0.0,0,0,0,0,agf
2024-07-29,0,0,0.0,0,0,0,0,agf
2024-07-26,5,500,100.0,11,14800,1345,-14300,agf
2024-07-25,0,0,0.0,0,0,0,0,agf
2024-07-24,0,0,0.0,0,0,0,0,agf
2024-07-23,0,0,0.0,0,0,0,0,agf
2024-07-22,0,0,0.0,0,0,0,0,agf
2024-07-19,10,25500,2550.0,14,35000,2500,-9500,agf
2024-07-18,0,0,0.0,0,0,0,0,agf
2024-07-17,0,0,0.0,0,0,0,0,agf
2024-07-16,0,0,0.0,0,0,0,0,agf
2024-07-15,0,0,0.0,0,0,0,0,agf
2024-07-12,22,48900,2222.73,19,29700,1563,19200,agf
2024-07-11,0,0,0.0,0,0,0,0,agf
2024-07-10,0,0,0.0,0,0,0,0,agf
2024-07-09,0,0,0.0,0,0,0,0,agf
2024-07-08,0,0,0.0,0,0,0,0,agf
2024-07-05,25,24700,988.0,18,24500,1361,200,agf
2024-07-04,0,0,0.0,0,0,0,0,agf
2024-07-03,0,0,0.0,0,0,0,0,agf
2024-07-02,0,0,0.0,0,0,0,0,agf
2024-07-01,0,0,0.0,0,0,0,0,agf
2024-06-28,14,19500,1392.86,24,32300,1346,-12800,agf
2024-06-27,0,0,0.0,0,0,0,0,agf
2024-06-26,0,0,0.0,0,0,0,0,agf
2024-06-25,0,0,0.0,0,0,0,0,agf
2024-06-24,0,0,0.0,0,0,0,0,agf
2024-06-21,13,9600,738.46,19,21100,1111,-11500,agf
2024-06-20,0,0,0.0,0,0,0,0,agf
2024-06-19,0,0,0.0,0,0,0,0,agf
2024-06-18,0,0,0.0,0,0,0,0,agf
2024-06-17,0,0,0.0,0,0,0,0,agf
2024-06-14,34,18100,532.35,34,27800,818,-9700,agf
2024-06-13,0,0,0.0,0,0,0,0,agf
2024-06-12,0,0,0.0,0,0,0,0,agf
2024-06-11,0,0,0.0,0,0,0,0,agf
2024-06-10,0,0,0.0,0,0,0,0,agf
2024-06-07,34,19500,573.53,26,23900,919,-4400,agf
2024-06-06,0,0,0.0,0,0,0,0,agf
2024-06-05,0,0,0.0,0,0,0,0,agf
2024-06-04,0,0,0.0,0,0,0,0,agf
2024-06-03,0,0,0.0,0,0,0,0,agf
2024-05-31,30,27800,926.67,11,12100,1100,15700,agf
2024-05-30,0,0,0.0,0,0,0,0,agf
2024-05-29,0,0,0.0,0,0,0,0,agf
2024-05-28,0,0,0.0,0,0,0,0,agf
2024-05-27,0,0,0.0,0,0,0,0,agf
2024-05-24,26,22200,853.85,11,4800,436,17400,agf
2024-05-23,0,0,0.0,0,0,0,0,agf
2024-05-22,0,0,0.0,0,0,0,0,agf
2024-05-21,0,0,0.0,0,0,0,0,agf
2024-05-20,0,0,0.0,0,0,0,0,agf
2024-05-17,27,13100,485.19,6,3200,533,9900,agf
2024-05-16,0,0,0.0,0,0,0,0,agf
2024-05-15,0,0,0.0,0,0,0,0,agf
2024-05-14,0,0,0.0,0,0,0,0,agf
2024-05-13,0,0,0.0,0,0,0,0,agf
2024-05-10,7,2300,328.57,7,2500,357,-200,agf
2024-05-09,0,0,0.0,0,0,0,0,agf
2024-05-08,0,0,0.0,0,0,0,0,agf
2024-05-07,0,0,0.0,0,0,0,0,agf
2024-05-06,0,0,0.0,0,0,0,0,agf
2024-05-03,7,3500,500.0,10,4000,400,-500,agf
2024-05-02,0,0,0.0,0,0,0,0,agf
2024-04-26,10,2900,290.0,9,2900,322,0,agf
2024-04-25,0,0,0.0,0,0,0,0,agf
2024-04-24,0,0,0.0,0,0,0,0,agf
2024-04-23,0,0,0.0,0,0,0,0,agf
2024-04-22,0,0,0.0,0,0,0,0,agf
2024-04-19,8,2100,262.5,7,2800,400,-700,agf
2024-04-17,0,0,0.0,0,0,0,0,agf
2024-04-16,0,0,0.0,0,0,0,0,agf
2024-04-15,0,0,0.0,0,0,0,0,agf
2024-04-12,18,7700,427.78,13,3900,300,3800,agf
2024-04-11,0,0,0.0,0,0,0,0,agf
2024-04-10,0,0,0.0,0,0,0,0,agf
2024-04-09,0,0,0.0,0,0,0,0,agf
2024-04-08,0,0,0.0,0,0,0,0,agf
2024-04-05,22,16700,759.09,24,19100,796,-2400,agf
2024-04-04,0,0,0.0,0,0,0,0,agf
2024-04-03,0,0,0.0,0,0,0,0,agf
2024-04-02,0,0,0.0,0,0,0,0,agf
2024-04-01,0,0,0.0,0,0,0,0,agf
2024-03-29,13,8500,653.85,21,18000,857,-9500,agf
2024-03-28,0,0,0.0,0,0,0,0,agf
2024-03-27,0,0,0.0,0,0,0,0,agf
2024-03-26,0,0,0.0,0,0,0,0,agf
2024-03-25,0,0,0.0,0,0,0,0,agf
2024-03-22,23,3500,152.17,19,10200,537,-6700,agf
2024-03-21,0,0,0.0,0,0,0,0,agf
2024-03-20,0,0,0.0,0,0,0,0,agf
2024-03-19,0,0,0.0,0,0,0,0,agf
2024-03-18,0,0,0.0,0,0,0,0,agf
2024-03-15,19,10000,526.32,21,7300,348,2700,agf
2024-03-14,0,0,0.0,0,0,0,0,agf
2024-03-13,0,0,0.0,0,0,0,0,agf
2024-03-12,0,0,0.0,0,0,0,0,agf
2024-03-11,0,0,0.0,0,0,0,0,agf
2024-03-08,7,500,71.43,10,4700,470,-4200,agf
2024-03-07,0,0,0.0,0,0,0,0,agf
2024-03-06,0,0,0.0,0,0,0,0,agf
2024-03-05,0,0,0.0,0,0,0,0,agf
2024-03-04,0,0,0.0,0,0,0,0,agf
2024-03-01,10,1800,180.0,8,3100,388,-1300,agf
2024-02-29,0,0,0.0,0,0,0,0,agf
2024-02-28,0,0,0.0,0,0,0,0,agf
2024-02-27,0,0,0.0,0,0,0,0,agf
2024-02-26,0,0,0.0,0,0,0,0,agf
2024-02-23,11,6200,563.64,7,3000,429,3200,agf
2024-02-22,0,0,0.0,0,0,0,0,agf
2024-02-21,0,0,0.0,0,0,0,0,agf
2024-02-20,0,0,0.0,0,0,0,0,agf
2024-02-19,0,0,0.0,0,0,0,0,agf
2024-02-16,17,7400,435.29,4,2400,600,5000,agf
2024-02-15,0,0,0.0,0,0,0,0,agf
2024-02-07,0,0,0.0,0,0,0,0,agf
2024-02-06,0,0,0.0,0,0,0,0,agf
2024-02-05,0,0,0.0,0,0,0,0,agf
2024-02-02,8,2700,337.5,6,3300,550,-600,agf
2024-02-01,0,0,0.0,0,0,0,0,agf
2024-01-31,0,0,0.0,0,0,0,0,agf
2024-01-30,0,0,0.0,0,0,0,0,agf
2024-01-29,0,0,0.0,0,0,0,0,agf
2024-01-26,12,18900,1575.0,7,2500,357,16400,agf
2024-01-25,0,0,0.0,0,0,0,0,agf
2024-01-24,0,0,0.0,0,0,0,0,agf
2024-01-23,0,0,0.0,0,0,0,0,agf
2024-01-22,0,0,0.0,0,0,0,0,agf
2024-01-19,12,11200,933.33,9,4200,467,7000,agf
2024-01-18,0,0,0.0,0,0,0,0,agf
2024-01-17,0,0,0.0,0,0,0,0,agf
2024-01-16,0,0,0.0,0,0,0,0,agf
2024-01-15,0,0,0.0,0,0,0,0,agf
2024-01-12,13,9100,700.0,8,5600,700,3500,agf
2024-01-11,0,0,0.0,0,0,0,0,agf
2024-01-10,0,0,0.0,0,0,0,0,agf
2024-01-09,0,0,0.0,0,0,0,0,agf
2024-01-08,0,0,0.0,0,0,0,0,agf
2024-01-05,13,4700,361.54,19,4600,242,100,agf
2024-01-04,0,0,0.0,0,0,0,0,agf
2024-01-03,0,0,0.0,0,0,0,0,agf
2024-01-02,0,0,0.0,0,0,0,0,agf
2024-09-12,337,912800,2708.61,67,111900,1670,800900,agm
2024-09-11,274,889200,3245.26,72,68000,944,821200,agm
2024-09-10,216,833200,3857.41,144,333400,2315,499800,agm
2024-09-09,111,195300,1759.46,90,371400,4127,-176100,agm
2024-09-06,80,106800,1335.0,103,266800,2590,-160000,agm
2024-09-05,124,111900,902.42,83,229800,2769,-117900,agm
2024-09-04,110,166300,1511.82,89,189100,2125,-22800,agm
2024-08-30,137,195700,1428.47,76,409200,5384,-213500,agm
2024-08-29,101,97300,963.37,88,362300,4117,-265000,agm
2024-08-28,116,116800,1006.9,77,96700,1256,20100,agm
2024-08-27,297,498700,1679.12,79,1208300,15295,-709600,agm
2024-08-26,190,307600,1618.95,100,1206200,12062,-898600,agm
2024-08-23,123,202400,1645.53,53,432200,8155,-229800,agm
2024-08-22,151,205600,1361.59,86,571200,6642,-365600,agm
2024-08-21,182,389900,2142.31,129,775200,6009,-385300,agm
2024-08-20,148,256400,1732.43,79,266200,3370,-9800,agm
2024-08-19,169,245600,1453.25,113,770700,6820,-525100,agm
2024-08-16,155,388100,2503.87,142,269000,1894,119100,agm
2024-08-15,133,233600,1756.39,82,160400,1956,73200,agm
2024-08-14,135,190400,1410.37,79,275600,3489,-85200,agm
2024-08-13,89,117000,1314.61,80,86000,1075,31000,agm
2024-08-12,113,675800,5980.53,118,205600,1742,470200,agm
2024-08-08,272,567200,2085.29,85,211400,2487,355800,agm
2024-08-07,218,835700,3833.49,85,113900,1340,721800,agm
2024-08-06,216,738600,3419.44,136,257200,1891,481400,agm
2024-08-05,219,283600,1294.98,137,394700,2881,-111100,agm
2024-08-02,275,492300,1790.18,157,405500,2583,86800,agm
2024-08-01,244,344700,1412.7,122,630400,5167,-285700,agm
2024-07-31,246,184100,748.37,142,311200,2192,-127100,agm
2024-07-30,113,193000,1707.96,98,249400,2545,-56400,agm
2024-07-29,108,126000,1166.67,96,317600,3308,-191600,agm
2024-07-26,120,257300,2144.17,57,92200,1618,165100,agm
2024-07-25,91,92200,1013.19,64,267100,4173,-174900,agm
2024-07-24,185,657800,3555.68,125,136200,1090,521600,agm
2024-07-22,239,451000,1887.03,159,726100,4567,-275100,agm
2024-07-19,197,419800,2130.96,127,464000,3654,-44200,agm
2024-07-18,345,718400,2082.32,199,811300,4077,-92900,agm
2024-07-17,203,305800,1506.4,173,584900,3381,-279100,agm
2024-07-16,260,714800,2749.23,167,802100,4803,-87300,agm
2024-07-15,120,294100,2450.83,98,363800,3712,-69700,agm
2024-07-12,199,331400,1665.33,102,325800,3194,5600,agm
2024-07-11,236,337300,1429.24,116,611100,5268,-273800,agm
2024-07-10,188,345600,1838.3,103,425100,4127,-79500,agm
2024-07-09,289,457600,1583.39,128,580300,4534,-122700,agm
2024-07-08,147,109000,741.5,104,455100,4376,-346100,agm
2024-07-05,157,145300,925.48,121,422400,3491,-277100,agm
2024-07-04,221,253900,1148.87,117,612200,5232,-358300,agm
2024-07-03,136,148400,1091.18,87,334500,3845,-186100,agm
2024-07-02,185,309100,1670.81,91,319100,3507,-10000,agm
2024-07-01,169,178500,1056.21,95,355300,3740,-176800,agm
2024-06-28,147,272800,1855.78,87,525600,6041,-252800,agm
2024-06-27,124,154500,1245.97,116,297000,2560,-142500,agm
2024-06-26,125,184000,1472.0,83,342200,4123,-158200,agm
2024-06-25,174,253500,1456.9,119,478800,4024,-225300,agm
2024-06-24,211,435500,2063.98,131,489200,3734,-53700,agm
2024-06-21,318,434500,1366.35,108,606100,5612,-171600,agm
2024-06-20,310,320700,1034.52,119,453100,3808,-132400,agm
2024-06-19,224,303100,1353.12,105,256000,2438,47100,agm
2024-06-18,344,364500,1059.59,128,458200,3580,-93700,agm
2024-06-17,259,265500,1025.1,128,491800,3842,-226300,agm
2024-06-14,188,267800,1424.47,131,442900,3381,-175100,agm
2024-06-13,174,249300,1432.76,131,413400,3156,-164100,agm
2024-06-12,169,242400,1434.32,122,508700,4170,-266300,agm
2024-06-11,239,416200,1741.42,143,558600,3906,-142400,agm
2024-06-10,187,355600,1901.6,160,546700,3417,-191100,agm
2024-06-07,170,315600,1856.47,155,700100,4517,-384500,agm
2024-06-06,191,444100,2325.13,202,694400,3438,-250300,agm
2024-06-05,308,623400,2024.03,161,741600,4606,-118200,agm
2024-06-04,224,386400,1725.0,158,405400,2566,-19000,agm
2024-06-03,256,419200,1637.5,178,543700,3054,-124500,agm
2024-05-31,237,491200,2072.57,203,494200,2434,-3000,agm
2024-05-30,187,535100,2861.5,243,537800,2213,-2700,agm
2024-05-29,245,661300,2699.18,257,800400,3114,-139100,agm
2024-05-28,213,460000,2159.62,171,333100,1948,126900,agm
2024-05-27,204,387000,1897.06,117,401400,3431,-14400,agm
2024-05-24,175,427600,2443.43,232,462200,1992,-34600,agm
2024-05-23,213,398100,1869.01,134,361600,2699,36500,agm
2024-05-22,298,582300,1954.03,199,1068800,5371,-486500,agm
2024-05-21,370,681900,1842.97,158,597500,3782,84400,agm
2024-05-20,314,789100,2513.06,164,596000,3634,193100,agm
2024-05-17,317,721400,2275.71,207,779300,3765,-57900,agm
2024-05-16,407,746500,1834.15,227,1542900,6797,-796400,agm
2024-05-15,203,356300,1755.17,194,455200,2346,-98900,agm
2024-05-14,400,550300,1375.75,250,789800,3159,-239500,agm
2024-05-13,345,477700,1384.64,226,469900,2079,7800,agm
2024-05-10,329,783700,2382.07,330,740100,2243,43600,agm
2024-05-09,568,1769100,3114.61,427,1334000,3124,435100,agm
2024-05-08,500,1467000,2934.0,182,403100,2215,1063900,agm
2024-05-07,434,1334700,3075.35,361,601200,1665,733500,agm
2024-05-06,243,294900,1213.58,188,389500,2072,-94600,agm
2024-05-03,195,278300,1427.18,152,471700,3103,-193400,agm
2024-05-02,372,554200,1489.78,193,508900,2637,45300,agm
2024-04-26,281,761600,2710.32,175,517300,2956,244300,agm
2024-04-25,118,177300,1502.54,150,244100,1627,-66800,agm
2024-04-24,252,281100,1115.48,145,196700,1357,84400,agm
2024-04-23,169,668400,3955.03,346,516600,1493,151800,agm
2024-04-22,221,365300,1652.94,234,398700,1704,-33400,agm
2024-04-19,431,505300,1172.39,324,637200,1967,-131900,agm
2024-04-17,286,275800,964.34,231,408500,1768,-132700,agm
2024-04-16,672,1005100,1495.68,379,1507800,3978,-502700,agm
2024-04-15,331,630100,1903.63,377,1130800,2999,-500700,agm
2024-04-12,429,893600,2082.98,386,1067700,2766,-174100,agm
2024-04-11,393,515700,1312.21,212,683100,3222,-167400,agm
2024-04-10,540,892500,1652.78,555,883000,1591,9500,agm
2024-04-09,610,730400,1197.38,400,2303900,5760,-1573500,agm
2024-04-08,701,897000,1279.6,377,1285400,3410,-388400,agm
2024-04-05,1046,1538500,1470.84,428,2381300,5564,-842800,agm
2024-04-04,764,1446900,1893.85,543,1661000,3059,-214100,agm
2024-04-03,923,2170100,2351.14,312,1219400,3908,950700,agm
2024-04-02,520,1177500,2264.42,495,1937400,3914,-759900,agm
2024-04-01,645,1000400,1551.01,632,2608500,4127,-1608100,agm
2024-03-29,501,902500,1801.4,300,558000,1860,344500,agm
2024-03-28,625,968600,1549.76,408,1069300,2621,-100700,agm
2024-03-27,1052,1617100,1537.17,670,1976400,2950,-359300,agm
2024-03-26,908,1263500,1391.52,536,1835100,3424,-571600,agm
2024-03-25,1342,2497500,1861.03,716,2455900,3430,41600,agm
2024-03-22,2050,4786800,2335.02,753,3586200,4763,1200600,agm
2024-03-21,1422,5100500,3586.85,154,1347900,8753,3752600,agm
2024-03-20,0,0,0.0,0,0,0,0,agm
2024-03-19,0,0,0.0,0,0,0,0,agm
2024-03-18,0,0,0.0,0,0,0,0,agm
2024-03-15,0,0,0.0,0,0,0,0,agm
2024-03-14,0,0,0.0,0,0,0,0,agm
2024-03-13,0,0,0.0,0,0,0,0,agm
2024-03-12,0,0,0.0,0,0,0,0,agm
2024-03-11,0,0,0.0,0,0,0,0,agm
2024-03-08,0,0,0.0,0,0,0,0,agm
2024-03-07,0,0,0.0,0,0,0,0,agm
2024-03-06,0,0,0.0,0,0,0,0,agm
2024-03-05,0,0,0.0,0,0,0,0,agm
2024-03-04,0,0,0.0,0,0,0,0,agm
2024-03-01,0,0,0.0,0,0,0,0,agm
2024-02-29,0,0,0.0,0,0,0,0,agm
2024-02-28,0,0,0.0,0,0,0,0,agm
2024-02-27,0,0,0.0,0,0,0,0,agm
2024-02-26,0,0,0.0,0,0,0,0,agm
2024-02-23,0,0,0.0,0,0,0,0,agm
2024-02-22,0,0,0.0,0,0,0,0,agm
2024-02-21,0,0,0.0,0,0,0,0,agm
2024-02-20,0,0,0.0,0,0,0,0,agm
2024-02-19,0,0,0.0,0,0,0,0,agm
2024-02-16,0,0,0.0,0,0,0,0,agm
2024-02-15,0,0,0.0,0,0,0,0,agm
2024-02-07,0,0,0.0,0,0,0,0,agm
2024-02-06,0,0,0.0,0,0,0,0,agm
2024-02-05,0,0,0.0,0,0,0,0,agm
2024-02-02,0,0,0.0,0,0,0,0,agm
2024-02-01,0,0,0.0,0,0,0,0,agm
2024-01-31,0,0,0.0,0,0,0,0,agm
2024-01-30,0,0,0.0,0,0,0,0,agm
2024-01-29,0,0,0.0,0,0,0,0,agm
2024-01-26,0,0,0.0,0,0,0,0,agm
2024-01-25,0,0,0.0,0,0,0,0,agm
2024-01-24,0,0,0.0,0,0,0,0,agm
2024-01-23,0,0,0.0,0,0,0,0,agm
2024-01-22,0,0,0.0,0,0,0,0,agm
2024-01-19,0,0,0.0,0,0,0,0,agm
2024-01-18,0,0,0.0,0,0,0,0,agm
2024-01-17,0,0,0.0,0,0,0,0,agm
2024-01-16,0,0,0.0,0,0,0,0,agm
2024-01-15,0,0,0.0,0,0,0,0,agm
2024-01-12,0,0,0.0,0,0,0,0,agm
2024-01-11,0,0,0.0,0,0,0,0,agm
2024-01-10,0,0,0.0,0,0,0,0,agm
2024-01-09,0,0,0.0,0,0,0,0,agm
2024-01-08,0,0,0.0,0,0,0,0,agm
2024-01-05,0,0,0.0,0,0,0,0,agm
2024-01-04,0,0,0.0,0,0,0,0,agm
2024-01-03,0,0,0.0,0,0,0,0,agm
2024-01-02,0,0,0.0,0,0,0,0,agm
2024-09-12,4,3600,900.0,9,9500,1056,-5900,agp
2024-09-11,3,1300,433.33,7,8300,1186,-7000,agp
2024-09-10,8,3500,437.5,9,15700,1744,-12200,agp
2024-09-09,10,33500,3350.0,9,12200,1356,21300,agp
2024-09-06,12,27600,2300.0,16,25300,1581,2300,agp
2024-09-05,9,10200,1133.33,12,31600,2633,-21400,agp
2024-09-04,8,26800,3350.0,12,32200,2683,-5400,agp
2024-08-30,22,19500,886.36,13,39800,3062,-20300,agp
2024-08-29,9,15400,1711.11,9,31200,3467,-15800,agp
2024-08-28,9,9500,1055.56,9,13500,1500,-4000,agp
2024-08-27,20,23500,1175.0,16,27100,1694,-3600,agp
2024-08-26,8,6700,837.5,12,43900,3658,-37200,agp
2024-08-23,13,9700,746.15,16,45200,2825,-35500,agp
2024-08-22,9,7800,866.67,12,27100,2258,-19300,agp
2024-08-21,7,4800,685.71,15,40400,2693,-35600,agp
2024-08-20,16,18400,1150.0,21,51400,2448,-33000,agp
2024-08-19,10,7600,760.0,17,42500,2500,-34900,agp
2024-08-16,8,4200,525.0,16,40200,2512,-36000,agp
2024-08-15,11,12200,1109.09,23,13300,578,-1100,agp
2024-08-14,6,5700,950.0,15,40600,2707,-34900,agp
2024-08-13,10,7200,720.0,20,10700,535,-3500,agp
2024-08-12,5,2600,520.0,18,41600,2311,-39000,agp
2024-08-09,9,5500,611.11,18,44600,2478,-39100,agp
2024-08-08,12,28700,2391.67,18,62700,3483,-34000,agp
2024-08-07,6,6500,1083.33,10,6500,650,0,agp
2024-08-06,11,8400,763.64,15,30000,2000,-21600,agp
2024-08-05,9,7400,822.22,16,40300,2519,-32900,agp
2024-08-02,13,10400,800.0,9,36000,4000,-25600,agp
2024-08-01,10,10000,1000.0,8,37800,4725,-27800,agp
2024-07-31,10,8200,820.0,11,38500,3500,-30300,agp
2024-07-30,14,10100,721.43,15,40000,2667,-29900,agp
2024-07-29,16,15600,975.0,19,40900,2153,-25300,agp
2024-07-26,17,13100,770.59,18,43900,2439,-30800,agp
2024-07-25,14,10300,735.71,18,40000,2222,-29700,agp
2024-07-24,17,11800,694.12,20,8800,440,3000,agp
2024-07-23,21,13400,638.1,20,43500,2175,-30100,agp
2024-07-22,17,10400,611.76,22,50200,2282,-39800,agp
2024-07-19,22,13000,590.91,19,47800,2516,-34800,agp
2024-07-18,23,17400,756.52,18,45300,2517,-27900,agp
2024-07-17,16,9500,593.75,19,44500,2342,-35000,agp
2024-07-16,20,14700,735.0,18,47700,2650,-33000,agp
2024-07-15,17,7800,458.82,12,43700,3642,-35900,agp
2024-07-12,11,8900,809.09,14,44800,3200,-35900,agp
2024-07-11,11,6300,572.73,14,6400,457,-100,agp
2024-07-10,18,8900,494.44,12,11600,967,-2700,agp
2024-07-09,19,8200,431.58,21,46200,2200,-38000,agp
2024-07-08,17,9900,582.35,15,43000,2867,-33100,agp
2024-07-05,12,4300,358.33,13,41900,3223,-37600,agp
2024-07-04,26,17900,688.46,20,47300,2365,-29400,agp
2024-07-03,12,5900,491.67,16,49500,3094,-43600,agp
2024-07-02,17,7700,452.94,14,26100,1864,-18400,agp
2024-07-01,19,6600,347.37,10,17500,1750,-10900,agp
2024-06-28,15,8000,533.33,9,6800,756,1200,agp
2024-06-27,19,7800,410.53,10,4800,480,3000,agp
2024-06-26,24,19000,791.67,23,25800,1122,-6800,agp
2024-06-25,15,9000,600.0,15,12200,813,-3200,agp
2024-06-24,13,12100,930.77,10,9400,940,2700,agp
2024-06-21,16,12000,750.0,16,11900,744,100,agp
2024-06-20,15,11700,780.0,11,9200,836,2500,agp
2024-06-19,24,35000,1458.33,20,31300,1565,3700,agp
2024-06-18,11,6400,581.82,11,3000,273,3400,agp
2024-06-17,16,9100,568.75,10,13500,1350,-4400,agp
2024-06-14,20,13000,650.0,9,14800,1644,-1800,agp
2024-06-13,14,9100,650.0,14,6800,486,2300,agp
2024-06-12,5,3600,720.0,11,8400,764,-4800,agp
2024-06-11,8,5500,687.5,8,3200,400,2300,agp
2024-06-10,12,8500,708.33,7,4300,614,4200,agp
2024-06-07,11,8800,800.0,8,5300,662,3500,agp
2024-06-06,10,8400,840.0,8,56100,7012,-47700,agp
2024-06-05,11,13600,1236.36,11,7600,691,6000,agp
2024-06-04,11,13900,1263.64,17,40600,2388,-26700,agp
2024-06-03,13,8600,661.54,11,10600,964,-2000,agp
2024-05-31,14,9000,642.86,16,12900,806,-3900,agp
2024-05-30,18,10200,566.67,22,39400,1791,-29200,agp
2024-05-29,11,10000,909.09,10,20000,2000,-10000,agp
2024-05-28,22,16000,727.27,18,19000,1056,-3000,agp
2024-05-27,17,9500,558.82,29,20600,710,-11100,agp
2024-05-24,28,16000,571.43,15,15000,1000,1000,agp
2024-05-23,27,22200,822.22,16,14600,912,7600,agp
2024-05-22,25,23300,932.0,18,49800,2767,-26500,agp
2024-05-21,48,27300,568.75,41,97300,2373,-70000,agp
2024-05-20,32,18300,571.88,18,23200,1289,-4900,agp
2024-05-17,31,23400,754.84,33,25000,758,-1600,agp
2024-05-16,27,17400,644.44,31,24500,790,-7100,agp
2024-05-15,28,10000,357.14,21,9800,467,200,agp
2024-05-14,13,11500,884.62,24,11100,462,400,agp
2024-05-13,13,9400,723.08,35,61400,1754,-52000,agp
2024-05-10,16,24900,1556.25,28,35400,1264,-10500,agp
2024-05-09,20,31000,1550.0,28,47900,1711,-16900,agp
2024-05-08,11,4500,409.09,12,25200,2100,-20700,agp
2024-05-07,15,4300,286.67,12,39700,3308,-35400,agp
2024-05-06,12,4400,366.67,20,39500,1975,-35100,agp
2024-05-03,13,9700,746.15,14,29200,2086,-19500,agp
2024-05-02,13,6500,500.0,19,33700,1774,-27200,agp
2024-04-26,5,1100,220.0,13,45400,3492,-44300,agp
2024-04-25,9,1400,155.56,12,44700,3725,-43300,agp
2024-04-24,17,13200,776.47,26,48200,1854,-35000,agp
2024-04-23,13,4000,307.69,19,53100,2795,-49100,agp
2024-04-22,10,2000,200.0,16,56000,3500,-54000,agp
2024-04-19,23,11700,508.7,33,75100,2276,-63400,agp
2024-04-17,19,12200,642.11,47,95800,2038,-83600,agp
2024-04-16,22,9200,418.18,34,159700,4697,-150500,agp
2024-04-15,22,32600,1481.82,47,123600,2630,-91000,agp
2024-04-12,15,11300,753.33,18,66300,3683,-55000,agp
2024-04-11,15,7000,466.67,21,70300,3348,-63300,agp
2024-04-10,19,11500,605.26,33,47900,1452,-36400,agp
2024-04-09,15,9700,646.67,23,21400,930,-11700,agp
2024-04-08,31,12900,416.13,29,31900,1100,-19000,agp
2024-04-05,71,35100,494.37,29,92600,3193,-57500,agp
2024-04-04,54,33900,627.78,36,83100,2308,-49200,agp
2024-04-03,57,44600,782.46,44,144100,3275,-99500,agp
2024-04-02,73,99000,1356.16,59,233900,3964,-134900,agp
2024-04-01,87,90000,1034.48,27,89000,3296,1000,agp
2024-03-29,53,89100,1681.13,28,153400,5479,-64300,agp
2024-03-28,23,20700,900.0,15,76100,5073,-55400,agp
2024-03-27,20,10700,535.0,11,55300,5027,-44600,agp
2024-03-26,17,7300,429.41,15,65200,4347,-57900,agp
2024-03-25,13,6300,484.62,12,57100,4758,-50800,agp
2024-03-22,15,4500,300.0,8,42900,5362,-38400,agp
2024-03-21,15,5900,393.33,14,52100,3721,-46200,agp
2024-03-20,14,7200,514.29,18,33800,1878,-26600,agp
2024-03-19,11,5700,518.18,12,13600,1133,-7900,agp
2024-03-18,16,7300,456.25,14,61400,4386,-54100,agp
2024-03-15,19,9900,521.05,23,83100,3613,-73200,agp
2024-03-14,22,5600,254.55,18,57100,3172,-51500,agp
2024-03-13,11,6200,563.64,18,56700,3150,-50500,agp
2024-03-12,8,6500,812.5,9,63100,7011,-56600,agp
2024-03-11,11,4800,436.36,17,51700,3041,-46900,agp
2024-03-08,14,7100,507.14,17,43600,2565,-36500,agp
2024-03-07,13,56100,4315.38,12,59700,4975,-3600,agp
2024-03-06,16,5400,337.5,19,13100,689,-7700,agp
2024-03-05,26,63000,2423.08,25,15300,612,47700,agp
2024-03-04,19,40100,2110.53,10,19300,1930,20800,agp
2024-03-01,24,175300,7304.17,118,80400,681,94900,agp
2024-02-29,18,27900,1550.0,10,42500,4250,-14600,agp
2024-02-28,14,13300,950.0,21,30900,1471,-17600,agp
2024-02-27,10,4300,430.0,14,43100,3079,-38800,agp
2024-02-26,15,25800,1720.0,12,14800,1233,11000,agp
2024-02-23,16,14200,887.5,15,32500,2167,-18300,agp
2024-02-22,7,6400,914.29,11,17700,1609,-11300,agp
2024-02-21,9,16400,1822.22,17,23700,1394,-7300,agp
2024-02-20,7,6500,928.57,10,18600,1860,-12100,agp
2024-02-19,9,12300,1366.67,10,17700,1770,-5400,agp
2024-02-16,21,19100,909.52,10,38600,3860,-19500,agp
2024-02-15,10,1500,150.0,9,16400,1822,-14900,agp
2024-02-07,10,12300,1230.0,8,14400,1800,-2100,agp
2024-02-06,13,56800,4369.23,9,49700,5522,7100,agp
2024-02-05,9,13200,1466.67,12,15300,1275,-2100,agp
2024-02-02,7,31300,4471.43,18,20200,1122,11100,agp
2024-02-01,4,6800,1700.0,17,45900,2700,-39100,agp
2024-01-31,3,31300,10433.33,11,16500,1500,14800,agp
2024-01-30,5,14500,2900.0,10,45500,4550,-31000,agp
2024-01-29,4,30000,7500.0,8,22700,2838,7300,agp
2024-01-26,5,24300,4860.0,6,24100,4017,200,agp
2024-01-25,2,9400,4700.0,7,53900,7700,-44500,agp
2024-01-24,1,12000,12000.0,8,42900,5362,-30900,agp
2024-01-23,4,24300,6075.0,12,17900,1492,6400,agp
2024-01-22,2,12200,6100.0,8,17700,2212,-5500,agp
2024-01-19,3,12200,4066.67,7,11900,1700,300,agp
2024-01-18,3,32100,10700.0,12,26300,2192,5800,agp
2024-01-17,4,12400,3100.0,11,20800,1891,-8400,agp
2024-01-16,3,13200,4400.0,11,26600,2418,-13400,agp
2024-01-15,2,12200,6100.0,8,13600,1700,-1400,agp
2024-01-12,2,17000,8500.0,11,16500,1500,500,agp
2024-01-11,7,17600,2514.29,11,15500,1409,2100,agp
2024-01-10,4,6900,1725.0,15,16700,1113,-9800,agp
2024-01-09,2,1000,500.0,14,17500,1250,-16500,agp
2024-01-08,2,600,300.0,11,17700,1609,-17100,agp
2024-01-05,2,10500,5250.0,10,17000,1700,-6500,agp
2024-01-04,1,300,300.0,8,14100,1762,-13800,agp
2024-01-03,2,2300,1150.0,15,36500,2433,-34200,agp
2024-01-02,5,3900,780.0,10,17400,1740,-13500,agp
2024-09-12,499,771500,1546.09,447,997100,2231,-225600,agr
2024-09-11,1525,2565000,1681.97,728,2058700,2828,506300,agr
2024-09-10,1043,1766400,1693.58,590,1735200,2941,31200,agr
2024-09-09,847,1234900,1457.97,435,967100,2223,267800,agr
2024-09-06,802,1337100,1667.21,566,1287300,2274,49800,agr
2024-09-05,920,1969100,2140.33,715,2074300,2901,-105200,agr
2024-09-04,1478,2873000,1943.84,606,2176000,3591,697000,agr
2024-08-30,715,1559700,2181.4,676,1840900,2723,-281200,agr
2024-08-29,753,1346900,1788.71,756,1833100,2425,-486200,agr
2024-08-28,1234,2400400,1945.22,948,2505300,2643,-104900,agr
2024-08-27,1294,2034700,1572.41,897,3224600,3595,-1189900,agr
2024-08-26,1103,2807200,2545.06,1633,3803800,2329,-996600,agr
2024-08-23,1357,3672600,2706.41,1543,3484900,2259,187700,agr
2024-08-22,1313,4214100,3209.52,1051,2671200,2542,1542900,agr
2024-08-21,1368,2283700,1669.37,798,2657600,3330,-373900,agr
2024-08-20,1716,6440200,3753.03,1656,4652700,2810,1787500,agr
2024-08-19,1427,6399000,4484.23,1508,3416600,2266,2982400,agr
2024-08-16,1768,16024600,9063.69,1462,3466800,2371,12557800,agr
2024-08-15,1069,2242300,2097.57,558,1386700,2485,855600,agr
2024-08-14,1028,1726300,1679.28,694,2602000,3749,-875700,agr
2024-08-13,999,2122400,2124.52,763,2635100,3454,-512700,agr
2024-08-12,811,1513000,1865.6,678,2148200,3168,-635200,agr
2024-08-08,956,1717000,1796.03,797,1906800,2392,-189800,agr
2024-08-07,837,1331100,1590.32,694,1644300,2369,-313200,agr
2024-08-06,1086,3003300,2765.47,1166,3276000,2810,-272700,agr
2024-08-05,1362,2627100,1928.85,941,2520100,2678,107000,agr
2024-08-02,1228,2734900,2227.12,912,2738700,3003,-3800,agr
2024-08-01,2284,4497500,1969.13,887,4852600,5471,-355100,agr
2024-07-31,518,1031600,1991.51,574,1321700,2303,-290100,agr
2024-07-30,820,1297200,1581.95,462,1265000,2738,32200,agr
2024-07-29,688,1284600,1867.15,588,1083700,1843,200900,agr
2024-07-26,670,1260100,1880.75,570,1341300,2353,-81200,agr
2024-07-25,899,2011000,2236.93,467,1124100,2407,886900,agr
2024-07-24,1895,3635200,1918.31,987,2627300,2662,1007900,agr
2024-07-22,2781,4850300,1744.08,1437,4324600,3009,525700,agr
2024-07-19,1660,2377200,1432.05,806,2563900,3181,-186700,agr
2024-07-18,1744,2975800,1706.31,748,2375800,3176,600000,agr
2024-07-17,1505,2919900,1940.13,1040,3316900,3189,-397000,agr
2024-07-16,1319,2501500,1896.51,1142,3008900,2635,-507400,agr
2024-07-15,780,1407100,1803.97,739,1836100,2485,-429000,agr
2024-07-12,923,2100400,2275.62,822,2117700,2576,-17300,agr
2024-07-11,1038,2510000,2418.11,1346,2953100,2194,-443100,agr
2024-07-10,1060,2371400,2237.17,1085,2984700,2751,-613300,agr
2024-07-09,1441,4327700,3003.26,1979,4046200,2045,281500,agr
2024-07-08,1006,2501400,2486.48,1026,2237200,2181,264200,agr
2024-07-05,1830,3350800,1831.04,717,2865900,3997,484900,agr
2024-07-04,1052,2090300,1986.98,1076,2561900,2381,-471600,agr
2024-07-03,875,1887300,2156.91,951,2134500,2244,-247200,agr
2024-07-02,905,1850300,2044.53,1160,2354100,2029,-503800,agr
2024-07-01,1455,2867200,1970.58,827,1552100,1877,1315100,agr
2024-06-28,2591,5259200,2029.8,1237,4184200,3383,1075000,agr
2024-06-27,1300,2043400,1571.85,668,1719900,2575,323500,agr
2024-06-26,1557,2677600,1719.72,870,2415200,2776,262400,agr
2024-06-25,1179,2407200,2041.73,774,1887300,2438,519900,agr
2024-06-24,4345,7823000,1800.46,1904,7158200,3760,664800,agr
2024-06-21,1650,2851400,1728.12,984,2699900,2744,151500,agr
2024-06-20,1661,2956000,1779.65,1031,2634100,2555,321900,agr
2024-06-19,2914,5511400,1891.35,1481,4290200,2897,1221200,agr
2024-06-18,1315,2740400,2083.95,938,2791500,2976,-51100,agr
2024-06-17,2225,5273800,2370.25,1361,4033000,2963,1240800,agr
2024-06-14,2130,4414500,2072.54,1901,6001800,3157,-1587300,agr
2024-06-13,1475,3042200,2062.51,1256,4606600,3668,-1564400,agr
2024-06-12,1709,4026600,2356.11,2212,4714200,2131,-687600,agr
2024-06-11,2214,6929900,3130.04,3255,7689400,2362,-759500,agr
2024-06-10,1942,5675800,2922.66,3085,6791700,2202,-1115900,agr
2024-06-07,1206,2764100,2291.96,1308,3197500,2445,-433400,agr
2024-06-06,1744,3251300,1864.28,1493,4277300,2865,-1026000,agr
2024-06-05,1937,4706900,2429.99,2240,5654800,2524,-947900,agr
2024-06-04,1794,3863000,2153.29,2325,6411300,2758,-2548300,agr
2024-06-03,1539,2940300,1910.53,1906,4774900,2505,-1834600,agr
2024-05-31,1940,4185000,2157.22,2593,6627300,2556,-2442300,agr
2024-05-30,3539,9614300,2716.67,4457,9055600,2032,558700,agr
2024-05-29,2582,7045900,2728.85,4080,8329000,2041,-1283100,agr
2024-05-28,1495,3738400,2500.6,2051,4646600,2266,-908200,agr
2024-05-27,1337,2277400,1703.37,811,2494200,3075,-216800,agr
2024-05-24,3934,6172100,1568.91,1999,6840900,3422,-668800,agr
2024-05-23,2179,3816000,1751.26,1755,4262600,2429,-446600,agr
2024-05-22,2539,5653800,2226.78,3059,6486300,2120,-832500,agr
2024-05-21,2313,4305700,1861.52,1374,4543800,3307,-238100,agr
2024-05-20,1380,2713000,1965.94,1838,3642000,1982,-929000,agr
2024-05-17,1846,4866400,2636.19,2135,5433600,2545,-567200,agr
2024-05-16,1421,3332300,2345.04,1653,5316500,3216,-1984200,agr
2024-05-15,2206,5586400,2532.37,2421,6891000,2846,-1304600,agr
2024-05-14,1019,1727700,1695.49,1280,3299600,2578,-1571900,agr
2024-05-13,1926,4635200,2406.65,1728,4280100,2477,355100,agr
2024-05-10,1489,3437400,2308.53,1439,4002700,2782,-565300,agr
2024-05-09,1502,2459100,1637.22,1388,3307100,2383,-848000,agr
2024-05-08,2372,5882500,2479.97,2162,5948700,2751,-66200,agr
2024-05-07,1751,3731500,2131.07,1437,4639900,3229,-908400,agr
2024-05-06,1599,4589500,2870.23,2440,6077700,2491,-1488200,agr
2024-05-03,1155,3767800,3262.16,1529,3081800,2016,686000,agr
2024-05-02,2504,4106900,1640.14,1520,5786900,3807,-1680000,agr
2024-04-26,2238,3723600,1663.81,1570,4347200,2769,-623600,agr
2024-04-25,2257,5421900,2402.26,1687,4898300,2904,523600,agr
2024-04-24,2332,6897900,2957.93,2324,5656200,2434,1241700,agr
2024-04-23,3330,5770600,1732.91,1967,7533200,3830,-1762600,agr
2024-04-22,2514,6114900,2432.34,2482,6248800,2518,-133900,agr
2024-04-19,4695,8751900,1864.09,2858,10457000,3659,-1705100,agr
2024-04-17,2959,4956200,1674.96,1652,5703500,3452,-747300,agr
2024-04-16,4611,9537200,2068.36,2502,7875400,3148,1661800,agr
2024-04-15,3358,8703200,2591.78,4230,10799200,2553,-2096000,agr
2024-04-12,1782,4622800,2594.16,2353,5341800,2270,-719000,agr
2024-04-11,2261,4154500,1837.46,1382,3616400,2617,538100,agr
2024-04-10,1747,2704000,1547.8,1191,3461000,2906,-757000,agr
2024-04-09,1949,4663100,2392.56,1586,4191200,2643,471900,agr
2024-04-08,2746,6381000,2323.74,1595,4446800,2788,1934200,agr
2024-04-05,3647,6573100,1802.33,1557,5677500,3646,895600,agr
2024-04-04,3556,5656800,1590.78,1448,5333800,3684,323000,agr
2024-04-03,2523,5344500,2118.31,2464,8432400,3422,-3087900,agr
2024-04-02,2685,4379400,1631.06,1293,4058800,3139,320600,agr
2024-04-01,2543,4146700,1630.63,1933,4144400,2144,2300,agr
2024-03-29,2397,4781300,1994.7,1886,5034800,2670,-253500,agr
2024-03-28,3776,11895800,3150.37,4150,9914300,2389,1981500,agr
2024-03-27,1518,3089700,2035.38,1648,3680700,2233,-591000,agr
2024-03-26,1870,3536200,1891.02,1326,2856400,2154,679800,agr
2024-03-25,2337,3952300,1691.19,1722,4716600,2739,-764300,agr
2024-03-22,2950,6451500,2186.95,3234,8287600,2563,-1836100,agr
2024-03-21,2222,5708400,2569.04,2803,8201300,2926,-2492900,agr
2024-03-20,1987,4635300,2332.81,2085,5216700,2502,-581400,agr
2024-03-19,2181,5544900,2542.37,1614,4669700,2893,875200,agr
2024-03-18,5312,10101900,1901.71,2918,13048200,4472,-2946300,agr
2024-03-15,2796,5686700,2033.87,1540,5250900,3410,435800,agr
2024-03-14,3674,6985100,1901.22,2116,7622600,3602,-637500,agr
2024-03-13,2501,8039000,3214.31,2786,8990800,3227,-951800,agr
2024-03-12,2689,5471400,2034.73,1592,5697800,3579,-226400,agr
2024-03-11,3099,8139500,2626.49,2459,6212700,2527,1926800,agr
2024-03-08,3405,11806200,3467.31,3739,9595000,2566,2211200,agr
2024-03-07,3157,13028500,4126.86,2156,4613800,2140,8414700,agr
2024-03-06,2857,7288300,2551.03,3234,9353500,2892,-2065200,agr
2024-03-05,2562,6350000,2478.53,1880,6174300,3284,175700,agr
2024-03-04,1417,3721900,2626.61,1623,4050300,2496,-328400,agr
2024-03-01,2223,7162100,3221.82,3156,8259500,2617,-1097400,agr
2024-02-29,1843,5543400,3007.81,2336,6998700,2996,-1455300,agr
2024-02-28,1409,2597600,1843.58,1298,3407400,2625,-809800,agr
2024-02-27,1273,4007500,3148.08,1658,4534200,2735,-526700,agr
2024-02-26,1586,4934800,3111.48,1402,4450200,3174,484600,agr
2024-02-23,1952,4265200,2185.04,1618,7602300,4699,-3337100,agr
2024-02-22,1291,2162100,1674.75,826,2758600,3340,-596500,agr
2024-02-21,1178,2306500,1957.98,976,2805400,2874,-498900,agr
2024-02-20,1591,5777100,3631.11,2193,5863400,2674,-86300,agr
2024-02-19,1899,3664100,1929.49,1065,3784300,3553,-120200,agr
2024-02-16,1296,2767100,2135.11,1099,3703700,3370,-936600,agr
2024-02-15,1278,2593300,2029.19,843,3291400,3904,-698100,agr
2024-02-07,0,0,0.0,0,0,0,0,agr
2024-02-06,849,2382500,2806.24,1511,3456700,2288,-1074200,agr
2024-02-05,931,2740000,2943.07,1369,3460600,2528,-720600,agr
2024-02-02,1662,8139200,4897.23,2951,8133500,2756,5700,agr
2024-02-01,1103,2570500,2330.46,1074,3676100,3423,-1105600,agr
2024-01-31,1608,4867700,3027.18,2643,7023600,2657,-2155900,agr
2024-01-30,1260,2313800,1836.35,807,2752400,3411,-438600,agr
2024-01-29,690,1201300,1741.01,877,2115200,2412,-913900,agr
2024-01-26,850,1555100,1829.53,905,2430900,2686,-875800,agr
2024-01-25,740,1353200,1828.65,993,2654500,2673,-1301300,agr
2024-01-24,1233,3087300,2503.89,1935,5061100,2616,-1973800,agr
2024-01-23,899,1965800,2186.65,991,2898600,2925,-932800,agr
2024-01-22,1202,2462500,2048.67,1090,2820100,2587,-357600,agr
2024-01-19,1174,2311100,1968.57,1176,2994200,2546,-683100,agr
2024-01-18,1504,3291200,2188.3,1236,4569600,3697,-1278400,agr
2024-01-17,1689,4033600,2388.16,2174,7252800,3336,-3219200,agr
2024-01-16,1463,3039300,2077.44,764,2088000,2733,951300,agr
2024-01-15,1374,2744900,1997.74,931,3344100,3592,-599200,agr
2024-01-12,1644,3529500,2146.9,1270,3842000,3025,-312500,agr
2024-01-11,1618,3871900,2393.02,1569,4258300,2714,-386400,agr
2024-01-10,0,0,0.0,0,0,0,0,agr
2024-01-09,1670,3922500,2348.8,1718,4450100,2590,-527600,agr
2024-01-08,2139,7858300,3673.82,3174,7485800,2358,372500,agr
2024-01-05,1350,3289700,2436.81,1319,3246600,2461,43100,agr
2024-01-04,2015,6912500,3430.52,3154,7550600,2394,-638100,agr
2024-01-03,1209,2067000,1709.68,734,2546100,3469,-479100,agr
2024-01-02,1200,2279400,1899.5,1192,3501700,2938,-1222300,agr
2024-09-12,9,1000,111.11,1,1000,1000,0,agx
2024-09-11,1,300,300.0,1,1000,1000,-700,agx
2024-09-10,2,500,250.0,1,100,100,400,agx
2024-09-09,2,100,50.0,1,1000,1000,-900,agx
2024-09-06,1,100,100.0,1,1000,1000,-900,agx
2024-09-05,4,400,100.0,1,1000,1000,-600,agx
2024-09-04,2,200,100.0,2,200,100,0,agx
2024-08-30,1,0,0.0,1,100,100,-100,agx
2024-08-29,0,0,0.0,0,0,0,0,agx
2024-08-28,5,500,100.0,1,1000,1000,-500,agx
2024-08-27,7,600,85.71,1,1000,1000,-400,agx
2024-08-26,3,300,100.0,0,0,0,300,agx
2024-08-23,3,300,100.0,1,500,500,-200,agx
2024-08-22,9,600,66.67,2,600,300,0,agx
2024-08-21,2,500,250.0,2,900,450,-400,agx
2024-08-20,1,100,100.0,3,1100,367,-1000,agx
2024-08-19,5,1100,220.0,1,500,500,600,agx
2024-08-16,1,100,100.0,2,1500,750,-1400,agx
2024-08-15,4,400,100.0,1,500,500,-100,agx
2024-08-14,5,400,80.0,2,600,300,-200,agx
2024-08-13,6,400,66.67,2,500,250,-100,agx
2024-08-12,4,400,100.0,2,200,100,200,agx
2024-08-09,2,300,150.0,2,500,250,-200,agx
2024-08-08,2,200,100.0,1,300,300,-100,agx
2024-08-07,1,100,100.0,1,100,100,0,agx
2024-08-06,2,200,100.0,2,300,150,-100,agx
2024-08-05,2,100,50.0,2,1700,850,-1600,agx
2024-08-02,3,100,33.33,1,500,500,-400,agx
2024-08-01,3,200,66.67,1,500,500,-300,agx
2024-07-31,1,100,100.0,1,2000,2000,-1900,agx
2024-07-30,3,300,100.0,1,100,100,200,agx
2024-07-29,2,100,50.0,1,100,100,0,agx
2024-07-26,7,1600,228.57,2,200,100,1400,agx
2024-07-25,10,2900,290.0,3,3500,1167,-600,agx
2024-07-24,10,900,90.0,3,900,300,0,agx
2024-07-23,6,1100,183.33,3,1600,533,-500,agx
2024-07-22,2,100,50.0,2,100,50,0,agx
2024-07-19,3,300,100.0,3,1000,333,-700,agx
2024-07-18,8,800,100.0,4,1400,350,-600,agx
2024-07-17,10,1100,110.0,4,1600,400,-500,agx
2024-07-16,8,800,100.0,3,2000,667,-1200,agx
2024-07-15,4,300,75.0,4,2100,525,-1800,agx
2024-07-12,4,1000,250.0,7,3400,486,-2400,agx
2024-07-11,3,1000,333.33,5,2800,560,-1800,agx
2024-07-10,5,300,60.0,4,1400,350,-1100,agx
2024-07-09,4,400,100.0,4,1200,300,-800,agx
2024-07-08,14,3000,214.29,12,4100,342,-1100,agx
2024-07-05,3,200,66.67,4,2200,550,-2000,agx
2024-07-04,7,3000,428.57,5,2000,400,1000,agx
2024-07-03,2,1100,550.0,2,300,150,800,agx
2024-07-02,2,1100,550.0,2,200,100,900,agx
2024-07-01,4,600,150.0,3,500,167,100,agx
2024-06-28,4,200,50.0,3,100,33,100,agx
2024-06-27,3,600,200.0,2,300,150,300,agx
2024-06-26,12,1300,108.33,2,200,100,1100,agx
2024-06-25,3,300,100.0,2,100,50,200,agx
2024-06-24,8,1100,137.5,3,300,100,800,agx
2024-06-21,9,900,100.0,4,600,150,300,agx
2024-06-20,7,500,71.43,2,500,250,0,agx
2024-06-19,6,600,100.0,10,2100,210,-1500,agx
2024-06-18,1,100,100.0,5,1400,280,-1300,agx
2024-06-17,2,200,100.0,6,1600,267,-1400,agx
2024-06-14,11,1800,163.64,6,2400,400,-600,agx
2024-06-13,17,3900,229.41,9,2400,267,1500,agx
2024-06-12,5,900,180.0,3,1100,367,-200,agx
2024-06-11,3,1000,333.33,3,1400,467,-400,agx
2024-06-10,7,1500,214.29,5,1300,260,200,agx
2024-06-07,11,2900,263.64,4,1300,325,1600,agx
2024-06-06,5,800,160.0,2,200,100,600,agx
2024-06-05,4,900,225.0,2,300,150,600,agx
2024-06-04,3,700,233.33,1,200,200,500,agx
2024-06-03,2,600,300.0,1,200,200,400,agx
2024-05-31,3,600,200.0,1,100,100,500,agx
2024-05-30,4,700,175.0,1,200,200,500,agx
2024-05-29,4,700,175.0,1,200,200,500,agx
2024-05-28,4,500,125.0,2,300,150,200,agx
2024-05-27,11,3100,281.82,1,300,300,2800,agx
2024-05-24,8,1300,162.5,2,400,200,900,agx
2024-05-23,3,600,200.0,3,300,100,300,agx
2024-05-22,8,5700,712.5,9,6700,744,-1000,agx
2024-05-21,4,200,50.0,3,1000,333,-800,agx
2024-05-20,12,3200,266.67,7,2300,329,900,agx
2024-05-17,9,2800,311.11,11,3000,273,-200,agx
2024-05-16,12,1600,133.33,5,1700,340,-100,agx
2024-05-15,4,800,200.0,1,100,100,700,agx
2024-05-14,9,1800,200.0,2,200,100,1600,agx
2024-05-13,3,700,233.33,3,300,100,400,agx
2024-05-10,4,200,50.0,1,100,100,100,agx
2024-05-09,4,400,100.0,1,100,100,300,agx
2024-05-08,11,2000,181.82,4,700,175,1300,agx
2024-05-07,6,3200,533.33,3,300,100,2900,agx
2024-05-06,4,400,100.0,3,200,67,200,agx
2024-05-03,7,1000,142.86,5,2700,540,-1700,agx
2024-05-02,10,1000,100.0,2,200,100,800,agx
2024-04-26,3,300,100.0,5,2400,480,-2100,agx
2024-04-25,4,900,225.0,3,1900,633,-1000,agx
2024-04-24,1,0,0.0,2,700,350,-700,agx
2024-04-23,1,100,100.0,1,600,600,-500,agx
2024-04-22,3,1200,400.0,4,2200,550,-1000,agx
2024-04-19,0,0,0.0,3,1000,333,-1000,agx
2024-04-17,0,0,0.0,1,300,300,-300,agx
2024-04-16,0,0,0.0,3,1100,367,-1100,agx
2024-04-15,0,0,0.0,1,1000,1000,-1000,agx
2024-04-12,0,0,0.0,1,1300,1300,-1300,agx
2024-04-11,8,800,100.0,1,100,100,700,agx
2024-04-10,4,1000,250.0,11,15500,1409,-14500,agx
2024-04-09,0,0,0.0,1,0,0,0,agx
2024-04-08,0,0,0.0,3,2200,733,-2200,agx
2024-04-05,1,100,100.0,5,2300,460,-2200,agx
2024-04-04,0,0,0.0,5,1300,260,-1300,agx
2024-04-03,0,0,0.0,5,2000,400,-2000,agx
2024-04-02,0,0,0.0,4,300,75,-300,agx
2024-04-01,1,100,100.0,4,300,75,-200,agx
2024-03-29,1,100,100.0,3,300,100,-200,agx
2024-03-28,1,100,100.0,8,300,38,-200,agx
2024-03-27,3,1600,533.33,4,1000,250,600,agx
2024-03-26,3,3200,1066.67,4,500,125,2700,agx
2024-03-25,11,4600,418.18,3,300,100,4300,agx
2024-03-22,17,21500,1264.71,3,17300,5767,4200,agx
2024-03-21,9,4700,522.22,1,6300,6300,-1600,agx
2024-03-20,14,7800,557.14,3,19500,6500,-11700,agx
2024-03-19,9,4900,544.44,2,9500,4750,-4600,agx
2024-03-18,10,103900,10390.0,0,0,0,103900,agx
2024-03-15,9,103700,11522.22,0,0,0,103700,agx
2024-03-14,7,4700,671.43,0,0,0,4700,agx
2024-03-13,8,6100,762.5,3,2900,967,3200,agx
2024-03-12,8,6000,750.0,4,2100,525,3900,agx
2024-03-11,8,103500,12937.5,4,3500,875,100000,agx
2024-03-08,8,102700,12837.5,0,0,0,102700,agx
2024-03-07,5,2000,400.0,0,0,0,2000,agx
2024-03-06,9,7400,822.22,2,2300,1150,5100,agx
2024-03-05,11,9300,845.45,3,10100,3367,-800,agx
2024-03-04,9,3000,333.33,2,500,250,2500,agx
2024-03-01,7,4500,642.86,1,500,500,4000,agx
2024-02-29,7,3200,457.14,0,0,0,3200,agx
2024-02-28,6,3000,500.0,0,0,0,3000,agx
2024-02-27,5,2700,540.0,0,0,0,2700,agx
2024-02-26,6,3300,550.0,0,0,0,3300,agx
2024-02-23,5,2800,560.0,0,0,0,2800,agx
2024-02-22,5,1600,320.0,0,0,0,1600,agx
2024-02-21,7,5000,714.29,0,0,0,5000,agx
2024-02-20,9,5200,577.78,1,2200,2200,3000,agx
2024-02-19,6,4000,666.67,0,0,0,4000,agx
2024-02-16,6,3800,633.33,0,0,0,3800,agx
2024-02-15,8,3900,487.5,0,0,0,3900,agx
2024-02-07,8,8500,1062.5,2,100,50,8400,agx
2024-02-06,7,6400,914.29,0,0,0,6400,agx
2024-02-05,7,3400,485.71,1,200,200,3200,agx
2024-02-02,6,4000,666.67,0,0,0,4000,agx
2024-02-01,3,1900,633.33,0,0,0,1900,agx
2024-01-31,7,3000,428.57,1,100,100,2900,agx
2024-01-30,14,28200,2014.29,4,27500,6875,700,agx
2024-01-29,9,5000,555.56,2,300,150,4700,agx
2024-01-26,7,3600,514.29,2,300,150,3300,agx
2024-01-25,10,7400,740.0,2,25000,12500,-17600,agx
2024-01-24,8,5600,700.0,2,700,350,4900,agx
2024-01-23,24,44800,1866.67,8,50700,6338,-5900,agx
2024-01-22,34,69000,2029.41,8,42200,5275,26800,agx
2024-01-19,7,3900,557.14,2,2300,1150,1600,agx
2024-01-18,5,3400,680.0,0,0,0,3400,agx
2024-01-17,6,3700,616.67,2,600,300,3100,agx
2024-01-16,4,2400,600.0,0,0,0,2400,agx
2024-01-15,4,2400,600.0,1,200,200,2200,agx
2024-01-12,5,2500,500.0,0,0,0,2500,agx
2024-01-11,4,2300,575.0,0,0,0,2300,agx
2024-01-10,9,3900,433.33,2,800,400,3100,agx
2024-01-09,9,3400,377.78,3,1000,333,2400,agx
2024-01-08,11,5000,454.55,4,1900,475,3100,agx
2024-01-05,10,5800,580.0,2,600,300,5200,agx
2024-01-04,10,5200,520.0,1,2500,2500,2700,agx
2024-01-03,25,19200,768.0,7,15400,2200,3800,agx
2024-01-02,11,5400,490.91,4,5500,1375,-100,agx
2024-09-12,0,0,0.0,14,10100,721,-10100,alt
2024-09-11,0,0,0.0,8,7800,975,-7800,alt
2024-09-10,0,0,0.0,11,6100,555,-6100,alt
2024-09-09,0,0,0.0,13,6600,508,-6600,alt
2024-09-06,1,100,100.0,16,7200,450,-7100,alt
2024-09-05,0,0,0.0,9,3600,400,-3600,alt
2024-09-04,0,0,0.0,8,4000,500,-4000,alt
2024-08-30,3,2100,700.0,13,6100,469,-4000,alt
2024-08-29,4,4200,1050.0,11,3000,273,1200,alt
2024-08-28,7,1300,185.71,12,4300,358,-3000,alt
2024-08-27,8,25300,3162.5,11,24100,2191,1200,alt
2024-08-26,7,9400,1342.86,10,3300,330,6100,alt
2024-08-23,7,4400,628.57,8,3600,450,800,alt
2024-08-22,9,7700,855.56,11,4200,382,3500,alt
2024-08-21,9,15300,1700.0,8,4100,512,11200,alt
2024-08-20,10,12700,1270.0,10,5400,540,7300,alt
2024-08-19,20,11600,580.0,16,5000,312,6600,alt
2024-08-16,5,3800,760.0,11,4600,418,-800,alt
2024-08-15,8,6900,862.5,12,6000,500,900,alt
2024-08-14,6,3300,550.0,9,5400,600,-2100,alt
2024-08-13,4,800,200.0,11,5500,500,-4700,alt
2024-08-12,12,4300,358.33,16,5300,331,-1000,alt
2024-08-09,3,800,266.67,9,6000,667,-5200,alt
2024-08-08,6,2700,450.0,8,5700,712,-3000,alt
2024-08-07,9,5500,611.11,8,3900,488,1600,alt
2024-08-06,10,6700,670.0,7,4200,600,2500,alt
2024-08-05,10,9300,930.0,18,12300,683,-3000,alt
2024-08-02,3,1600,533.33,8,6900,862,-5300,alt
2024-08-01,4,1200,300.0,7,6600,943,-5400,alt
2024-07-31,8,1600,200.0,9,8400,933,-6800,alt
2024-07-30,4,600,150.0,9,9000,1000,-8400,alt
2024-07-29,13,1700,130.77,13,6100,469,-4400,alt
2024-07-26,5,1300,260.0,10,5900,590,-4600,alt
2024-07-25,2,200,100.0,11,6000,545,-5800,alt
2024-07-24,0,0,0.0,8,5800,725,-5800,alt
2024-07-23,0,0,0.0,11,7200,655,-7200,alt
2024-07-22,1,100,100.0,12,10900,908,-10800,alt
2024-07-19,6,800,133.33,11,3100,282,-2300,alt
2024-07-18,1,300,300.0,6,3900,650,-3600,alt
2024-07-17,6,1200,200.0,9,4100,456,-2900,alt
2024-07-16,9,9900,1100.0,5,2600,520,7300,alt
2024-07-15,4,500,125.0,9,5000,556,-4500,alt
2024-07-12,2,200,100.0,5,3500,700,-3300,alt
2024-07-11,1,100,100.0,7,7000,1000,-6900,alt
2024-07-10,0,0,0.0,10,8000,800,-8000,alt
2024-07-09,0,0,0.0,15,14300,953,-14300,alt
2024-07-08,0,0,0.0,11,57600,5236,-57600,alt
2024-07-05,1,100,100.0,9,4900,544,-4800,alt
2024-07-04,0,0,0.0,10,10100,1010,-10100,alt
2024-07-03,3,8800,2933.33,7,4700,671,4100,alt
2024-07-02,9,8300,922.22,3,500,167,7800,alt
2024-07-01,12,8000,666.67,10,2000,200,6000,alt
2024-06-28,13,9100,700.0,7,1900,271,7200,alt
2024-06-27,7,5600,800.0,5,1500,300,4100,alt
2024-06-26,26,12300,473.08,14,9500,679,2800,alt
2024-06-25,14,8400,600.0,10,1800,180,6600,alt
2024-06-24,11,11800,1072.73,6,1100,183,10700,alt
2024-06-21,13,15000,1153.85,9,1900,211,13100,alt
2024-06-20,6,3900,650.0,10,2100,210,1800,alt
2024-06-19,17,13800,811.76,6,1100,183,12700,alt
2024-06-18,12,13700,1141.67,6,1100,183,12600,alt
2024-06-17,25,8400,336.0,16,3400,212,5000,alt
2024-06-14,9,5400,600.0,10,3500,350,1900,alt
2024-06-13,9,12900,1433.33,10,3500,350,9400,alt
2024-06-12,10,13100,1310.0,10,3100,310,10000,alt
2024-06-11,13,6200,476.92,13,3700,285,2500,alt
2024-06-10,18,5900,327.78,12,3200,267,2700,alt
2024-06-07,7,7500,1071.43,11,3200,291,4300,alt
2024-06-06,8,6900,862.5,4,500,125,6400,alt
2024-06-05,11,7900,718.18,13,2700,208,5200,alt
2024-06-04,17,15300,900.0,9,1500,167,13800,alt
2024-06-03,14,12000,857.14,7,1600,229,10400,alt
2024-05-31,25,31100,1244.0,19,4500,237,26600,alt
2024-05-30,29,21100,727.59,9,1200,133,19900,alt
2024-05-29,43,12700,295.35,36,9800,272,2900,alt
2024-05-28,12,4300,358.33,5,1000,200,3300,alt
2024-05-27,14,4400,314.29,10,2400,240,2000,alt
2024-05-24,17,2500,147.06,10,1800,180,700,alt
2024-05-23,17,3500,205.88,5,900,180,2600,alt
2024-05-22,21,2700,128.57,15,3600,240,-900,alt
2024-05-21,16,2300,143.75,7,5100,729,-2800,alt
2024-05-20,15,10500,700.0,20,18700,935,-8200,alt
2024-05-17,6,400,66.67,15,11200,747,-10800,alt
2024-05-16,4,800,200.0,4,1200,300,-400,alt
2024-05-15,6,1600,266.67,7,11900,1700,-10300,alt
2024-05-14,2,300,150.0,13,13400,1031,-13100,alt
2024-05-13,3,400,133.33,13,4700,362,-4300,alt
2024-05-10,6,600,100.0,12,13000,1083,-12400,alt
2024-05-09,4,300,75.0,11,12700,1155,-12400,alt
2024-05-08,0,0,0.0,11,13100,1191,-13100,alt
2024-05-07,0,0,0.0,11,9900,900,-9900,alt
2024-05-06,0,0,0.0,11,20200,1836,-20200,alt
2024-05-03,0,0,0.0,15,24400,1627,-24400,alt
2024-05-02,5,900,180.0,12,10700,892,-9800,alt
2024-04-26,0,0,0.0,15,22200,1480,-22200,alt
2024-04-25,2,500,250.0,16,21500,1344,-21000,alt
2024-04-24,4,800,200.0,20,16900,845,-16100,alt
2024-04-23,1,200,200.0,10,13000,1300,-12800,alt
2024-04-22,3,500,166.67,15,12800,853,-12300,alt
2024-04-19,0,0,0.0,12,9700,808,-9700,alt
2024-04-17,0,0,0.0,10,8200,820,-8200,alt
2024-04-16,2,200,100.0,12,10100,842,-9900,alt
2024-04-15,4,1100,275.0,10,6600,660,-5500,alt
2024-04-12,12,13600,1133.33,13,8800,677,4800,alt
2024-04-11,6,7600,1266.67,12,8100,675,-500,alt
2024-04-10,5,11500,2300.0,8,7200,900,4300,alt
2024-04-09,5,2500,500.0,11,7700,700,-5200,alt
2024-04-08,6,2100,350.0,12,8900,742,-6800,alt
2024-04-05,12,4300,358.33,9,6500,722,-2200,alt
2024-04-04,10,4900,490.0,9,3600,400,1300,alt
2024-04-03,13,2800,215.38,12,5500,458,-2700,alt
2024-04-02,5,2500,500.0,6,3600,600,-1100,alt
2024-04-01,6,4700,783.33,11,3800,345,900,alt
2024-03-29,12,10800,900.0,17,5600,329,5200,alt
2024-03-28,3,300,100.0,9,5800,644,-5500,alt
2024-03-27,7,7200,1028.57,11,5800,527,1400,alt
2024-03-26,8,3400,425.0,7,3000,429,400,alt
2024-03-25,3,1000,333.33,8,7600,950,-6600,alt
2024-03-22,6,7600,1266.67,6,3600,600,4000,alt
2024-03-21,5,2600,520.0,10,5200,520,-2600,alt
2024-03-20,6,1000,166.67,13,6700,515,-5700,alt
2024-03-19,8,8600,1075.0,11,9000,818,-400,alt
2024-03-18,8,3200,400.0,13,8200,631,-5000,alt
2024-03-15,12,3900,325.0,11,8400,764,-4500,alt
2024-03-14,5,9600,1920.0,16,9300,581,300,alt
2024-03-13,12,9500,791.67,12,4100,342,5400,alt
2024-03-12,14,6400,457.14,9,3400,378,3000,alt
2024-03-11,11,5800,527.27,7,3300,471,2500,alt
2024-03-08,14,11000,785.71,6,2900,483,8100,alt
2024-03-07,13,4600,353.85,6,1300,217,3300,alt
2024-03-06,10,10200,1020.0,6,4300,717,5900,alt
2024-03-05,10,9200,920.0,6,5000,833,4200,alt
2024-03-04,10,8000,800.0,5,3400,680,4600,alt
2024-03-01,16,10800,675.0,10,5400,540,5400,alt
2024-02-29,14,13700,978.57,7,6200,886,7500,alt
2024-02-28,13,10000,769.23,9,7100,789,2900,alt
2024-02-27,16,10300,643.75,10,4500,450,5800,alt
2024-02-26,20,12200,610.0,10,3600,360,8600,alt
2024-02-23,9,4200,466.67,8,5200,650,-1000,alt
2024-02-22,12,8700,725.0,11,9200,836,-500,alt
2024-02-21,9,7000,777.78,8,2400,300,4600,alt
2024-02-20,10,8400,840.0,11,4000,364,4400,alt
2024-02-19,15,19900,1326.67,14,16800,1200,3100,alt
2024-02-16,12,7200,600.0,14,4900,350,2300,alt
2024-02-15,7,9000,1285.71,5,1800,360,7200,alt
2024-02-07,14,13500,964.29,8,12300,1538,1200,alt
2024-02-06,9,11800,1311.11,7,9500,1357,2300,alt
2024-02-05,7,1700,242.86,5,2400,480,-700,alt
2024-02-02,8,33500,4187.5,8,5800,725,27700,alt
2024-02-01,7,11100,1585.71,8,3900,488,7200,alt
2024-01-31,8,18800,2350.0,14,5200,371,13600,alt
2024-01-30,14,18100,1292.86,14,14900,1064,3200,alt
2024-01-29,12,6500,541.67,5,2300,460,4200,alt
2024-01-26,15,6700,446.67,11,5700,518,1000,alt
2024-01-25,8,9900,1237.5,9,5700,633,4200,alt
2024-01-24,9,2400,266.67,9,6400,711,-4000,alt
2024-01-23,16,13600,850.0,15,16400,1093,-2800,alt
2024-01-22,5,1400,280.0,10,5900,590,-4500,alt
2024-01-19,5,3000,600.0,9,5000,556,-2000,alt
2024-01-18,7,2200,314.29,8,4700,588,-2500,alt
2024-01-17,11,8500,772.73,8,7000,875,1500,alt
2024-01-16,7,4500,642.86,6,5400,900,-900,alt
2024-01-15,8,8600,1075.0,6,4200,700,4400,alt
2024-01-12,10,4000,400.0,4,2700,675,1300,alt
2024-01-11,11,13600,1236.36,8,12500,1562,1100,alt
2024-01-10,9,2300,255.56,5,2900,580,-600,alt
2024-01-09,9,3000,333.33,6,3000,500,0,alt
2024-01-08,6,2700,450.0,8,3800,475,-1100,alt
2024-01-05,9,5100,566.67,7,4400,629,700,alt
2024-01-04,10,1800,180.0,5,2100,420,-300,alt
2024-01-03,7,1400,200.0,5,3100,620,-1700,alt
2024-01-02,6,1700,283.33,4,2500,625,-800,alt
2024-09-12,35,38000,1085.71,34,49800,1465,-11800,alv
2024-09-11,39,56800,1456.41,45,60400,1342,-3600,alv
2024-09-10,48,59000,1229.17,48,64100,1335,-5100,alv
2024-09-09,19,21800,1147.37,23,41900,1822,-20100,alv
2024-09-06,23,64100,2786.96,27,16000,593,48100,alv
2024-09-05,32,41200,1287.5,18,19600,1089,21600,alv
2024-09-04,39,54200,1389.74,21,41400,1971,12800,alv
2024-08-30,51,55800,1094.12,24,48800,2033,7000,alv
2024-08-29,30,29300,976.67,22,39100,1777,-9800,alv
2024-08-28,37,36200,978.38,30,27400,913,8800,alv
2024-08-27,26,25200,969.23,33,24100,730,1100,alv
2024-08-26,54,60600,1122.22,26,29900,1150,30700,alv
2024-08-23,67,91500,1365.67,29,74200,2559,17300,alv
2024-08-22,25,29500,1180.0,23,31800,1383,-2300,alv
2024-08-21,41,52600,1282.93,20,35500,1775,17100,alv
2024-08-20,38,34000,894.74,23,35900,1561,-1900,alv
2024-08-19,44,51000,1159.09,28,41000,1464,10000,alv
2024-08-16,73,91800,1257.53,42,35300,840,56500,alv
2024-08-15,36,25000,694.44,24,21100,879,3900,alv
2024-08-14,26,23000,884.62,24,25800,1075,-2800,alv
2024-08-13,33,22700,687.88,32,24700,772,-2000,alv
2024-08-12,82,103800,1265.85,61,89700,1470,14100,alv
2024-08-09,66,59700,904.55,64,75500,1180,-15800,alv
2024-08-08,51,86000,1686.27,41,81900,1998,4100,alv
2024-08-07,27,46500,1722.22,29,40200,1386,6300,alv
2024-08-06,24,119800,4991.67,27,118700,4396,1100,alv
2024-08-05,22,67400,3063.64,23,76700,3335,-9300,alv
2024-08-02,74,105100,1420.27,40,121100,3028,-16000,alv
2024-08-01,5,1500,300.0,27,13600,504,-12100,alv
2024-07-31,22,11400,518.18,27,16200,600,-4800,alv
2024-07-30,20,11400,570.0,25,25200,1008,-13800,alv
2024-07-29,32,15000,468.75,30,24700,823,-9700,alv
2024-07-26,35,12500,357.14,22,39100,1777,-26600,alv
2024-07-25,19,8800,463.16,19,23000,1211,-14200,alv
2024-07-24,26,16600,638.46,27,36900,1367,-20300,alv
2024-07-23,37,28000,756.76,23,27100,1178,900,alv
2024-07-22,36,37900,1052.78,40,61500,1538,-23600,alv
2024-07-19,23,13700,595.65,32,19100,597,-5400,alv
2024-07-18,29,5800,200.0,18,9800,544,-4000,alv
2024-07-17,25,13900,556.0,23,27600,1200,-13700,alv
2024-07-16,51,46600,913.73,43,40100,933,6500,alv
2024-07-15,46,32900,715.22,48,49300,1027,-16400,alv
2024-07-12,54,34700,642.59,31,46900,1513,-12200,alv
2024-07-11,46,22200,482.61,35,35000,1000,-12800,alv
2024-07-10,53,19600,369.81,34,58400,1718,-38800,alv
2024-07-09,45,20400,453.33,50,47600,952,-27200,alv
2024-07-08,37,28500,770.27,32,42600,1331,-14100,alv
2024-07-05,34,17500,514.71,44,50500,1148,-33000,alv
2024-07-04,47,31000,659.57,49,34700,708,-3700,alv
2024-07-03,20,20100,1005.0,36,39100,1086,-19000,alv
2024-07-02,48,27900,581.25,60,39200,653,-11300,alv
2024-07-01,61,34600,567.21,34,35000,1029,-400,alv
2024-06-28,57,43900,770.18,67,69400,1036,-25500,alv
2024-06-27,51,50600,992.16,69,79100,1146,-28500,alv
2024-06-26,38,36000,947.37,39,58000,1487,-22000,alv
2024-06-25,62,55500,895.16,45,80100,1780,-24600,alv
2024-06-24,57,41300,724.56,67,96900,1446,-55600,alv
2024-06-21,78,69300,888.46,56,55200,986,14100,alv
2024-06-20,107,121000,1130.84,80,85500,1069,35500,alv
2024-06-19,57,29600,519.3,54,37100,687,-7500,alv
2024-06-18,59,40900,693.22,53,39900,753,1000,alv
2024-06-17,87,59400,682.76,64,102800,1606,-43400,alv
2024-06-14,109,101300,929.36,88,84000,955,17300,alv
2024-06-13,110,73500,668.18,61,67700,1110,5800,alv
2024-06-12,94,53700,571.28,68,60500,890,-6800,alv
2024-06-11,95,116100,1222.11,79,142800,1808,-26700,alv
2024-06-10,91,108500,1192.31,127,122500,965,-14000,alv
2024-06-07,163,261000,1601.23,145,229400,1582,31600,alv
2024-06-06,153,105500,689.54,89,148800,1672,-43300,alv
2024-06-05,217,153900,709.22,111,226900,2044,-73000,alv
2024-06-04,116,128300,1106.03,110,374600,3405,-246300,alv
2024-06-03,86,84000,976.74,95,128800,1356,-44800,alv
2024-05-31,77,42300,549.35,71,85900,1210,-43600,alv
2024-05-30,226,255000,1128.32,149,241400,1620,13600,alv
2024-05-29,231,492000,2129.87,217,434100,2000,57900,alv
2024-05-28,144,182900,1270.14,97,126100,1300,56800,alv
2024-05-27,163,176600,1083.44,116,372000,3207,-195400,alv
2024-05-24,276,252000,913.04,174,530300,3048,-278300,alv
2024-05-23,174,246900,1418.97,145,212700,1467,34200,alv
2024-05-22,258,405800,1572.87,204,448600,2199,-42800,alv
2024-05-21,185,199900,1080.54,161,187100,1162,12800,alv
2024-05-20,140,368800,2634.29,73,153700,2105,215100,alv
2024-05-17,193,365300,1892.75,121,261900,2164,103400,alv
2024-05-16,303,394400,1301.65,236,428500,1816,-34100,alv
2024-05-15,103,531800,5163.11,32,73000,2281,458800,alv
2024-05-14,206,870000,4223.3,88,397300,4515,472700,alv
2024-05-13,197,1758200,8924.87,107,578700,5408,1179500,alv
2024-05-10,77,1241900,16128.57,30,117800,3927,1124100,alv
2024-05-09,85,344600,4054.12,42,180800,4305,163800,alv
2024-05-08,51,82400,1615.69,47,105300,2240,-22900,alv
2024-05-07,22,12600,572.73,26,40400,1554,-27800,alv
2024-05-06,78,169600,2174.36,56,78500,1402,91100,alv
2024-05-03,65,113500,1746.15,51,87300,1712,26200,alv
2024-05-02,16,34600,2162.5,35,44500,1271,-9900,alv
2024-04-26,24,37900,1579.17,29,30700,1059,7200,alv
2024-04-25,21,46100,2195.24,31,26700,861,19400,alv
2024-04-24,30,39000,1300.0,27,33800,1252,5200,alv
2024-04-23,30,46200,1540.0,29,34700,1197,11500,alv
2024-04-22,33,95700,2900.0,25,58200,2328,37500,alv
2024-04-19,29,57200,1972.41,36,79700,2214,-22500,alv
2024-04-17,40,73400,1835.0,30,67700,2257,5700,alv
2024-04-16,63,51500,817.46,51,52800,1035,-1300,alv
2024-04-15,73,80400,1101.37,55,86500,1573,-6100,alv
2024-04-12,78,181400,2325.64,51,70200,1376,111200,alv
2024-04-11,60,73700,1228.33,70,118800,1697,-45100,alv
2024-04-10,69,81700,1184.06,61,156500,2566,-74800,alv
2024-04-09,58,338700,5839.66,105,223200,2126,115500,alv
2024-04-08,73,118800,1627.4,60,123400,2057,-4600,alv
2024-04-05,84,298800,3557.14,78,128800,1651,170000,alv
2024-04-04,153,291300,1903.92,144,329700,2290,-38400,alv
2024-04-03,80,568500,7106.25,35,127800,3651,440700,alv
2024-04-02,172,427600,2486.05,33,203600,6170,224000,alv
2024-04-01,139,502500,3615.11,27,169100,6263,333400,alv
2024-03-29,30,50200,1673.33,33,83300,2524,-33100,alv
2024-03-28,24,36000,1500.0,23,32900,1430,3100,alv
2024-03-27,23,84800,3686.96,27,47000,1741,37800,alv
2024-03-26,33,91200,2763.64,24,39800,1658,51400,alv
2024-03-25,39,54800,1405.13,33,48800,1479,6000,alv
2024-03-22,64,219600,3431.25,29,42400,1462,177200,alv
2024-03-21,51,120200,2356.86,28,46800,1671,73400,alv
2024-03-20,37,50100,1354.05,46,75400,1639,-25300,alv
2024-03-19,45,96300,2140.0,48,116000,2417,-19700,alv
2024-03-18,74,135300,1828.38,36,65800,1828,69500,alv
2024-03-15,35,130600,3731.43,28,80600,2879,50000,alv
2024-03-14,21,67000,3190.48,28,44500,1589,22500,alv
2024-03-13,44,86000,1954.55,21,43800,2086,42200,alv
2024-03-12,24,51400,2141.67,20,52600,2630,-1200,alv
2024-03-11,32,50600,1581.25,25,52800,2112,-2200,alv
2024-03-08,26,47300,1819.23,17,61400,3612,-14100,alv
2024-03-07,21,50800,2419.05,20,48400,2420,2400,alv
2024-03-06,22,36800,1672.73,22,37400,1700,-600,alv
2024-03-05,22,41300,1877.27,20,43300,2165,-2000,alv
2024-03-04,15,35300,2353.33,22,46000,2091,-10700,alv
2024-03-01,14,29200,2085.71,21,22700,1081,6500,alv
2024-02-29,19,53400,2810.53,23,32700,1422,20700,alv
2024-02-28,29,49100,1693.1,23,31300,1361,17800,alv
2024-02-27,31,69600,2245.16,51,60300,1182,9300,alv
2024-02-26,18,63700,3538.89,24,45100,1879,18600,alv
2024-02-23,28,44400,1585.71,37,40300,1089,4100,alv
2024-02-22,30,125200,4173.33,20,32600,1630,92600,alv
2024-02-21,29,50300,1734.48,22,61100,2777,-10800,alv
2024-02-20,19,46800,2463.16,24,38100,1588,8700,alv
2024-02-19,32,57200,1787.5,20,41100,2055,16100,alv
2024-02-16,27,62100,2300.0,26,76300,2935,-14200,alv
2024-02-15,25,44300,1772.0,23,38000,1652,6300,alv
2024-02-07,22,44200,2009.09,24,45300,1888,-1100,alv
2024-02-06,21,37300,1776.19,27,51000,1889,-13700,alv
2024-02-05,27,89700,3322.22,30,97700,3257,-8000,alv
2024-02-02,18,31300,1738.89,19,31000,1632,300,alv
2024-02-01,33,59100,1790.91,29,73500,2534,-14400,alv
2024-01-31,21,50200,2390.48,15,36200,2413,14000,alv
2024-01-30,29,49400,1703.45,28,100800,3600,-51400,alv
2024-01-29,15,31800,2120.0,19,42500,2237,-10700,alv
2024-01-26,17,29800,1752.94,20,42900,2145,-13100,alv
2024-01-25,17,35900,2111.76,23,50200,2183,-14300,alv
2024-01-24,18,35800,1988.89,17,30200,1776,5600,alv
2024-01-23,23,33400,1452.17,16,35100,2194,-1700,alv
2024-01-22,17,21400,1258.82,24,58900,2454,-37500,alv
2024-01-19,24,40600,1691.67,27,51000,1889,-10400,alv
2024-01-18,27,59200,2192.59,21,42800,2038,16400,alv
2024-01-17,16,85500,5343.75,21,96000,4571,-10500,alv
2024-01-16,20,50700,2535.0,18,56400,3133,-5700,alv
2024-01-15,31,49400,1593.55,19,47600,2505,1800,alv
2024-01-12,22,36800,1672.73,21,38600,1838,-1800,alv
2024-01-11,19,29900,1573.68,18,25300,1406,4600,alv
2024-01-10,19,32900,1731.58,18,24300,1350,8600,alv
2024-01-09,28,30400,1085.71,21,21000,1000,9400,alv
2024-01-08,25,30000,1200.0,20,32100,1605,-2100,alv
2024-01-05,18,33200,1844.44,18,31000,1722,2200,alv
2024-01-04,20,27800,1390.0,16,30900,1931,-3100,alv
2024-01-03,20,26800,1340.0,20,47900,2395,-21100,alv
2024-01-02,27,27800,1029.63,15,26900,1793,900,alv
2024-09-12,10,2900,290.0,7,2600,371,300,amc
2024-09-11,7,3100,442.86,6,6100,1017,-3000,amc
2024-09-10,9,3700,411.11,6,6100,1017,-2400,amc
2024-09-09,8,2900,362.5,10,7400,740,-4500,amc
2024-09-06,7,2000,285.71,9,6700,744,-4700,amc
2024-09-05,4,1700,425.0,10,4800,480,-3100,amc
2024-09-04,15,5200,346.67,8,4600,575,600,amc
2024-08-30,9,2900,322.22,8,4400,550,-1500,amc
2024-08-29,14,4100,292.86,13,6300,485,-2200,amc
2024-08-28,13,4500,346.15,6,3100,517,1400,amc
2024-08-27,8,3300,412.5,9,4700,522,-1400,amc
2024-08-26,17,8100,476.47,7,1700,243,6400,amc
2024-08-23,16,7700,481.25,8,3700,462,4000,amc
2024-08-22,8,3000,375.0,6,2900,483,100,amc
2024-08-21,11,2700,245.45,7,3900,557,-1200,amc
2024-08-20,9,2700,300.0,5,2400,480,300,amc
2024-08-19,11,3300,300.0,5,3500,700,-200,amc
2024-08-16,11,4800,436.36,6,3200,533,1600,amc
2024-08-15,8,3300,412.5,11,5200,473,-1900,amc
2024-08-14,10,6300,630.0,8,4800,600,1500,amc
2024-08-13,8,2500,312.5,8,5200,650,-2700,amc
2024-08-12,7,2000,285.71,8,4000,500,-2000,amc
2024-08-09,5,900,180.0,7,4200,600,-3300,amc
2024-08-08,11,3300,300.0,5,3200,640,100,amc
2024-08-07,10,4600,460.0,3,2600,867,2000,amc
2024-08-06,12,3700,308.33,4,5000,1250,-1300,amc
2024-08-05,9,3500,388.89,8,3400,425,100,amc
2024-08-02,8,3000,375.0,3,500,167,2500,amc
2024-08-01,9,4200,466.67,4,2700,675,1500,amc
2024-07-31,8,4100,512.5,4,900,225,3200,amc
2024-07-30,9,3900,433.33,4,1500,375,2400,amc
2024-07-29,8,4100,512.5,4,3600,900,500,amc
2024-07-26,8,3400,425.0,5,800,160,2600,amc
2024-07-25,8,2900,362.5,5,4900,980,-2000,amc
2024-07-24,10,3600,360.0,6,5000,833,-1400,amc
2024-07-23,8,4000,500.0,6,1000,167,3000,amc
2024-07-22,8,5100,637.5,3,1400,467,3700,amc
2024-07-19,9,5000,555.56,5,2600,520,2400,amc
2024-07-18,11,10100,918.18,5,1100,220,9000,amc
2024-07-17,9,5300,588.89,6,1900,317,3400,amc
2024-07-16,12,5200,433.33,10,1600,160,3600,amc
2024-07-15,10,4800,480.0,8,2900,362,1900,amc
2024-07-12,11,5500,500.0,5,2700,540,2800,amc
2024-07-11,12,4700,391.67,9,3400,378,1300,amc
2024-07-10,13,6800,523.08,11,4600,418,2200,amc
2024-07-09,13,5700,438.46,6,2500,417,3200,amc
2024-07-08,12,3600,300.0,13,5600,431,-2000,amc
2024-07-05,6,2200,366.67,11,7100,645,-4900,amc
2024-07-04,7,3400,485.71,9,6500,722,-3100,amc
2024-07-03,6,2900,483.33,12,5500,458,-2600,amc
2024-07-02,9,3100,344.44,10,5000,500,-1900,amc
2024-07-01,7,3300,471.43,12,3500,292,-200,amc
2024-06-28,7,4200,600.0,7,2700,386,1500,amc
2024-06-27,9,3400,377.78,10,4800,480,-1400,amc
2024-06-26,12,5800,483.33,13,6800,523,-1000,amc
2024-06-25,12,6900,575.0,11,3200,291,3700,amc
2024-06-24,13,4600,353.85,16,7000,438,-2400,amc
2024-06-21,11,2300,209.09,5,1100,220,1200,amc
2024-06-20,22,2500,113.64,11,2100,191,400,amc
2024-06-19,26,7400,284.62,30,17800,593,-10400,amc
2024-06-18,20,3200,160.0,25,11700,468,-8500,amc
2024-06-17,20,7100,355.0,8,6200,775,900,amc
2024-06-14,21,3300,157.14,8,5600,700,-2300,amc
2024-06-13,35,6000,171.43,19,11800,621,-5800,amc
2024-06-12,23,8000,347.83,12,6200,517,1800,amc
2024-06-11,15,6200,413.33,10,4800,480,1400,amc
2024-06-10,23,3200,139.13,10,9600,960,-6400,amc
2024-06-07,35,16700,477.14,5,6500,1300,10200,amc
2024-06-06,9,5900,655.56,4,600,150,5300,amc
2024-06-05,6,4900,816.67,5,1200,240,3700,amc
2024-06-04,5,5500,1100.0,4,600,150,4900,amc
2024-06-03,9,5800,644.44,6,2000,333,3800,amc
2024-05-31,9,2800,311.11,4,800,200,2000,amc
2024-05-30,18,700,38.89,5,1100,220,-400,amc
2024-05-29,10,5000,500.0,9,3000,333,2000,amc
2024-05-28,4,3400,850.0,11,2900,264,500,amc
2024-05-27,5,5100,1020.0,6,1300,217,3800,amc
2024-05-24,6,5200,866.67,9,2500,278,2700,amc
2024-05-23,9,6800,755.56,2,500,250,6300,amc
2024-05-22,31,8500,274.19,7,2000,286,6500,amc
2024-05-21,3,4500,1500.0,8,3400,425,1100,amc
2024-05-20,3,3400,1133.33,7,3100,443,300,amc
2024-05-17,5,4800,960.0,6,2900,483,1900,amc
2024-05-16,3,3100,1033.33,7,2500,357,600,amc
2024-05-15,4,3600,900.0,8,2400,300,1200,amc
2024-05-14,2,3000,1500.0,8,2300,288,700,amc
2024-05-13,4,8000,2000.0,5,1500,300,6500,amc
2024-05-10,6,3800,633.33,5,1900,380,1900,amc
2024-05-09,8,4200,525.0,6,2400,400,1800,amc
2024-05-08,10,3000,300.0,11,4600,418,-1600,amc
2024-05-07,5,1300,260.0,14,4000,286,-2700,amc
2024-05-06,9,5200,577.78,6,3300,550,1900,amc
2024-05-03,8,7100,887.5,8,1900,238,5200,amc
2024-05-02,3,2000,666.67,8,1800,225,200,amc
2024-04-26,1,100,100.0,6,1600,267,-1500,amc
2024-04-25,1,1000,1000.0,12,2200,183,-1200,amc
2024-04-24,6,5000,833.33,5,900,180,4100,amc
2024-04-23,5,4300,860.0,5,1500,300,2800,amc
2024-04-22,6,4600,766.67,6,2000,333,2600,amc
2024-04-19,4,7200,1800.0,7,1900,271,5300,amc
2024-04-17,10,7600,760.0,11,1400,127,6200,amc
2024-04-16,3,2300,766.67,9,1900,211,400,amc
2024-04-15,5,8400,1680.0,6,2500,417,5900,amc
2024-04-12,7,2800,400.0,5,1900,380,900,amc
2024-04-11,4,2400,600.0,7,3000,429,-600,amc
2024-04-10,4,7300,1825.0,6,2100,350,5200,amc
2024-04-09,5,6700,1340.0,5,1900,380,4800,amc
2024-04-08,3,1300,433.33,5,2300,460,-1000,amc
2024-04-05,5,6400,1280.0,7,3600,514,2800,amc
2024-04-04,4,4100,1025.0,9,2600,289,1500,amc
2024-04-03,3,2300,766.67,7,2000,286,300,amc
2024-04-02,16,5300,331.25,8,1600,200,3700,amc
2024-04-01,12,5600,466.67,7,2200,314,3400,amc
2024-03-29,8,3600,450.0,3,1800,600,1800,amc
2024-03-28,7,6100,871.43,5,2700,540,3400,amc
2024-03-27,5,3700,740.0,8,5300,662,-1600,amc
2024-03-26,8,4500,562.5,8,4900,612,-400,amc
2024-03-25,5,3600,720.0,5,4300,860,-700,amc
2024-03-22,11,5000,454.55,6,2900,483,2100,amc
2024-03-21,8,6000,750.0,2,3100,1550,2900,amc
2024-03-20,12,5700,475.0,7,4100,586,1600,amc
2024-03-19,13,10000,769.23,3,1700,567,8300,amc
2024-03-18,8,7100,887.5,6,3900,650,3200,amc
2024-03-15,4,1700,425.0,7,3100,443,-1400,amc
2024-03-14,5,2700,540.0,7,3100,443,-400,amc
2024-03-13,10,6000,600.0,3,800,267,5200,amc
2024-03-12,4,2100,525.0,3,800,267,1300,amc
2024-03-11,7,5600,800.0,3,1300,433,4300,amc
2024-03-08,6,7600,1266.67,3,1300,433,6300,amc
2024-03-07,5,5600,1120.0,3,800,267,4800,amc
2024-03-06,4,3600,900.0,6,2800,467,800,amc
2024-03-05,4,4100,1025.0,4,1300,325,2800,amc
2024-03-04,6,1300,216.67,4,2300,575,-1000,amc
2024-03-01,6,1800,300.0,2,600,300,1200,amc
2024-02-29,8,6500,812.5,8,2200,275,4300,amc
2024-02-28,6,4200,700.0,4,1500,375,2700,amc
2024-02-27,9,6900,766.67,2,300,150,6600,amc
2024-02-26,9,7500,833.33,4,1500,375,6000,amc
2024-02-23,9,8700,966.67,4,1500,375,7200,amc
2024-02-22,11,8300,754.55,4,1300,325,7000,amc
2024-02-21,18,14700,816.67,13,11800,908,2900,amc
2024-02-20,9,5800,644.44,9,1600,178,4200,amc
2024-02-19,7,4500,642.86,1,100,100,4400,amc
2024-02-16,37,30100,813.51,3,20100,6700,10000,amc
2024-02-15,5,2600,520.0,2,1100,550,1500,amc
2024-02-07,5,2000,400.0,2,300,150,1700,amc
2024-02-06,4,1700,425.0,1,100,100,1600,amc
2024-02-05,4,1700,425.0,1,100,100,1600,amc
2024-02-02,5,1700,340.0,1,100,100,1600,amc
2024-02-01,7,3300,471.43,1,100,100,3200,amc
2024-01-31,6,2200,366.67,1,100,100,2100,amc
2024-01-30,5,2200,440.0,2,200,100,2000,amc
2024-01-29,5,2200,440.0,1,100,100,2100,amc
2024-01-26,6,2200,366.67,1,100,100,2100,amc
2024-01-25,4,2100,525.0,2,800,400,1300,amc
2024-01-24,5,2300,460.0,1,100,100,2200,amc
2024-01-23,5,2200,440.0,1,100,100,2100,amc
2024-01-22,5,3100,620.0,1,100,100,3000,amc
2024-01-19,5,2200,440.0,1,100,100,2100,amc
2024-01-18,5,2300,460.0,1,100,100,2200,amc
2024-01-17,5,2200,440.0,1,100,100,2100,amc
2024-01-16,5,1800,360.0,1,100,100,1700,amc
2024-01-15,4,2100,525.0,1,100,100,2000,amc
2024-01-12,5,1300,260.0,7,1600,229,-300,amc
2024-01-11,9,5700,633.33,2,200,100,5500,amc
2024-01-10,7,2800,400.0,0,0,0,2800,amc
2024-01-09,7,2800,400.0,0,0,0,2800,amc
2024-01-08,7,2600,371.43,0,0,0,2600,amc
2024-01-05,6,2700,450.0,0,0,0,2700,amc
2024-01-04,6,3500,583.33,0,0,0,3500,amc
2024-01-03,6,2700,450.0,0,0,0,2700,amc
2024-01-02,6,2300,383.33,0,0,0,2300,amc
2024-09-12,0,0,0.0,0,0,0,0,amd
2024-09-11,0,0,0.0,0,0,0,0,amd
2024-09-10,0,0,0.0,0,0,0,0,amd
2024-09-09,0,0,0.0,0,0,0,0,amd
2024-09-06,0,0,0.0,0,0,0,0,amd
2024-09-05,0,0,0.0,0,0,0,0,amd
2024-09-04,0,0,0.0,0,0,0,0,amd
2024-08-30,0,0,0.0,0,0,0,0,amd
2024-08-29,0,0,0.0,0,0,0,0,amd
2024-08-28,0,0,0.0,0,0,0,0,amd
2024-08-27,0,0,0.0,0,0,0,0,amd
2024-08-26,0,0,0.0,0,0,0,0,amd
2024-08-23,0,0,0.0,0,0,0,0,amd
2024-08-22,0,0,0.0,0,0,0,0,amd
2024-08-21,0,0,0.0,0,0,0,0,amd
2024-08-20,0,0,0.0,0,0,0,0,amd
2024-08-19,0,0,0.0,0,0,0,0,amd
2024-08-16,0,0,0.0,0,0,0,0,amd
2024-08-15,0,0,0.0,0,0,0,0,amd
2024-08-14,0,0,0.0,0,0,0,0,amd
2024-08-13,0,0,0.0,0,0,0,0,amd
2024-08-12,0,0,0.0,0,0,0,0,amd
2024-08-09,0,0,0.0,0,0,0,0,amd
2024-08-08,0,0,0.0,0,0,0,0,amd
2024-08-07,0,0,0.0,0,0,0,0,amd
2024-08-06,0,0,0.0,0,0,0,0,amd
2024-08-05,0,0,0.0,0,0,0,0,amd
2024-08-02,0,0,0.0,0,0,0,0,amd
2024-08-01,0,0,0.0,0,0,0,0,amd
2024-07-31,0,0,0.0,0,0,0,0,amd
2024-07-30,0,0,0.0,0,0,0,0,amd
2024-07-29,0,0,0.0,0,0,0,0,amd
2024-07-26,0,0,0.0,0,0,0,0,amd
2024-07-25,0,0,0.0,0,0,0,0,amd
2024-07-24,0,0,0.0,0,0,0,0,amd
2024-07-23,0,0,0.0,0,0,0,0,amd
2024-07-22,0,0,0.0,0,0,0,0,amd
2024-07-19,0,0,0.0,0,0,0,0,amd
2024-07-18,0,0,0.0,0,0,0,0,amd
2024-07-17,0,0,0.0,0,0,0,0,amd
2024-07-16,0,0,0.0,0,0,0,0,amd
2024-07-15,0,0,0.0,0,0,0,0,amd
2024-07-12,0,0,0.0,0,0,0,0,amd
2024-07-11,0,0,0.0,0,0,0,0,amd
2024-07-10,0,0,0.0,0,0,0,0,amd
2024-07-09,0,0,0.0,0,0,0,0,amd
2024-07-08,0,0,0.0,0,0,0,0,amd
2024-07-05,0,0,0.0,0,0,0,0,amd
2024-07-04,0,0,0.0,0,0,0,0,amd
2024-07-03,0,0,0.0,0,0,0,0,amd
2024-07-02,0,0,0.0,0,0,0,0,amd
2024-07-01,0,0,0.0,0,0,0,0,amd
2024-06-28,0,0,0.0,0,0,0,0,amd
2024-06-27,0,0,0.0,0,0,0,0,amd
2024-06-26,0,0,0.0,0,0,0,0,amd
2024-06-25,0,0,0.0,0,0,0,0,amd
2024-06-24,0,0,0.0,0,0,0,0,amd
2024-06-21,0,0,0.0,0,0,0,0,amd
2024-06-20,0,0,0.0,0,0,0,0,amd
2024-06-19,0,0,0.0,0,0,0,0,amd
2024-06-18,0,0,0.0,0,0,0,0,amd
2024-06-17,0,0,0.0,0,0,0,0,amd
2024-06-14,0,0,0.0,0,0,0,0,amd
2024-06-13,0,0,0.0,0,0,0,0,amd
2024-06-12,0,0,0.0,0,0,0,0,amd
2024-06-11,0,0,0.0,0,0,0,0,amd
2024-06-10,0,0,0.0,0,0,0,0,amd
2024-06-07,0,0,0.0,0,0,0,0,amd
2024-06-06,0,0,0.0,0,0,0,0,amd
2024-06-05,0,0,0.0,0,0,0,0,amd
2024-06-04,0,0,0.0,0,0,0,0,amd
2024-06-03,0,0,0.0,0,0,0,0,amd
2024-05-31,0,0,0.0,0,0,0,0,amd
2024-05-30,0,0,0.0,0,0,0,0,amd
2024-05-29,0,0,0.0,0,0,0,0,amd
2024-05-28,0,0,0.0,0,0,0,0,amd
2024-05-27,0,0,0.0,0,0,0,0,amd
2024-05-24,0,0,0.0,0,0,0,0,amd
2024-05-23,0,0,0.0,0,0,0,0,amd
2024-05-22,0,0,0.0,0,0,0,0,amd
2024-05-21,0,0,0.0,0,0,0,0,amd
2024-05-20,0,0,0.0,0,0,0,0,amd
2024-05-17,0,0,0.0,0,0,0,0,amd
2024-05-16,0,0,0.0,0,0,0,0,amd
2024-05-15,0,0,0.0,0,0,0,0,amd
2024-05-14,0,0,0.0,0,0,0,0,amd
2024-05-13,0,0,0.0,0,0,0,0,amd
2024-05-10,0,0,0.0,0,0,0,0,amd
2024-05-09,0,0,0.0,0,0,0,0,amd
2024-05-08,0,0,0.0,0,0,0,0,amd
2024-05-07,0,0,0.0,0,0,0,0,amd
2024-05-06,0,0,0.0,0,0,0,0,amd
2024-05-03,0,0,0.0,0,0,0,0,amd
2024-05-02,0,0,0.0,0,0,0,0,amd
2024-04-26,0,0,0.0,0,0,0,0,amd
2024-04-25,0,0,0.0,0,0,0,0,amd
2024-04-24,0,0,0.0,0,0,0,0,amd
2024-04-23,0,0,0.0,0,0,0,0,amd
2024-04-22,0,0,0.0,0,0,0,0,amd
2024-04-19,0,0,0.0,0,0,0,0,amd
2024-04-17,0,0,0.0,0,0,0,0,amd
2024-04-16,0,0,0.0,0,0,0,0,amd
2024-04-15,0,0,0.0,0,0,0,0,amd
2024-04-12,0,0,0.0,0,0,0,0,amd
2024-04-11,0,0,0.0,0,0,0,0,amd
2024-04-10,0,0,0.0,0,0,0,0,amd
2024-04-09,0,0,0.0,0,0,0,0,amd
2024-04-08,0,0,0.0,0,0,0,0,amd
2024-04-05,0,0,0.0,0,0,0,0,amd
2024-04-04,0,0,0.0,0,0,0,0,amd
2024-04-03,0,0,0.0,0,0,0,0,amd
2024-04-02,0,0,0.0,0,0,0,0,amd
2024-04-01,0,0,0.0,0,0,0,0,amd
2024-03-29,0,0,0.0,0,0,0,0,amd
2024-03-28,0,0,0.0,0,0,0,0,amd
2024-03-27,0,0,0.0,0,0,0,0,amd
2024-03-26,0,0,0.0,0,0,0,0,amd
2024-03-25,0,0,0.0,0,0,0,0,amd
2024-03-22,0,0,0.0,0,0,0,0,amd
2024-03-21,0,0,0.0,0,0,0,0,amd
2024-03-20,0,0,0.0,0,0,0,0,amd
2024-03-19,0,0,0.0,0,0,0,0,amd
2024-03-18,0,0,0.0,0,0,0,0,amd
2024-03-15,0,0,0.0,0,0,0,0,amd
2024-03-14,0,0,0.0,0,0,0,0,amd
2024-03-13,0,0,0.0,0,0,0,0,amd
2024-03-12,0,0,0.0,0,0,0,0,amd
2024-03-11,0,0,0.0,0,0,0,0,amd
2024-03-08,0,0,0.0,0,0,0,0,amd
2024-03-07,0,0,0.0,0,0,0,0,amd
2024-03-06,0,0,0.0,0,0,0,0,amd
2024-03-05,0,0,0.0,0,0,0,0,amd
2024-03-04,0,0,0.0,0,0,0,0,amd
2024-03-01,0,0,0.0,0,0,0,0,amd
2024-02-29,0,0,0.0,0,0,0,0,amd
2024-02-28,0,0,0.0,0,0,0,0,amd
2024-02-27,0,0,0.0,0,0,0,0,amd
2024-02-26,0,0,0.0,0,0,0,0,amd
2024-02-23,0,0,0.0,0,0,0,0,amd
2024-02-22,0,0,0.0,0,0,0,0,amd
2024-02-21,0,0,0.0,0,0,0,0,amd
2024-02-20,0,0,0.0,0,0,0,0,amd
2024-02-19,0,0,0.0,0,0,0,0,amd
2024-02-16,0,0,0.0,0,0,0,0,amd
2024-02-15,0,0,0.0,0,0,0,0,amd
2024-02-07,0,0,0.0,0,0,0,0,amd
2024-02-06,0,0,0.0,0,0,0,0,amd
2024-02-05,0,0,0.0,0,0,0,0,amd
2024-02-02,0,0,0.0,0,0,0,0,amd
2024-02-01,0,0,0.0,0,0,0,0,amd
2024-01-31,0,0,0.0,0,0,0,0,amd
2024-01-30,0,0,0.0,0,0,0,0,amd
2024-01-29,0,0,0.0,0,0,0,0,amd
2024-01-26,0,0,0.0,0,0,0,0,amd
2024-01-25,0,0,0.0,0,0,0,0,amd
2024-01-24,0,0,0.0,0,0,0,0,amd
2024-01-23,0,0,0.0,0,0,0,0,amd
2024-01-22,0,0,0.0,0,0,0,0,amd
2024-01-19,0,0,0.0,0,0,0,0,amd
2024-01-18,0,0,0.0,0,0,0,0,amd
2024-01-17,0,0,0.0,0,0,0,0,amd
2024-01-16,0,0,0.0,0,0,0,0,amd
2024-01-15,0,0,0.0,0,0,0,0,amd
2024-01-12,0,0,0.0,0,0,0,0,amd
2024-01-11,0,0,0.0,0,0,0,0,amd
2024-01-10,0,0,0.0,0,0,0,0,amd
2024-01-09,0,0,0.0,0,0,0,0,amd
2024-01-08,0,0,0.0,0,0,0,0,amd
2024-01-05,0,0,0.0,0,0,0,0,amd
2024-01-04,0,0,0.0,0,0,0,0,amd
2024-01-03,0,0,0.0,0,0,0,0,amd
2024-01-02,0,0,0.0,0,0,0,0,amd
2024-09-12,7,1500,214.29,13,2100,162,-600,ame
2024-09-11,5,1200,240.0,11,2100,191,-900,ame
2024-09-10,8,1500,187.5,16,2600,162,-1100,ame
2024-09-09,7,800,114.29,14,3300,236,-2500,ame
2024-09-06,11,1000,90.91,14,2700,193,-1700,ame
2024-09-05,3,1200,400.0,6,2300,383,-1100,ame
2024-09-04,6,1700,283.33,9,2300,256,-600,ame
2024-08-30,6,300,50.0,12,11900,992,-11600,ame
2024-08-29,10,1900,190.0,10,1700,170,200,ame
2024-08-28,8,1600,200.0,12,2700,225,-1100,ame
2024-08-27,16,7700,481.25,12,7500,625,200,ame
2024-08-26,8,1900,237.5,9,2200,244,-300,ame
2024-08-23,11,2200,200.0,8,2200,275,0,ame
2024-08-22,10,4100,410.0,11,2600,236,1500,ame
2024-08-21,16,8100,506.25,7,6500,929,1600,ame
2024-08-20,16,3600,225.0,16,2900,181,700,ame
2024-08-19,8,1500,187.5,7,1700,243,-200,ame
2024-08-16,24,4100,170.83,9,4800,533,-700,ame
2024-08-15,2,100,50.0,3,1600,533,-1500,ame
2024-08-14,3,200,66.67,3,1400,467,-1200,ame
2024-08-13,3,400,133.33,3,1500,500,-1100,ame
2024-08-12,8,1000,125.0,7,1600,229,-600,ame
2024-08-09,3,200,66.67,4,500,125,-300,ame
2024-08-08,4,100,25.0,1,800,800,-700,ame
2024-08-07,4,200,50.0,2,1200,600,-1000,ame
2024-08-06,8,1000,125.0,5,1300,260,-300,ame
2024-08-05,3,800,266.67,7,1500,214,-700,ame
2024-08-02,4,900,225.0,3,1200,400,-300,ame
2024-08-01,11,2900,263.64,7,3500,500,-600,ame
2024-07-31,8,2000,250.0,5,1500,300,500,ame
2024-07-30,7,2000,285.71,2,400,200,1600,ame
2024-07-29,10,5500,550.0,11,3100,282,2400,ame
2024-07-26,19,3300,173.68,7,1400,200,1900,ame
2024-07-25,14,2300,164.29,6,1000,167,1300,ame
2024-07-24,6,400,66.67,9,3000,333,-2600,ame
2024-07-23,3,200,66.67,4,3700,925,-3500,ame
2024-07-22,7,600,85.71,8,3000,375,-2400,ame
2024-07-19,3,300,100.0,6,1300,217,-1000,ame
2024-07-18,4,500,125.0,6,3300,550,-2800,ame
2024-07-17,5,500,100.0,6,1900,317,-1400,ame
2024-07-16,16,5500,343.75,11,7800,709,-2300,ame
2024-07-15,2,200,100.0,4,1600,400,-1400,ame
2024-07-12,4,6100,1525.0,12,9700,808,-3600,ame
2024-07-11,3,2000,666.67,14,7200,514,-5200,ame
2024-07-10,3,300,100.0,9,3100,344,-2800,ame
2024-07-09,5,800,160.0,8,4400,550,-3600,ame
2024-07-08,6,4500,750.0,8,6700,838,-2200,ame
2024-07-05,2,100,50.0,4,1600,400,-1500,ame
2024-07-04,1,100,100.0,6,3300,550,-3200,ame
2024-07-03,1,100,100.0,6,4400,733,-4300,ame
2024-07-02,1,100,100.0,3,1600,533,-1500,ame
2024-07-01,2,100,50.0,3,2100,700,-2000,ame
2024-06-28,7,1000,142.86,9,5100,567,-4100,ame
2024-06-27,5,800,160.0,11,4100,373,-3300,ame
2024-06-26,7,5400,771.43,12,17000,1417,-11600,ame
2024-06-25,5,4900,980.0,9,5400,600,-500,ame
2024-06-24,12,13600,1133.33,9,5000,556,8600,ame
2024-06-21,10,18600,1860.0,5,4000,800,14600,ame
2024-06-20,17,3600,211.76,12,7200,600,-3600,ame
2024-06-19,12,1600,133.33,10,4600,460,-3000,ame
2024-06-18,12,2500,208.33,10,5700,570,-3200,ame
2024-06-17,6,1100,183.33,8,7800,975,-6700,ame
2024-06-14,8,1200,150.0,14,15200,1086,-14000,ame
2024-06-13,9,3700,411.11,12,25700,2142,-22000,ame
2024-06-12,10,7400,740.0,7,19100,2729,-11700,ame
2024-06-11,13,1300,100.0,8,4400,550,-3100,ame
2024-06-10,19,3400,178.95,18,7800,433,-4400,ame
2024-06-07,1,100,100.0,6,12700,2117,-12600,ame
2024-06-06,0,0,0.0,6,14300,2383,-14300,ame
2024-06-05,0,0,0.0,8,12700,1588,-12700,ame
2024-06-04,1,500,500.0,10,14300,1430,-13800,ame
2024-06-03,4,900,225.0,18,16200,900,-15300,ame
2024-05-31,1,100,100.0,10,13400,1340,-13300,ame
2024-05-30,1,100,100.0,6,14400,2400,-14300,ame
2024-05-29,0,0,0.0,9,11700,1300,-11700,ame
2024-05-28,12,2400,200.0,7,10900,1557,-8500,ame
2024-05-27,15,3500,233.33,3,700,233,2800,ame
2024-05-24,7,2800,400.0,10,7400,740,-4600,ame
2024-05-23,7,3600,514.29,8,13900,1738,-10300,ame
2024-05-22,5,3400,680.0,9,11100,1233,-7700,ame
2024-05-21,2,200,100.0,8,15200,1900,-15000,ame
2024-05-20,3,1000,333.33,11,16600,1509,-15600,ame
2024-05-17,3,300,100.0,8,5900,738,-5600,ame
2024-05-16,4,200,50.0,12,6200,517,-6000,ame
2024-05-15,1,100,100.0,10,5600,560,-5500,ame
2024-05-14,5,1700,340.0,12,15100,1258,-13400,ame
2024-05-13,5,2300,460.0,11,3800,345,-1500,ame
2024-05-10,3,300,100.0,10,6300,630,-6000,ame
2024-05-09,3,200,66.67,17,69300,4076,-69100,ame
2024-05-08,4,1100,275.0,15,15600,1040,-14500,ame
2024-05-07,3,1200,400.0,9,13900,1544,-12700,ame
2024-05-06,1,100,100.0,12,11700,975,-11600,ame
2024-05-03,5,1100,220.0,4,3300,825,-2200,ame
2024-05-02,5,500,100.0,8,3700,462,-3200,ame
2024-04-26,7,1200,171.43,10,2700,270,-1500,ame
2024-04-25,6,700,116.67,16,12100,756,-11400,ame
2024-04-24,6,500,83.33,5,1100,220,-600,ame
2024-04-23,4,400,100.0,3,500,167,-100,ame
2024-04-22,7,800,114.29,5,600,120,200,ame
2024-04-19,2,600,300.0,7,2900,414,-2300,ame
2024-04-17,7,800,114.29,4,11300,2825,-10500,ame
2024-04-16,3,700,233.33,10,11300,1130,-10600,ame
2024-04-15,3,700,233.33,13,2000,154,-1300,ame
2024-04-12,6,700,116.67,15,3000,200,-2300,ame
2024-04-11,5,700,140.0,14,2900,207,-2200,ame
2024-04-10,5,800,160.0,6,700,117,100,ame
2024-04-09,5,11900,2380.0,11,14200,1291,-2300,ame
2024-04-08,15,19200,1280.0,15,19300,1287,-100,ame
2024-04-05,4,300,75.0,9,2200,244,-1900,ame
2024-04-04,5,1300,260.0,9,2000,222,-700,ame
2024-04-03,9,14400,1600.0,11,40100,3645,-25700,ame
2024-04-02,4,300,75.0,9,3400,378,-3100,ame
2024-04-01,4,300,75.0,8,1800,225,-1500,ame
2024-03-29,1,100,100.0,6,1300,217,-1200,ame
2024-03-28,4,800,200.0,6,1300,217,-500,ame
2024-03-27,3,200,66.67,6,3000,500,-2800,ame
2024-03-26,2,200,100.0,8,1800,225,-1600,ame
2024-03-25,5,200,40.0,7,3100,443,-2900,ame
2024-03-22,3,400,133.33,14,4500,321,-4100,ame
2024-03-21,4,100,25.0,9,3800,422,-3700,ame
2024-03-20,8,800,100.0,23,9000,391,-8200,ame
2024-03-19,9,700,77.78,15,10100,673,-9400,ame
2024-03-18,17,2200,129.41,5,2200,440,0,ame
2024-03-15,13,3300,253.85,9,7800,867,-4500,ame
2024-03-14,20,2600,130.0,9,5700,633,-3100,ame
2024-03-13,6,600,100.0,6,4000,667,-3400,ame
2024-03-12,2,400,200.0,5,3000,600,-2600,ame
2024-03-11,3,500,166.67,7,5200,743,-4700,ame
2024-03-08,5,700,140.0,10,4900,490,-4200,ame
2024-03-07,3,500,166.67,7,7400,1057,-6900,ame
2024-03-06,9,6000,666.67,9,8900,989,-2900,ame
2024-03-05,17,10500,617.65,12,10000,833,500,ame
2024-03-04,10,2400,240.0,8,7300,912,-4900,ame
2024-03-01,10,3300,330.0,11,8400,764,-5100,ame
2024-02-29,8,1800,225.0,7,4600,657,-2800,ame
2024-02-28,8,5900,737.5,7,3000,429,2900,ame
2024-02-27,6,1200,200.0,9,6100,678,-4900,ame
2024-02-26,10,3500,350.0,10,8200,820,-4700,ame
2024-02-23,10,2200,220.0,11,7800,709,-5600,ame
2024-02-22,8,1000,125.0,8,5400,675,-4400,ame
2024-02-21,16,3600,225.0,13,7200,554,-3600,ame
2024-02-20,5,900,180.0,12,10600,883,-9700,ame
2024-02-19,10,1100,110.0,10,12100,1210,-11000,ame
2024-02-16,5,400,80.0,10,7300,730,-6900,ame
2024-02-15,6,1500,250.0,11,10700,973,-9200,ame
2024-02-07,6,2200,366.67,7,3600,514,-1400,ame
2024-02-06,1,400,400.0,9,9100,1011,-8700,ame
2024-02-05,3,1500,500.0,11,8600,782,-7100,ame
2024-02-02,4,1600,400.0,10,4800,480,-3200,ame
2024-02-01,4,1800,450.0,13,8700,669,-6900,ame
2024-01-31,5,1700,340.0,9,5900,656,-4200,ame
2024-01-30,9,3900,433.33,9,5400,600,-1500,ame
2024-01-29,7,2000,285.71,13,5600,431,-3600,ame
2024-01-26,4,2100,525.0,14,5700,407,-3600,ame
2024-01-25,4,1900,475.0,13,8400,646,-6500,ame
2024-01-24,4,2000,500.0,15,7700,513,-5700,ame
2024-01-23,5,1900,380.0,11,4600,418,-2700,ame
2024-01-22,6,2300,383.33,14,4800,343,-2500,ame
2024-01-19,14,3600,257.14,16,8800,550,-5200,ame
2024-01-18,5,600,120.0,17,12800,753,-12200,ame
2024-01-17,7,700,100.0,15,13000,867,-12300,ame
2024-01-16,14,1100,78.57,12,8800,733,-7700,ame
2024-01-15,11,5600,509.09,17,9300,547,-3700,ame
2024-01-12,9,5500,611.11,15,9400,627,-3900,ame
2024-01-11,12,2700,225.0,10,5900,590,-3200,ame
2024-01-10,16,4200,262.5,17,9300,547,-5100,ame
2024-01-09,8,1200,150.0,13,7400,569,-6200,ame
2024-01-08,12,2400,200.0,16,8800,550,-6400,ame
2024-01-05,16,3100,193.75,14,5700,407,-2600,ame
2024-01-04,12,3000,250.0,21,10700,510,-7700,ame
2024-01-03,24,3400,141.67,12,8500,708,-5100,ame
2024-01-02,15,2600,173.33,17,9800,576,-7200,ame
2024-09-12,1,100,100.0,1,100,100,0,amp
2024-09-11,0,0,0.0,0,0,0,0,amp
2024-09-10,1,100,100.0,0,0,0,100,amp
2024-09-09,1,0,0.0,0,0,0,0,amp
2024-09-06,1,100,100.0,0,0,0,100,amp
2024-09-05,1,100,100.0,0,0,0,100,amp
2024-09-04,2,100,50.0,1,100,100,0,amp
2024-08-30,1,100,100.0,2,800,400,-700,amp
2024-08-29,1,300,300.0,2,500,250,-200,amp
2024-08-28,0,0,0.0,3,1200,400,-1200,amp
2024-08-27,4,500,125.0,1,300,300,200,amp
2024-08-26,3,900,300.0,3,1000,333,-100,amp
2024-08-23,1,200,200.0,3,3200,1067,-3000,amp
2024-08-22,0,0,0.0,2,4700,2350,-4700,amp
2024-08-21,0,0,0.0,1,300,300,-300,amp
2024-08-20,0,0,0.0,1,300,300,-300,amp
2024-08-19,0,0,0.0,1,300,300,-300,amp
2024-08-16,2,700,350.0,3,1000,333,-300,amp
2024-08-15,0,0,0.0,0,0,0,0,amp
2024-08-14,0,0,0.0,1,200,200,-200,amp
2024-08-13,0,0,0.0,0,0,0,0,amp
2024-08-12,0,0,0.0,0,0,0,0,amp
2024-08-09,0,0,0.0,2,4600,2300,-4600,amp
2024-08-08,0,0,0.0,0,0,0,0,amp
2024-08-07,0,0,0.0,0,0,0,0,amp
2024-08-06,0,0,0.0,0,0,0,0,amp
2024-08-05,0,0,0.0,0,0,0,0,amp
2024-08-02,0,0,0.0,0,0,0,0,amp
2024-08-01,0,0,0.0,0,0,0,0,amp
2024-07-31,1,200,200.0,0,0,0,200,amp
2024-07-30,2,2000,1000.0,1,1000,1000,1000,amp
2024-07-29,1,500,500.0,0,0,0,500,amp
2024-07-26,1,500,500.0,1,500,500,0,amp
2024-07-25,1,1700,1700.0,0,0,0,1700,amp
2024-07-24,1,4500,4500.0,2,4500,2250,0,amp
2024-07-23,1,200,200.0,2,600,300,-400,amp
2024-07-22,1,500,500.0,1,100,100,400,amp
2024-07-19,3,600,200.0,3,600,200,0,amp
2024-07-18,1,600,600.0,2,600,300,0,amp
2024-07-17,1,300,300.0,3,600,200,-300,amp
2024-07-16,0,0,0.0,2,600,300,-600,amp
2024-07-15,1,600,600.0,2,600,300,0,amp
2024-07-12,3,1000,333.33,3,1300,433,-300,amp
2024-07-11,1,300,300.0,3,1300,433,-1000,amp
2024-07-10,0,0,0.0,1,500,500,-500,amp
2024-07-09,0,0,0.0,2,1000,500,-1000,amp
2024-07-08,1,200,200.0,4,700,175,-500,amp
2024-07-05,1,500,500.0,3,1000,333,-500,amp
2024-07-04,1,200,200.0,4,1700,425,-1500,amp
2024-07-03,1,100,100.0,3,2200,733,-2100,amp
2024-07-02,1,500,500.0,1,0,0,500,amp
2024-07-01,2,600,300.0,2,800,400,-200,amp
2024-06-28,3,1000,333.33,2,1400,700,-400,amp
2024-06-27,2,400,200.0,0,0,0,400,amp
2024-06-26,5,600,120.0,2,400,200,200,amp
2024-06-25,3,300,100.0,1,1000,1000,-700,amp
2024-06-24,5,800,160.0,5,3100,620,-2300,amp
2024-06-21,5,600,120.0,2,1100,550,-500,amp
2024-06-20,20,6000,300.0,6,2800,467,3200,amp
2024-06-19,0,0,0.0,4,1400,350,-1400,amp
2024-06-18,3,200,66.67,2,1000,500,-800,amp
2024-06-17,0,0,0.0,2,500,250,-500,amp
2024-06-14,2,400,200.0,6,2600,433,-2200,amp
2024-06-13,3,700,233.33,3,900,300,-200,amp
2024-06-12,4,800,200.0,4,1700,425,-900,amp
2024-06-11,3,1400,466.67,3,1600,533,-200,amp
2024-06-10,4,700,175.0,3,2600,867,-1900,amp
2024-06-07,4,1000,250.0,8,4800,600,-3800,amp
2024-06-06,6,1000,166.67,9,3500,389,-2500,amp
2024-06-05,1,100,100.0,7,3300,471,-3200,amp
2024-06-04,5,200,40.0,8,2800,350,-2600,amp
2024-06-03,2,100,50.0,4,1400,350,-1300,amp
2024-05-31,8,2000,250.0,15,6000,400,-4000,amp
2024-05-30,0,0,0.0,10,8100,810,-8100,amp
2024-05-29,0,0,0.0,12,8200,683,-8200,amp
2024-05-28,1,200,200.0,13,6800,523,-6600,amp
2024-05-27,0,0,0.0,12,8100,675,-8100,amp
2024-05-24,0,0,0.0,13,11200,862,-11200,amp
2024-05-23,0,0,0.0,14,10600,757,-10600,amp
2024-05-22,2,5100,2550.0,10,2300,230,2800,amp
2024-05-21,10,2400,240.0,9,3100,344,-700,amp
2024-05-20,14,1500,107.14,8,2200,275,-700,amp
2024-05-17,12,7300,608.33,16,13500,844,-6200,amp
2024-05-16,3,400,133.33,7,2300,329,-1900,amp
2024-05-15,1,100,100.0,5,1400,280,-1300,amp
2024-05-14,0,0,0.0,4,1300,325,-1300,amp
2024-05-13,0,0,0.0,5,1400,280,-1400,amp
2024-05-10,0,0,0.0,4,400,100,-400,amp
2024-05-09,0,0,0.0,4,1300,325,-1300,amp
2024-05-08,0,0,0.0,4,300,75,-300,amp
2024-05-07,0,0,0.0,4,400,100,-400,amp
2024-05-06,0,0,0.0,3,300,100,-300,amp
2024-05-03,0,0,0.0,4,1000,250,-1000,amp
2024-05-02,1,200,200.0,8,1400,175,-1200,amp
2024-04-26,0,0,0.0,4,400,100,-400,amp
2024-04-25,0,0,0.0,0,0,0,0,amp
2024-04-24,0,0,0.0,0,0,0,0,amp
2024-04-23,0,0,0.0,0,0,0,0,amp
2024-04-22,0,0,0.0,0,0,0,0,amp
2024-04-19,0,0,0.0,5,600,120,-600,amp
2024-04-17,0,0,0.0,0,0,0,0,amp
2024-04-16,0,0,0.0,0,0,0,0,amp
2024-04-15,0,0,0.0,0,0,0,0,amp
2024-04-12,1,100,100.0,6,1400,233,-1300,amp
2024-04-11,0,0,0.0,0,0,0,0,amp
2024-04-10,0,0,0.0,0,0,0,0,amp
2024-04-09,0,0,0.0,0,0,0,0,amp
2024-04-08,0,0,0.0,0,0,0,0,amp
2024-04-05,0,0,0.0,4,1700,425,-1700,amp
2024-04-04,0,0,0.0,0,0,0,0,amp
2024-04-03,0,0,0.0,0,0,0,0,amp
2024-04-02,0,0,0.0,0,0,0,0,amp
2024-04-01,0,0,0.0,0,0,0,0,amp
2024-03-29,0,0,0.0,5,1800,360,-1800,amp
2024-03-28,0,0,0.0,0,0,0,0,amp
2024-03-27,0,0,0.0,0,0,0,0,amp
2024-03-26,0,0,0.0,0,0,0,0,amp
2024-03-25,0,0,0.0,0,0,0,0,amp
2024-03-22,0,0,0.0,4,1700,425,-1700,amp
2024-03-21,0,0,0.0,0,0,0,0,amp
2024-03-20,0,0,0.0,0,0,0,0,amp
2024-03-19,0,0,0.0,0,0,0,0,amp
2024-03-18,0,0,0.0,0,0,0,0,amp
2024-03-15,0,0,0.0,5,1800,360,-1800,amp
2024-03-14,0,0,0.0,0,0,0,0,amp
2024-03-13,0,0,0.0,0,0,0,0,amp
2024-03-12,0,0,0.0,0,0,0,0,amp
2024-03-11,0,0,0.0,0,0,0,0,amp
2024-03-08,0,0,0.0,7,2500,357,-2500,amp
2024-03-07,0,0,0.0,0,0,0,0,amp
2024-03-06,0,0,0.0,0,0,0,0,amp
2024-03-05,0,0,0.0,0,0,0,0,amp
2024-03-04,0,0,0.0,0,0,0,0,amp
2024-03-01,0,0,0.0,4,400,100,-400,amp
2024-02-29,0,0,0.0,0,0,0,0,amp
2024-02-28,0,0,0.0,0,0,0,0,amp
2024-02-27,0,0,0.0,0,0,0,0,amp
2024-02-26,0,0,0.0,0,0,0,0,amp
2024-02-23,1,100,100.0,4,900,225,-800,amp
2024-02-22,0,0,0.0,0,0,0,0,amp
2024-02-21,0,0,0.0,0,0,0,0,amp
2024-02-20,0,0,0.0,0,0,0,0,amp
2024-02-19,0,0,0.0,0,0,0,0,amp
2024-02-16,0,0,0.0,5,500,100,-500,amp
2024-02-15,0,0,0.0,0,0,0,0,amp
2024-02-07,0,0,0.0,0,0,0,0,amp
2024-02-06,0,0,0.0,0,0,0,0,amp
2024-02-05,0,0,0.0,0,0,0,0,amp
2024-02-02,0,0,0.0,6,2300,383,-2300,amp
2024-02-01,0,0,0.0,0,0,0,0,amp
2024-01-31,0,0,0.0,0,0,0,0,amp
2024-01-30,0,0,0.0,0,0,0,0,amp
2024-01-29,0,0,0.0,0,0,0,0,amp
2024-01-26,0,0,0.0,3,300,100,-300,amp
2024-01-25,0,0,0.0,0,0,0,0,amp
2024-01-24,0,0,0.0,0,0,0,0,amp
2024-01-23,0,0,0.0,0,0,0,0,amp
2024-01-22,0,0,0.0,0,0,0,0,amp
2024-01-19,0,0,0.0,3,500,167,-500,amp
2024-01-18,0,0,0.0,0,0,0,0,amp
2024-01-17,0,0,0.0,0,0,0,0,amp
2024-01-16,0,0,0.0,0,0,0,0,amp
2024-01-15,0,0,0.0,0,0,0,0,amp
2024-01-12,0,0,0.0,6,800,133,-800,amp
2024-01-11,0,0,0.0,0,0,0,0,amp
2024-01-10,0,0,0.0,0,0,0,0,amp
2024-01-09,0,0,0.0,0,0,0,0,amp
2024-01-08,0,0,0.0,0,0,0,0,amp
2024-01-05,1,200,200.0,8,5900,738,-5700,amp
2024-01-04,0,0,0.0,0,0,0,0,amp
2024-01-03,0,0,0.0,0,0,0,0,amp
2024-01-02,0,0,0.0,0,0,0,0,amp
2024-09-12,45,200100,4446.67,62,234200,3777,-34100,ams
2024-09-11,79,145100,1836.71,75,174100,2321,-29000,ams
2024-09-10,69,136100,1972.46,71,238300,3356,-102200,ams
2024-09-09,37,100100,2705.41,58,156100,2691,-56000,ams
2024-09-06,63,136400,2165.08,69,239700,3474,-103300,ams
2024-09-05,70,181500,2592.86,70,209700,2996,-28200,ams
2024-09-04,66,162400,2460.61,49,151900,3100,10500,ams
2024-08-30,143,353800,2474.13,98,359900,3672,-6100,ams
2024-08-29,88,269800,3065.91,68,267800,3938,2000,ams
2024-08-28,54,52300,968.52,73,254600,3488,-202300,ams
2024-08-27,101,105900,1048.51,74,218200,2949,-112300,ams
2024-08-26,106,130100,1227.36,86,293300,3410,-163200,ams
2024-08-23,100,139500,1395.0,87,271900,3125,-132400,ams
2024-08-22,134,336600,2511.94,107,378100,3534,-41500,ams
2024-08-21,122,344100,2820.49,125,466300,3730,-122200,ams
2024-08-20,125,266400,2131.2,126,455400,3614,-189000,ams
2024-08-19,100,246400,2464.0,113,339900,3008,-93500,ams
2024-08-16,140,488000,3485.71,158,402400,2547,85600,ams
2024-08-15,67,190600,2844.78,98,308600,3149,-118000,ams
2024-08-14,109,383200,3515.6,102,322300,3160,60900,ams
2024-08-13,126,475700,3775.4,130,454800,3498,20900,ams
2024-08-12,104,188000,1807.69,128,353800,2764,-165800,ams
2024-08-09,119,347100,2916.81,147,472800,3216,-125700,ams
2024-08-08,135,426700,3160.74,173,680700,3935,-254000,ams
2024-08-07,132,528700,4005.3,160,539000,3369,-10300,ams
2024-08-06,169,479100,2834.91,159,633100,3982,-154000,ams
2024-08-05,189,611300,3234.39,200,935300,4676,-324000,ams
2024-08-02,257,1192800,4641.25,189,795100,4207,397700,ams
2024-08-01,252,1476300,5858.33,316,1095000,3465,381300,ams
2024-07-31,197,1573100,7985.28,253,1101800,4355,471300,ams
2024-07-30,197,1471500,7469.54,239,1003800,4200,467700,ams
2024-07-29,220,1522300,6919.55,197,927700,4709,594600,ams
2024-07-26,206,687700,3338.35,209,775600,3711,-87900,ams
2024-07-25,125,438700,3509.6,170,590100,3471,-151400,ams
2024-07-24,186,528500,2841.4,206,723400,3512,-194900,ams
2024-07-23,130,999100,7685.38,205,714200,3484,284900,ams
2024-07-22,215,1104000,5134.88,267,662900,2483,441100,ams
2024-07-19,237,1524600,6432.91,248,940500,3792,584100,ams
2024-07-18,187,997400,5333.69,163,495000,3037,502400,ams
2024-07-17,180,607100,3372.78,195,474400,2433,132700,ams
2024-07-16,157,766900,4884.71,196,481800,2458,285100,ams
2024-07-15,200,499900,2499.5,217,714200,3291,-214300,ams
2024-07-12,175,527300,3013.14,261,714100,2736,-186800,ams
2024-07-11,145,750400,5175.17,265,696800,2629,53600,ams
2024-07-10,309,1329200,4301.62,337,1170500,3473,158700,ams
2024-07-09,311,939400,3020.58,287,806500,2810,132900,ams
2024-07-08,420,1977100,4707.38,319,1116100,3499,861000,ams
2024-07-05,290,1387900,4785.86,278,1038600,3736,349300,ams
2024-07-04,172,727600,4230.23,238,636500,2674,91100,ams
2024-07-03,230,894700,3890.0,236,585500,2481,309200,ams
2024-07-02,259,1267200,4892.66,266,567100,2132,700100,ams
2024-07-01,195,612500,3141.03,225,574900,2555,37600,ams
2024-06-28,320,1974800,6171.25,266,873500,3284,1101300,ams
2024-06-27,454,1354600,2983.7,311,937600,3015,417000,ams
2024-06-26,348,2052600,5898.28,300,802000,2673,1250600,ams
2024-06-25,304,1608800,5292.11,287,682300,2377,926500,ams
2024-06-24,501,2098900,4189.42,463,1061400,2292,1037500,ams
2024-06-21,879,3014200,3429.12,407,1530900,3761,1483300,ams
2024-06-20,680,2434100,3579.56,320,1273500,3980,1160600,ams
2024-06-19,268,2075400,7744.03,222,963700,4341,1111700,ams
2024-06-18,170,1131100,6653.53,193,682300,3535,448800,ams
2024-06-17,86,494200,5746.51,131,520700,3975,-26500,ams
2024-06-14,180,776300,4312.78,204,691500,3390,84800,ams
2024-06-13,242,1058400,4373.55,261,782100,2997,276300,ams
2024-06-12,92,430000,4673.91,111,246400,2220,183600,ams
2024-06-11,83,395400,4763.86,91,292400,3213,103000,ams
2024-06-10,73,215600,2953.42,77,227100,2949,-11500,ams
2024-06-07,58,302500,5215.52,90,187800,2087,114700,ams
2024-06-06,51,209800,4113.73,80,166700,2084,43100,ams
2024-06-05,55,310300,5641.82,71,235800,3321,74500,ams
2024-06-04,70,312000,4457.14,113,2655600,23501,-2343600,ams
2024-06-03,79,326800,4136.71,118,254800,2159,72000,ams
2024-05-31,117,411100,3513.68,131,339200,2589,71900,ams
2024-05-30,78,110900,1421.79,73,185800,2545,-74900,ams
2024-05-29,74,95000,1283.78,84,211000,2512,-116000,ams
2024-05-28,43,59000,1372.09,62,146200,2358,-87200,ams
2024-05-27,82,105600,1287.8,71,176000,2479,-70400,ams
2024-05-24,71,109600,1543.66,78,176100,2258,-66500,ams
2024-05-23,78,100400,1287.18,87,171100,1967,-70700,ams
2024-05-22,61,66200,1085.25,69,119300,1729,-53100,ams
2024-05-21,68,96200,1414.71,97,2613700,26945,-2517500,ams
2024-05-20,114,123900,1086.84,125,238800,1910,-114900,ams
2024-05-17,148,249900,1688.51,123,293400,2385,-43500,ams
2024-05-16,141,200100,1419.15,107,241600,2258,-41500,ams
2024-05-15,150,194400,1296.0,105,264100,2515,-69700,ams
2024-05-14,129,167100,1295.35,88,210200,2389,-43100,ams
2024-05-13,53,93000,1754.72,62,163600,2639,-70600,ams
2024-05-10,117,140800,1203.42,84,187100,2227,-46300,ams
2024-05-09,89,153300,1722.47,97,250100,2578,-96800,ams
2024-05-08,88,214100,2432.95,86,283300,3294,-69200,ams
2024-05-07,69,189100,2740.58,70,250000,3571,-60900,ams
2024-05-06,68,104700,1539.71,79,184000,2329,-79300,ams
2024-05-03,39,70300,1802.56,61,140500,2303,-70200,ams
2024-05-02,38,116500,3065.79,61,2615500,42877,-2499000,ams
2024-04-26,40,77800,1945.0,57,2654600,46572,-2576800,ams
2024-04-25,74,418900,5660.81,77,284400,3694,134500,ams
2024-04-24,68,401600,5905.88,87,263100,3024,138500,ams
2024-04-23,49,334700,6830.61,70,216200,3089,118500,ams
2024-04-22,46,306300,6658.7,41,173200,4224,133100,ams
2024-04-19,74,380300,5139.19,92,317000,3446,63300,ams
2024-04-17,80,397900,4973.75,105,348200,3316,49700,ams
2024-04-16,47,296300,6304.26,102,365900,3587,-69600,ams
2024-04-15,81,331700,4095.06,134,336600,2512,-4900,ams
2024-04-12,149,413400,2774.5,175,448400,2562,-35000,ams
2024-04-11,76,551400,7255.26,111,321400,2895,230000,ams
2024-04-10,74,609200,8232.43,141,412800,2928,196400,ams
2024-04-09,116,660200,5691.38,189,504400,2669,155800,ams
2024-04-08,110,610700,5551.82,218,459700,2109,151000,ams
2024-04-05,167,1011300,6055.69,242,986400,4076,24900,ams
2024-04-04,64,328600,5134.38,135,355500,2633,-26900,ams
2024-04-03,58,164800,2841.38,112,276300,2467,-111500,ams
2024-04-02,53,247600,4671.7,119,360000,3025,-112400,ams
2024-04-01,76,257300,3385.53,112,443800,3962,-186500,ams
2024-03-29,128,627600,4903.12,152,531500,3497,96100,ams
2024-03-28,52,793900,15267.31,89,327700,3682,466200,ams
2024-03-27,98,911200,9297.96,125,505800,4046,405400,ams
2024-03-26,46,725900,15780.43,102,548600,5378,177300,ams
2024-03-25,152,1140100,7500.66,177,605400,3420,534700,ams
2024-03-22,71,860000,12112.68,141,703900,4992,156100,ams
2024-03-21,121,1034500,8549.59,147,566800,3856,467700,ams
2024-03-20,78,556400,7133.33,110,276200,2511,280200,ams
2024-03-19,59,317900,5388.14,97,247100,2547,70800,ams
2024-03-18,87,202300,2325.29,124,273100,2202,-70800,ams
2024-03-15,49,131800,2689.8,98,249300,2544,-117500,ams
2024-03-14,65,192100,2955.38,114,321000,2816,-128900,ams
2024-03-13,70,156000,2228.57,125,244300,1954,-88300,ams
2024-03-12,50,230000,4600.0,103,245500,2383,-15500,ams
2024-03-11,82,276500,3371.95,106,281700,2658,-5200,ams
2024-03-08,59,373400,6328.81,120,319900,2666,53500,ams
2024-03-07,61,210900,3457.38,110,375400,3413,-164500,ams
2024-03-06,136,337100,2478.68,114,464900,4078,-127800,ams
2024-03-05,57,113500,1991.23,113,285600,2527,-172100,ams
2024-03-04,67,115600,1725.37,111,370100,3334,-254500,ams
2024-03-01,87,218600,2512.64,131,422100,3222,-203500,ams
2024-02-29,64,253400,3959.38,118,277400,2351,-24000,ams
2024-02-28,108,346800,3211.11,137,379400,2769,-32600,ams
2024-02-27,71,122000,1718.31,97,205300,2116,-83300,ams
2024-02-26,54,89400,1655.56,82,210800,2571,-121400,ams
2024-02-23,73,91600,1254.79,89,174300,1958,-82700,ams
2024-02-22,110,266800,2425.45,131,405900,3098,-139100,ams
2024-02-21,41,141600,3453.66,99,298300,3013,-156700,ams
2024-02-20,53,529100,9983.02,117,340300,2909,188800,ams
2024-02-19,82,274800,3351.22,112,450900,4026,-176100,ams
2024-02-16,171,652400,3815.2,162,726800,4486,-74400,ams
2024-02-15,160,471200,2945.0,145,435800,3006,35400,ams
2024-02-07,195,1057200,5421.54,205,1009700,4925,47500,ams
2024-02-06,88,588600,6688.64,88,392200,4457,196400,ams
2024-02-05,54,447400,8285.19,84,258600,3079,188800,ams
2024-02-02,57,506100,8878.95,107,453100,4235,53000,ams
2024-02-01,76,626800,8247.37,84,398000,4738,228800,ams
2024-01-31,67,608500,9082.09,81,364800,4504,243700,ams
2024-01-30,50,607800,12156.0,93,441000,4742,166800,ams
2024-01-29,75,514300,6857.33,115,502600,4370,11700,ams
2024-01-26,89,651200,7316.85,131,579800,4426,71400,ams
2024-01-25,87,350800,4032.18,94,476300,5067,-125500,ams
2024-01-24,123,419900,3413.82,140,609500,4354,-189600,ams
2024-01-23,41,229400,5595.12,88,390500,4438,-161100,ams
2024-01-22,51,354900,6958.82,103,384800,3736,-29900,ams
2024-01-19,73,446000,6109.59,128,356900,2788,89100,ams
2024-01-18,84,337500,4017.86,114,385700,3383,-48200,ams
2024-01-17,62,227700,3672.58,114,481100,4220,-253400,ams
2024-01-16,50,164700,3294.0,83,241500,2910,-76800,ams
2024-01-15,25,81400,3256.0,85,236100,2778,-154700,ams
2024-01-12,50,106700,2134.0,80,239300,2991,-132600,ams
2024-01-11,48,100500,2093.75,95,252500,2658,-152000,ams
2024-01-10,61,427000,7000.0,89,297200,3339,129800,ams
2024-01-09,45,418400,9297.78,105,326700,3111,91700,ams
2024-01-08,33,393600,11927.27,84,281600,3352,112000,ams
2024-01-05,46,444300,9658.7,93,313200,3368,131100,ams
2024-01-04,116,460100,3966.38,139,385700,2775,74400,ams
2024-01-03,44,290900,6611.36,101,243500,2411,47400,ams
2024-01-02,40,231400,5785.0,99,496100,5011,-264700,ams
2024-09-12,246,641900,2609.35,254,1728300,6804,-1086400,amv
2024-09-11,240,769800,3207.5,256,1534400,5994,-764600,amv
2024-09-10,320,820800,2565.0,292,1833300,6278,-1012500,amv
2024-09-09,224,594400,2653.57,256,1911400,7466,-1317000,amv
2024-09-06,279,761100,2727.96,315,2043100,6486,-1282000,amv
2024-09-05,295,762300,2584.07,362,2432300,6719,-1670000,amv
2024-09-04,250,996100,3984.4,313,2091300,6681,-1095200,amv
2024-08-30,297,913700,3076.43,338,2418800,7156,-1505100,amv
2024-08-29,328,1171100,3570.43,342,2550100,7456,-1379000,amv
2024-08-28,331,1016700,3071.6,356,2489300,6992,-1472600,amv
2024-08-27,366,1361000,3718.58,392,3094100,7893,-1733100,amv
2024-08-26,338,1457400,4311.83,454,2803400,6175,-1346000,amv
2024-08-23,341,994600,2916.72,362,2145900,5928,-1151300,amv
2024-08-22,403,1272800,3158.31,337,1963600,5827,-690800,amv
2024-08-21,343,962500,2806.12,332,1907800,5746,-945300,amv
2024-08-20,398,1358000,3412.06,375,2133600,5690,-775600,amv
2024-08-19,411,1188100,2890.75,442,2805200,6347,-1617100,amv
2024-08-16,237,857200,3616.88,448,2239200,4998,-1382000,amv
2024-08-15,482,1807000,3748.96,538,2630100,4889,-823100,amv
2024-08-14,266,699500,2629.7,251,1440700,5740,-741200,amv
2024-08-13,285,878300,3081.75,268,1477700,5514,-599400,amv
2024-08-12,265,682400,2575.09,271,1411700,5209,-729300,amv
2024-08-09,272,697800,2565.44,286,1374800,4807,-677000,amv
2024-08-08,287,552000,1923.34,274,1329000,4850,-777000,amv
2024-08-07,287,768700,2678.4,297,1284500,4325,-515800,amv
2024-08-06,321,828100,2579.75,299,1502500,5025,-674400,amv
2024-08-05,446,968500,2171.52,407,2056300,5052,-1087800,amv
2024-08-02,370,1216400,3287.57,285,991700,3480,224700,amv
2024-08-01,663,1575300,2376.02,368,2389100,6492,-813800,amv
2024-07-31,423,1259800,2978.25,327,1864200,5701,-604400,amv
2024-07-30,304,782900,2575.33,372,1836700,4937,-1053800,amv
2024-07-29,222,857600,3863.06,381,1677900,4404,-820300,amv
2024-07-26,244,652400,2673.77,331,1690100,5106,-1037700,amv
2024-07-25,305,797900,2616.07,313,1683200,5378,-885300,amv
2024-07-24,455,973800,2140.22,308,1566200,5085,-592400,amv
2024-07-23,394,873900,2218.02,301,1595900,5302,-722000,amv
2024-07-22,470,1107200,2355.74,376,1854800,4933,-747600,amv
2024-07-19,613,1705300,2781.89,414,2815700,6801,-1110400,amv
2024-07-18,618,1719800,2782.85,496,3270900,6595,-1551100,amv
2024-07-17,597,1536900,2574.37,835,5771100,6911,-4234200,amv
2024-07-16,1058,6075300,5742.25,738,4044800,5481,2030500,amv
2024-07-15,510,1677900,3290.0,414,3342900,8075,-1665000,amv
2024-07-12,341,762000,2234.6,484,3427400,7081,-2665400,amv
2024-07-11,263,771500,2933.46,427,2701700,6327,-1930200,amv
2024-07-10,317,854400,2695.27,408,2432700,5962,-1578300,amv
2024-07-09,309,784800,2539.81,394,2322500,5895,-1537700,amv
2024-07-08,324,751500,2319.44,426,2879700,6760,-2128200,amv
2024-07-05,451,904900,2006.43,400,2451400,6128,-1546500,amv
2024-07-04,314,599100,1907.96,372,2031500,5461,-1432400,amv
2024-07-03,264,580400,2198.48,306,2000100,6536,-1419700,amv
2024-07-02,314,886300,2822.61,331,2293100,6928,-1406800,amv
2024-07-01,293,930100,3174.4,271,1896200,6997,-966100,amv
2024-06-28,357,1031400,2889.08,365,3025100,8288,-1993700,amv
2024-06-27,378,989100,2616.67,469,3580200,7634,-2591100,amv
2024-06-26,313,920800,2941.85,424,2789800,6580,-1869000,amv
2024-06-25,401,1350900,3368.83,305,1767300,5794,-416400,amv
2024-06-24,337,1178800,3497.92,512,3170600,6193,-1991800,amv
2024-06-21,301,1463300,4861.46,496,3177900,6407,-1714600,amv
2024-06-20,279,1253100,4491.4,427,2941200,6888,-1688100,amv
2024-06-19,360,1097200,3047.78,409,2842200,6949,-1745000,amv
2024-06-18,355,1228500,3460.56,411,3065500,7459,-1837000,amv
2024-06-17,519,1416300,2728.9,475,3762800,7922,-2346500,amv
2024-06-14,494,1682400,3405.67,484,3220000,6653,-1537600,amv
2024-06-13,529,2084100,3939.7,546,3938900,7214,-1854800,amv
2024-06-12,467,1792700,3838.76,490,3446300,7033,-1653600,amv
2024-06-11,446,1546900,3468.39,556,4021000,7232,-2474100,amv
2024-06-10,463,1625100,3509.94,645,3891700,6034,-2266600,amv
2024-06-07,483,2372500,4912.01,642,4673800,7280,-2301300,amv
2024-06-06,483,3170600,6564.39,799,5700100,7134,-2529500,amv
2024-06-05,413,2040500,4940.68,672,4223400,6285,-2182900,amv
2024-06-04,624,2992700,4795.99,678,4715300,6955,-1722600,amv
2024-06-03,549,2245200,4089.62,819,5089100,6214,-2843900,amv
2024-05-31,525,3271200,6230.86,822,4935500,6004,-1664300,amv
2024-05-30,830,5177100,6237.47,1151,6362000,5527,-1184900,amv
2024-05-29,381,1693600,4445.14,618,3902600,6315,-2209000,amv
2024-05-28,356,1746600,4906.18,602,3668000,6093,-1921400,amv
2024-05-27,413,1892300,4581.84,545,3380100,6202,-1487800,amv
2024-05-24,550,3226500,5866.36,748,5885600,7868,-2659100,amv
2024-05-23,548,11824400,21577.37,948,4767600,5029,7056800,amv
2024-05-22,437,2786400,6376.2,776,4007500,5164,-1221100,amv
2024-05-21,586,3482500,5942.83,850,4562100,5367,-1079600,amv
2024-05-20,581,3484800,5997.93,733,4475100,6105,-990300,amv
2024-05-17,436,2236000,5128.44,613,3770400,6151,-1534400,amv
2024-05-16,524,1494600,2852.29,577,3324100,5761,-1829500,amv
2024-05-15,680,1986300,2921.03,661,4523600,6844,-2537300,amv
2024-05-14,653,2640600,4043.8,744,3969500,5335,-1328900,amv
2024-05-13,563,2001500,3555.06,689,3709800,5384,-1708300,amv
2024-05-10,543,2689800,4953.59,874,4077000,4665,-1387200,amv
2024-05-09,638,2789000,4371.47,537,2835100,5280,-46100,amv
2024-05-08,430,2060600,4792.09,432,1968100,4556,92500,amv
2024-05-07,431,2224500,5161.25,565,2547600,4509,-323100,amv
2024-05-06,362,1424700,3935.64,437,2070500,4738,-645800,amv
2024-05-03,306,1383100,4519.93,428,1869500,4368,-486400,amv
2024-05-02,376,1654900,4401.33,352,1500300,4262,154600,amv
2024-04-26,504,2355200,4673.02,362,2366400,6537,-11200,amv
2024-04-25,301,1369200,4548.84,443,2518200,5684,-1149000,amv
2024-04-24,469,1902600,4056.72,453,2104600,4646,-202000,amv
2024-04-23,374,1429700,3822.73,435,2220700,5105,-791000,amv
2024-04-22,466,1780300,3820.39,524,1722200,3287,58100,amv
2024-04-19,602,1917100,3184.55,438,2209200,5044,-292100,amv
2024-04-17,1069,3504900,3278.67,501,4068900,8122,-564000,amv
2024-04-16,827,2083200,2518.98,480,2354800,4906,-271600,amv
2024-04-15,610,1893000,3103.28,622,3588700,5770,-1695700,amv
2024-04-12,530,2218400,4185.66,547,2833400,5180,-615000,amv
2024-04-11,546,2003200,3668.86,491,2331200,4748,-328000,amv
2024-04-10,575,2409400,4190.26,472,2006000,4250,403400,amv
2024-04-09,1170,3661500,3129.49,626,4176300,6671,-514800,amv
2024-04-08,644,2216800,3442.24,446,2414400,5413,-197600,amv
2024-04-05,1657,5950000,3590.83,727,6546500,9005,-596500,amv
2024-04-04,618,2597600,4203.24,581,4444100,7649,-1846500,amv
2024-04-03,563,2300100,4085.44,693,5337900,7703,-3037800,amv
2024-04-02,729,2735500,3752.4,637,4444500,6977,-1709000,amv
2024-04-01,779,2878400,3694.99,601,4944100,8226,-2065700,amv
2024-03-29,708,2553100,3606.07,619,4484000,7244,-1930900,amv
2024-03-28,928,3925300,4229.85,821,7952800,9687,-4027500,amv
2024-03-27,478,17022300,35611.51,1206,8406200,6970,8616100,amv
2024-03-26,997,25349900,25426.18,1234,8971100,7270,16378800,amv
2024-03-25,464,3450600,7436.64,625,5977600,9564,-2527000,amv
2024-03-22,670,3649700,5447.31,684,5046200,7377,-1396500,amv
2024-03-21,820,4699400,5730.98,680,6424800,9448,-1725400,amv
2024-03-20,512,2106200,4113.67,565,3803900,6733,-1697700,amv
2024-03-19,539,2391400,4436.73,561,4234700,7548,-1843300,amv
2024-03-18,1005,4380000,4358.21,670,5785800,8636,-1405800,amv
2024-03-15,668,2189200,3277.25,602,4030600,6695,-1841400,amv
2024-03-14,752,3095100,4115.82,737,4353600,5907,-1258500,amv
2024-03-13,722,2368100,3279.92,630,4316100,6851,-1948000,amv
2024-03-12,677,2247400,3319.65,521,3269200,6275,-1021800,amv
2024-03-11,679,2773900,4085.27,559,3695200,6610,-921300,amv
2024-03-08,903,3680600,4075.97,848,6432900,7586,-2752300,amv
2024-03-07,626,2624200,4192.01,747,4636000,6206,-2011800,amv
2024-03-06,813,3790900,4662.85,999,6150800,6157,-2359900,amv
2024-03-05,673,2814800,4182.47,905,5419200,5988,-2604400,amv
2024-03-04,620,2766500,4462.1,738,3993500,5411,-1227000,amv
2024-03-01,721,3230200,4480.17,666,3999200,6005,-769000,amv
2024-02-29,865,3263600,3772.95,744,4126000,5546,-862400,amv
2024-02-28,874,2778400,3178.95,693,4767500,6880,-1989100,amv
2024-02-27,958,3197800,3338.0,806,5031900,6243,-1834100,amv
2024-02-26,837,2508200,2996.65,607,3910600,6443,-1402400,amv
2024-02-23,961,3730800,3882.21,997,6264600,6283,-2533800,amv
2024-02-22,1962,7287100,3714.12,1531,9340200,6101,-2053100,amv
2024-02-21,727,4230000,5818.43,853,5395300,6325,-1165300,amv
2024-02-20,618,4508800,7295.79,996,6741600,6769,-2232800,amv
2024-02-19,452,2760200,6106.64,666,4783500,7182,-2023300,amv
2024-02-16,422,2461200,5832.23,584,4057700,6948,-1596500,amv
2024-02-15,504,2237900,4440.28,511,3381300,6617,-1143400,amv
2024-02-07,502,1618000,3223.11,352,2952700,8388,-1334700,amv
2024-02-06,441,1739800,3945.12,381,2827100,7420,-1087300,amv
2024-02-05,449,1504800,3351.45,453,3155800,6966,-1651000,amv
2024-02-02,542,2515600,4641.33,489,4076200,8336,-1560600,amv
2024-02-01,526,2091500,3976.24,416,3804700,9146,-1713200,amv
2024-01-31,630,3182200,5051.11,645,5816200,9017,-2634000,amv
2024-01-30,361,2085100,5775.9,674,4887300,7251,-2802200,amv
2024-01-29,437,2546100,5826.32,879,4349100,4948,-1803000,amv
2024-01-26,734,17891300,24375.07,1143,6509300,5695,11382000,amv
2024-01-25,378,1975300,5225.66,454,2427300,5346,-452000,amv
2024-01-24,390,1349500,3460.26,493,3535000,7170,-2185500,amv
2024-01-23,353,1578800,4472.52,505,2900900,5744,-1322100,amv
2024-01-22,424,2957900,6976.18,499,3589200,7193,-631300,amv
2024-01-19,406,1648000,4059.11,520,2954200,5681,-1306200,amv
2024-01-18,452,1195700,2645.35,499,2936300,5884,-1740600,amv
2024-01-17,494,1438800,2912.55,508,3478700,6848,-2039900,amv
2024-01-16,553,1786600,3230.74,421,2415300,5737,-628700,amv
2024-01-15,358,1493800,4172.63,411,2984400,7261,-1490600,amv
2024-01-12,686,1909600,2783.67,519,3679400,7089,-1769800,amv
2024-01-11,526,1992400,3787.83,534,3128800,5859,-1136400,amv
2024-01-10,600,1579900,2633.17,690,3947600,5721,-2367700,amv
2024-01-09,691,2088400,3022.29,635,3485700,5489,-1397300,amv
2024-01-08,521,1941400,3726.3,596,3672700,6162,-1731300,amv
2024-01-05,531,2064900,3888.7,532,2674700,5028,-609800,amv
2024-01-04,675,3263900,4835.41,949,5268800,5552,-2004900,amv
2024-01-03,660,2862100,4336.52,588,2867000,4876,-4900,amv
2024-01-02,615,2103300,3420.0,491,2696600,5492,-593300,amv
2024-09-12,19,24800,1305.26,13,13700,1054,11100,ant
2024-09-11,26,25900,996.15,16,22800,1425,3100,ant
2024-09-10,38,54800,1442.11,23,47800,2078,7000,ant
2024-09-09,56,49300,880.36,32,28800,900,20500,ant
2024-09-06,32,36300,1134.38,24,26900,1121,9400,ant
2024-09-05,31,24100,777.42,25,36200,1448,-12100,ant
2024-09-04,26,50500,1942.31,24,30600,1275,19900,ant
2024-08-30,32,45700,1428.12,26,39400,1515,6300,ant
2024-08-29,44,30800,700.0,11,14500,1318,16300,ant
2024-08-28,41,134300,3275.61,22,42700,1941,91600,ant
2024-08-27,55,83700,1521.82,28,55400,1979,28300,ant
2024-08-26,47,32900,700.0,15,16000,1067,16900,ant
2024-08-23,39,27700,710.26,26,47000,1808,-19300,ant
2024-08-22,57,53400,936.84,42,36300,864,17100,ant
2024-08-21,46,63400,1378.26,29,35000,1207,28400,ant
2024-08-20,51,78700,1543.14,38,83100,2187,-4400,ant
2024-08-19,46,134600,2926.09,41,107000,2610,27600,ant
2024-08-16,18,36800,2044.44,16,21300,1331,15500,ant
2024-08-15,35,46700,1334.29,27,45300,1678,1400,ant
2024-08-14,38,39300,1034.21,22,32300,1468,7000,ant
2024-08-13,14,31800,2271.43,14,23400,1671,8400,ant
2024-08-12,21,36300,1728.57,17,17100,1006,19200,ant
2024-08-09,33,39800,1206.06,26,50200,1931,-10400,ant
2024-08-08,29,53000,1827.59,22,79500,3614,-26500,ant
2024-08-07,48,52100,1085.42,35,83500,2386,-31400,ant
2024-08-06,43,68700,1597.67,41,87600,2137,-18900,ant
2024-08-05,59,66700,1130.51,39,32000,821,34700,ant
2024-08-02,58,108400,1868.97,31,80600,2600,27800,ant
2024-08-01,87,127300,1463.22,79,117600,1489,9700,ant
2024-07-31,17,12600,741.18,30,55900,1863,-43300,ant
2024-07-30,178,272400,1530.34,86,209100,2431,63300,ant
2024-07-29,44,28200,640.91,24,42000,1750,-13800,ant
2024-07-26,21,13400,638.1,13,18200,1400,-4800,ant
2024-07-25,26,31900,1226.92,21,27400,1305,4500,ant
2024-07-24,18,28300,1572.22,15,23300,1553,5000,ant
2024-07-23,26,37600,1446.15,25,33000,1320,4600,ant
2024-07-22,28,52500,1875.0,27,48800,1807,3700,ant
2024-07-19,12,28700,2391.67,13,27000,2077,1700,ant
2024-07-18,25,53200,2128.0,22,34400,1564,18800,ant
2024-07-17,16,32900,2056.25,11,19500,1773,13400,ant
2024-07-16,25,39000,1560.0,16,22600,1412,16400,ant
2024-07-15,20,37600,1880.0,22,25600,1164,12000,ant
2024-07-12,14,38300,2735.71,11,9400,855,28900,ant
2024-07-11,27,57200,2118.52,18,30200,1678,27000,ant
2024-07-10,48,105600,2200.0,32,91100,2847,14500,ant
2024-07-09,39,68300,1751.28,17,84600,4976,-16300,ant
2024-07-08,27,40300,1492.59,16,26800,1675,13500,ant
2024-07-05,23,56000,2434.78,16,30500,1906,25500,ant
2024-07-04,78,129200,1656.41,50,113000,2260,16200,ant
2024-07-03,15,34800,2320.0,14,35900,2564,-1100,ant
2024-07-02,34,70700,2079.41,17,48300,2841,22400,ant
2024-07-01,27,41500,1537.04,23,26500,1152,15000,ant
2024-06-28,42,68500,1630.95,26,62900,2419,5600,ant
2024-06-27,31,56300,1816.13,16,48200,3012,8100,ant
2024-06-26,23,33900,1473.91,14,11100,793,22800,ant
2024-06-25,27,56600,2096.3,17,55700,3276,900,ant
2024-06-24,49,72400,1477.55,28,54100,1932,18300,ant
2024-06-21,31,86700,2796.77,20,52800,2640,33900,ant
2024-06-20,23,48500,2108.7,20,31700,1585,16800,ant
2024-06-19,24,71900,2995.83,19,39300,2068,32600,ant
2024-06-18,24,70600,2941.67,27,57100,2115,13500,ant
2024-06-17,23,58100,2526.09,16,31700,1981,26400,ant
2024-06-14,24,72400,3016.67,31,65200,2103,7200,ant
2024-06-13,14,13500,964.29,21,38800,1848,-25300,ant
2024-06-12,23,31700,1378.26,19,39900,2100,-8200,ant
2024-06-11,15,34400,2293.33,23,44700,1943,-10300,ant
2024-06-10,47,63800,1357.45,44,59600,1355,4200,ant
2024-06-07,38,113900,2997.37,42,97600,2324,16300,ant
2024-06-06,29,45700,1575.86,38,47900,1261,-2200,ant
2024-06-05,29,25400,875.86,24,22300,929,3100,ant
2024-06-04,45,40300,895.56,55,76500,1391,-36200,ant
2024-06-03,60,48800,813.33,24,27300,1138,21500,ant
2024-05-31,35,54700,1562.86,22,54700,2486,0,ant
2024-05-30,15,28100,1873.33,25,68600,2744,-40500,ant
2024-05-29,24,37200,1550.0,34,60100,1768,-22900,ant
2024-05-28,55,65000,1181.82,47,72600,1545,-7600,ant
2024-05-27,39,38600,989.74,31,19900,642,18700,ant
2024-05-24,101,100500,995.05,60,79400,1323,21100,ant
2024-05-23,26,35700,1373.08,30,36500,1217,-800,ant
2024-05-22,41,83800,2043.9,34,29800,876,54000,ant
2024-05-21,71,133600,1881.69,48,84400,1758,49200,ant
2024-05-20,26,49800,1915.38,15,17300,1153,32500,ant
2024-05-17,43,61600,1432.56,31,57200,1845,4400,ant
2024-05-16,34,62500,1838.24,20,28100,1405,34400,ant
2024-05-15,47,91300,1942.55,22,30400,1382,60900,ant
2024-05-14,34,66000,1941.18,25,66200,2648,-200,ant
2024-05-13,44,124600,2831.82,40,105400,2635,19200,ant
2024-05-10,27,43400,1607.41,26,27300,1050,16100,ant
2024-05-09,30,56200,1873.33,39,40800,1046,15400,ant
2024-05-08,38,116900,3076.32,68,204000,3000,-87100,ant
2024-05-07,68,162900,2395.59,95,220300,2319,-57400,ant
2024-05-06,99,198100,2001.01,30,47200,1573,150900,ant
2024-05-03,116,366900,3162.93,23,177600,7722,189300,ant
2024-05-02,69,367400,5324.64,3,400,133,367000,ant
2024-04-26,72,227700,3162.5,37,177100,4786,50600,ant
2024-04-25,43,53500,1244.19,28,59300,2118,-5800,ant
2024-04-24,14,21300,1521.43,13,35000,2692,-13700,ant
2024-04-23,12,19000,1583.33,11,42200,3836,-23200,ant
2024-04-22,7,11300,1614.29,14,8100,579,3200,ant
2024-04-19,16,31700,1981.25,24,31200,1300,500,ant
2024-04-17,19,39800,2094.74,19,53200,2800,-13400,ant
2024-04-16,24,25800,1075.0,14,29900,2136,-4100,ant
2024-04-15,24,19900,829.17,25,38500,1540,-18600,ant
2024-04-12,21,27300,1300.0,20,35100,1755,-7800,ant
2024-04-11,37,29400,794.59,17,32200,1894,-2800,ant
2024-04-10,19,29200,1536.84,22,24100,1095,5100,ant
2024-04-09,22,28400,1290.91,16,13600,850,14800,ant
2024-04-08,22,43000,1954.55,19,37000,1947,6000,ant
2024-04-05,40,75400,1885.0,29,59100,2038,16300,ant
2024-04-04,24,60400,2516.67,24,45200,1883,15200,ant
2024-04-03,47,89700,1908.51,22,74400,3382,15300,ant
2024-04-02,46,61800,1343.48,47,65600,1396,-3800,ant
2024-04-01,37,34700,937.84,26,31000,1192,3700,ant
2024-03-29,61,49500,811.48,19,37300,1963,12200,ant
2024-03-28,29,13700,472.41,19,16800,884,-3100,ant
2024-03-27,22,20400,927.27,21,39200,1867,-18800,ant
2024-03-26,26,16900,650.0,24,30000,1250,-13100,ant
2024-03-25,49,31200,636.73,34,31600,929,-400,ant
2024-03-22,23,29900,1300.0,22,17600,800,12300,ant
2024-03-21,30,29900,996.67,22,24600,1118,5300,ant
2024-03-20,24,17400,725.0,20,14400,720,3000,ant
2024-03-19,20,23100,1155.0,34,55700,1638,-32600,ant
2024-03-18,31,121900,3932.26,31,46500,1500,75400,ant
2024-03-15,28,49100,1753.57,24,18900,788,30200,ant
2024-03-14,33,89900,2724.24,18,31700,1761,58200,ant
2024-03-13,28,32900,1175.0,25,29900,1196,3000,ant
2024-03-12,27,23500,870.37,19,32500,1711,-9000,ant
2024-03-11,45,32400,720.0,26,39500,1519,-7100,ant
2024-03-08,26,21700,834.62,20,24300,1215,-2600,ant
2024-03-07,15,11800,786.67,14,22000,1571,-10200,ant
2024-03-06,19,19400,1021.05,10,21000,2100,-1600,ant
2024-03-05,20,16600,830.0,15,33700,2247,-17100,ant
2024-03-04,19,15500,815.79,13,17600,1354,-2100,ant
2024-03-01,44,39400,895.45,27,48600,1800,-9200,ant
2024-02-29,10,9900,990.0,13,11600,892,-1700,ant
2024-02-28,14,14400,1028.57,20,32300,1615,-17900,ant
2024-02-27,19,20600,1084.21,19,21700,1142,-1100,ant
2024-02-26,22,18700,850.0,19,28500,1500,-9800,ant
2024-02-23,32,40800,1275.0,29,46000,1586,-5200,ant
2024-02-22,39,26100,669.23,21,16300,776,9800,ant
2024-02-21,20,15900,795.0,11,12400,1127,3500,ant
2024-02-20,34,42600,1252.94,19,34600,1821,8000,ant
2024-02-19,31,50500,1629.03,18,49300,2739,1200,ant
2024-02-16,27,38200,1414.81,14,27400,1957,10800,ant
2024-02-15,16,14200,887.5,14,27100,1936,-12900,ant
2024-02-07,19,9600,505.26,7,14900,2129,-5300,ant
2024-02-06,25,27500,1100.0,14,36300,2593,-8800,ant
2024-02-05,10,7000,700.0,10,19600,1960,-12600,ant
2024-02-02,22,20900,950.0,12,33000,2750,-12100,ant
2024-02-01,20,18100,905.0,12,37200,3100,-19100,ant
2024-01-31,8,5700,712.5,7,14600,2086,-8900,ant
2024-01-30,7,10300,1471.43,11,35500,3227,-25200,ant
2024-01-29,12,19800,1650.0,14,20700,1479,-900,ant
2024-01-26,31,31500,1016.13,16,31700,1981,-200,ant
2024-01-25,19,13800,726.32,12,14800,1233,-1000,ant
2024-01-24,14,15400,1100.0,13,30800,2369,-15400,ant
2024-01-23,14,17900,1278.57,12,13900,1158,4000,ant
2024-01-22,35,41100,1174.29,16,49800,3112,-8700,ant
2024-01-19,16,16200,1012.5,12,8500,708,7700,ant
2024-01-18,14,10500,750.0,18,27500,1528,-17000,ant
2024-01-17,19,22900,1205.26,16,32900,2056,-10000,ant
2024-01-16,17,9200,541.18,17,19700,1159,-10500,ant
2024-01-15,19,9100,478.95,17,16400,965,-7300,ant
2024-01-12,13,7700,592.31,22,38200,1736,-30500,ant
2024-01-11,25,14900,596.0,20,37700,1885,-22800,ant
2024-01-10,24,30400,1266.67,33,22000,667,8400,ant
2024-01-09,16,16500,1031.25,21,15500,738,1000,ant
2024-01-08,23,21400,930.43,34,31900,938,-10500,ant
2024-01-05,34,26900,791.18,29,19800,683,7100,ant
2024-01-04,28,24800,885.71,19,31000,1632,-6200,ant
2024-01-03,38,35900,944.74,27,53400,1978,-17500,ant
2024-01-02,29,15700,541.38,25,30700,1228,-15000,ant
2024-09-12,358,531600,1484.92,585,1236600,2114,-705000,anv
2024-09-11,537,1009300,1879.52,600,1051300,1752,-42000,anv
2024-09-10,876,1676800,1914.16,1061,1723900,1625,-47100,anv
2024-09-09,537,1093400,2036.13,603,776500,1288,316900,anv
2024-09-06,850,1144000,1345.88,482,836900,1736,307100,anv
2024-09-05,821,1342500,1635.2,529,1148600,2171,193900,anv
2024-09-04,1199,1470400,1226.36,485,1178900,2431,291500,anv
2024-08-30,1219,1464900,1201.72,650,1167800,1797,297100,anv
2024-08-29,708,991100,1399.86,470,893500,1901,97600,anv
2024-08-28,1383,1754500,1268.62,669,1751400,2618,3100,anv
2024-08-27,648,901500,1391.2,609,1185400,1946,-283900,anv
2024-08-26,737,1036400,1406.24,905,1837100,2030,-800700,anv
2024-08-23,1429,2933900,2053.11,1788,3261300,1824,-327400,anv
2024-08-22,1073,1337200,1246.23,847,1855900,2191,-518700,anv
2024-08-21,1178,1425800,1210.36,854,2033800,2381,-608000,anv
2024-08-20,1136,2071100,1823.15,1371,2484400,1812,-413300,anv
2024-08-19,898,1823800,2030.96,896,2023600,2258,-199800,anv
2024-08-16,1211,2335800,1928.82,1252,2196200,1754,139600,anv
2024-08-15,761,1116400,1467.02,651,1399300,2149,-282900,anv
2024-08-14,811,1526200,1881.87,1035,1876400,1813,-350200,anv
2024-08-13,762,1221500,1603.02,790,1495200,1893,-273700,anv
2024-08-12,734,1311300,1786.51,694,1177200,1696,134100,anv
2024-08-08,862,1829500,2122.39,1084,1994800,1840,-165300,anv
2024-08-07,827,1570600,1899.15,997,1366600,1371,204000,anv
2024-08-06,1153,2207100,1914.22,1193,2079600,1743,127500,anv
2024-08-05,1972,2894400,1467.75,1275,3478600,2728,-584200,anv
2024-08-02,1958,3376900,1724.67,1348,2392100,1775,984800,anv
2024-08-01,3149,4038400,1282.44,1587,4211300,2654,-172900,anv
2024-07-31,1160,1814300,1564.05,962,2300400,2391,-486100,anv
2024-07-30,1636,2607600,1593.89,1466,3026700,2065,-419100,anv
2024-07-29,1106,2254000,2037.97,1320,1937200,1468,316800,anv
2024-07-26,1275,2143700,1681.33,872,1933800,2218,209900,anv
2024-07-25,1747,2361000,1351.46,899,1689200,1879,671800,anv
2024-07-24,2315,4503900,1945.53,1857,3783000,2037,720900,anv
2024-07-22,3655,6961200,1904.57,2950,8222700,2787,-1261500,anv
2024-07-19,4349,8296000,1907.56,4655,8975500,1928,-679500,anv
2024-07-18,2422,5094000,2103.22,2004,4454300,2223,639700,anv
2024-07-17,3819,6773900,1773.74,2869,6178000,2153,595900,anv
2024-07-16,3074,4910800,1597.53,2293,5677300,2476,-766500,anv
2024-07-15,2205,3040500,1378.91,2018,4168100,2065,-1127600,anv
2024-07-12,4471,9819000,2196.15,5158,10006100,1940,-187100,anv
2024-07-11,2095,4734300,2259.81,2196,4396200,2002,338100,anv
2024-07-10,3081,4825000,1566.05,2279,6001100,2633,-1176100,anv
2024-07-09,4786,10850200,2267.07,4497,10504700,2336,345500,anv
2024-07-08,1325,2465200,1860.53,1350,4210700,3119,-1745500,anv
2024-07-05,1201,2112400,1758.87,1486,4858400,3269,-2746000,anv
2024-07-04,969,1318400,1360.58,964,3784100,3925,-2465700,anv
2024-07-03,829,1405500,1695.42,1375,4419700,3214,-3014200,anv
2024-07-02,1204,2449100,2034.14,1283,3555400,2771,-1106300,anv
2024-07-01,912,1388600,1522.59,674,2218100,3291,-829500,anv
2024-06-28,1313,1679200,1278.9,925,2846900,3078,-1167700,anv
2024-06-27,946,1438700,1520.82,984,2699600,2743,-1260900,anv
2024-06-26,1107,1950800,1762.24,971,2469200,2543,-518400,anv
2024-06-25,1370,2533000,1848.91,1118,1710800,1530,822200,anv
2024-06-24,2738,4446000,1623.81,1731,5200200,3004,-754200,anv
2024-06-21,1693,2285200,1349.79,1232,2905700,2359,-620500,anv
2024-06-20,1907,2305900,1209.18,1308,3532800,2701,-1226900,anv
2024-06-19,1917,3435800,1792.28,2305,4925800,2137,-1490000,anv
2024-06-18,1224,2251900,1839.79,1506,3013100,2001,-761200,anv
2024-06-17,2386,4629000,1940.07,1397,4296100,3075,332900,anv
2024-06-14,2711,4865500,1794.73,1860,5705700,3068,-840200,anv
2024-06-13,1610,2720000,1689.44,1845,3453500,1872,-733500,anv
2024-06-12,1360,2999100,2205.22,1482,3002900,2026,-3800,anv
2024-06-11,2741,4369800,1594.24,2136,4806000,2250,-436200,anv
2024-06-10,3381,6428900,1901.48,4324,8292900,1918,-1864000,anv
2024-06-07,1739,3348400,1925.47,1906,3779500,1983,-431100,anv
2024-06-06,2399,3711400,1547.06,2320,4979700,2146,-1268300,anv
2024-06-05,2198,3652100,1661.56,3128,5792500,1852,-2140400,anv
2024-06-04,2731,5443300,1993.15,2628,6014900,2289,-571600,anv
2024-06-03,2158,4163100,1929.15,2724,4959700,1821,-796600,anv
2024-05-31,3009,7991600,2655.9,3270,8245800,2522,-254200,anv
2024-05-30,1673,2621700,1567.07,1126,3704100,3290,-1082400,anv
2024-05-29,3143,7264300,2311.26,3707,8476100,2287,-1211800,anv
2024-05-28,892,1724800,1933.63,1040,1873500,1801,-148700,anv
2024-05-27,759,1273000,1677.21,661,1407200,2129,-134200,anv
2024-05-24,1680,3130500,1863.39,1616,4139900,2562,-1009400,anv
2024-05-23,1234,3256200,2638.74,1672,2479800,1483,776400,anv
2024-05-22,1202,3776000,3141.43,1735,4571100,2635,-795100,anv
2024-05-21,1577,5288500,3353.52,2348,4400600,1874,887900,anv
2024-05-20,1495,6622700,4429.9,2514,4376600,1741,2246100,anv
2024-05-17,1200,3759900,3133.25,1854,3459900,1866,300000,anv
2024-05-16,968,2695400,2784.5,1261,2746700,2178,-51300,anv
2024-05-15,1298,2457700,1893.45,1730,3061200,1769,-603500,anv
2024-05-14,1451,2873900,1980.63,975,1599300,1640,1274600,anv
2024-05-13,1517,2671500,1761.04,819,1722000,2103,949500,anv
2024-05-10,1616,2756700,1705.88,1040,1710700,1645,1046000,anv
2024-05-09,2447,4612600,1885.0,3444,5635700,1636,-1023100,anv
2024-05-08,1501,3473100,2313.86,1683,2623200,1559,849900,anv
2024-05-07,1253,2333400,1862.25,977,1563400,1600,770000,anv
2024-05-06,1166,2712700,2326.5,1325,1761600,1330,951100,anv
2024-05-03,1003,1837400,1831.9,875,1775900,2030,61500,anv
2024-05-02,942,1780800,1890.45,550,1149400,2090,631400,anv
2024-04-26,1181,1822900,1543.52,764,1616600,2116,206300,anv
2024-04-25,1046,1733300,1657.07,648,1481100,2286,252200,anv
2024-04-24,1170,1773600,1515.9,1055,1649500,1564,124100,anv
2024-04-23,1283,1657000,1291.5,847,1846300,2180,-189300,anv
2024-04-22,1292,2000600,1548.45,927,2193100,2366,-192500,anv
2024-04-19,1726,3040200,1761.41,1044,2777800,2661,262400,anv
2024-04-17,1128,1613800,1430.67,1085,2049700,1889,-435900,anv
2024-04-16,2843,5335700,1876.79,1806,3926600,2174,1409100,anv
2024-04-15,2045,3197400,1563.52,1749,4222400,2414,-1025000,anv
2024-04-12,1358,1915800,1410.75,1143,1824100,1596,91700,anv
2024-04-11,2573,2803700,1089.66,1238,2548400,2058,255300,anv
2024-04-10,1366,1631000,1194.0,1072,2131700,1989,-500700,anv
2024-04-09,2492,2980300,1195.95,1316,2767700,2103,212600,anv
2024-04-08,2518,3299100,1310.21,1459,3997700,2740,-698600,anv
2024-04-05,2348,3800100,1618.44,1824,3671800,2013,128300,anv
2024-04-04,1891,2562600,1355.16,1318,2482200,1883,80400,anv
2024-04-03,3435,7032100,2047.19,3658,7552100,2065,-520000,anv
2024-04-02,2886,3607400,1249.97,1243,3215200,2587,392200,anv
2024-04-01,3374,3842900,1138.97,1304,3703800,2840,139100,anv
2024-03-29,1970,2449200,1243.25,1187,2825500,2380,-376300,anv
2024-03-28,2810,5611200,1996.87,3173,6742400,2125,-1131200,anv
2024-03-27,1719,3158200,1837.23,1774,4189300,2361,-1031100,anv
2024-03-26,2121,3162100,1490.85,1275,3309100,2595,-147000,anv
2024-03-25,2869,4231200,1474.8,2054,5903000,2874,-1671800,anv
2024-03-22,2360,4194700,1777.42,2365,4568300,1932,-373600,anv
2024-03-21,2048,3873900,1891.55,2501,4981300,1992,-1107400,anv
2024-03-20,1511,2858800,1891.99,1345,2949600,2193,-90800,anv
2024-03-19,1795,2844800,1584.85,1232,2657200,2157,187600,anv
2024-03-18,4830,8714200,1804.18,2449,7442100,3039,1272100,anv
2024-03-15,3351,4952300,1477.86,1773,4950000,2792,2300,anv
2024-03-14,3454,5471800,1584.19,2080,5973500,2872,-501700,anv
2024-03-13,2205,4481800,2032.56,2723,6160000,2262,-1678200,anv
2024-03-12,2457,4626500,1882.99,1903,4982000,2618,-355500,anv
2024-03-11,2483,4876000,1963.75,3080,6060100,1968,-1184100,anv
2024-03-08,2872,5382100,1873.99,2291,5638500,2461,-256400,anv
2024-03-07,1983,4210400,2123.25,2217,4866300,2195,-655900,anv
2024-03-06,2230,3803500,1705.61,1567,3927100,2506,-123600,anv
2024-03-05,2047,4036300,1971.81,2264,4566000,2017,-529700,anv
2024-03-04,2684,4676900,1742.51,1978,5536000,2799,-859100,anv
2024-03-01,1740,3342700,1921.09,1626,4052400,2492,-709700,anv
2024-02-29,2927,6042100,2064.26,2948,6428700,2181,-386600,anv
2024-02-28,3182,5562000,1747.96,2464,5740400,2330,-178400,anv
2024-02-27,3193,7390400,2314.56,4225,8010600,1896,-620200,anv
2024-02-26,3530,13037800,3693.43,3664,8455200,2308,4582600,anv
2024-02-23,2936,5721800,1948.84,3878,8780100,2264,-3058300,anv
2024-02-22,1687,3596300,2131.77,1712,4069600,2377,-473300,anv
2024-02-21,1946,2659900,1366.86,988,4266600,4318,-1606700,anv
2024-02-20,1781,2212900,1242.5,1157,2931800,2534,-718900,anv
2024-02-19,1237,2736200,2211.96,1934,4264200,2205,-1528000,anv
2024-02-16,1547,2734900,1767.87,1311,3101300,2366,-366400,anv
2024-02-15,1447,3390700,2343.26,1614,3182000,1971,208700,anv
2024-02-07,0,0,0.0,0,0,0,0,anv
2024-02-06,1120,2540600,2268.39,1471,2870500,1951,-329900,anv
2024-02-05,1024,2069400,2020.9,799,2580900,3230,-511500,anv
2024-02-02,799,1474900,1845.93,1028,2285200,2223,-810300,anv
2024-02-01,846,1725900,2040.07,1377,2721900,1977,-996000,anv
2024-01-31,957,2449900,2559.98,1533,3160500,2062,-710600,anv
2024-01-30,998,2143000,2147.29,1458,4085900,2802,-1942900,anv
2024-01-29,1218,3005100,2467.24,1346,2655900,1973,349200,anv
2024-01-26,1316,2403000,1825.99,963,1981200,2057,421800,anv
2024-01-25,3026,4492200,1484.53,1268,3998400,3153,493800,anv
2024-01-24,2581,3248600,1258.66,1085,3052400,2813,196200,anv
2024-01-23,1362,2382400,1749.19,1157,2509900,2169,-127500,anv
2024-01-22,1317,2037200,1546.85,850,1831800,2155,205400,anv
2024-01-19,924,1635900,1770.45,1084,2629100,2425,-993200,anv
2024-01-18,1298,2083700,1605.32,1130,1735000,1535,348700,anv
2024-01-17,1163,2188600,1881.86,1070,2255100,2108,-66500,anv
2024-01-16,1739,2306800,1326.51,1218,2068400,1698,238400,anv
2024-01-15,1382,1823000,1319.1,871,2428300,2788,-605300,anv
2024-01-12,2688,3818500,1420.57,1521,4738500,3115,-920000,anv
2024-01-11,1302,1744600,1339.94,958,2349200,2452,-604600,anv
2024-01-10,0,0,0.0,0,0,0,0,anv
2024-01-09,1369,2256500,1648.28,1329,3054000,2298,-797500,anv
2024-01-08,1379,2313300,1677.52,1340,2937500,2192,-624200,anv
2024-01-05,2051,5200800,2535.74,1865,3977600,2133,1223200,anv
2024-01-04,1635,2753200,1683.91,1400,3982400,2845,-1229200,anv
2024-01-03,1516,3482000,2296.83,1883,3878800,2060,-396800,anv
2024-01-02,1026,1802100,1756.43,1083,3075600,2840,-1273500,anv
2024-09-12,16,7500,468.75,7,6800,971,700,apc
2024-09-11,13,8300,638.46,10,11900,1190,-3600,apc
2024-09-10,13,6100,469.23,7,6500,929,-400,apc
2024-09-09,17,5400,317.65,7,10000,1429,-4600,apc
2024-09-06,18,7400,411.11,13,20400,1569,-13000,apc
2024-09-05,9,3100,344.44,13,8600,662,-5500,apc
2024-09-04,21,11000,523.81,20,18000,900,-7000,apc
2024-08-30,22,13500,613.64,19,88300,4647,-74800,apc
2024-08-29,18,7100,394.44,13,16400,1262,-9300,apc
2024-08-28,11,5700,518.18,11,11900,1082,-6200,apc
2024-08-27,12,6300,525.0,12,7000,583,-700,apc
2024-08-26,24,19500,812.5,18,48700,2706,-29200,apc
2024-08-23,25,15700,628.0,16,13100,819,2600,apc
2024-08-22,21,10500,500.0,21,37200,1771,-26700,apc
2024-08-21,19,9200,484.21,11,25600,2327,-16400,apc
2024-08-20,14,9400,671.43,14,42700,3050,-33300,apc
2024-08-19,19,12100,636.84,13,10000,769,2100,apc
2024-08-16,22,24500,1113.64,10,16900,1690,7600,apc
2024-08-15,12,20900,1741.67,8,12300,1538,8600,apc
2024-08-14,13,22000,1692.31,14,14400,1029,7600,apc
2024-08-13,17,21500,1264.71,13,11400,877,10100,apc
2024-08-12,10,27100,2710.0,17,29800,1753,-2700,apc
2024-08-09,30,29400,980.0,16,10300,644,19100,apc
2024-08-08,25,40300,1612.0,8,10400,1300,29900,apc
2024-08-07,18,24700,1372.22,9,7300,811,17400,apc
2024-08-06,12,22500,1875.0,14,16700,1193,5800,apc
2024-08-05,15,25200,1680.0,16,6300,394,18900,apc
2024-08-02,27,31800,1177.78,27,18400,681,13400,apc
2024-08-01,22,26600,1209.09,20,17000,850,9600,apc
2024-07-31,25,31400,1256.0,34,20000,588,11400,apc
2024-07-30,15,22800,1520.0,15,9500,633,13300,apc
2024-07-29,21,27100,1290.48,18,8700,483,18400,apc
2024-07-26,21,28200,1342.86,21,16200,771,12000,apc
2024-07-25,22,28400,1290.91,17,4000,235,24400,apc
2024-07-24,26,30700,1180.77,15,11500,767,19200,apc
2024-07-23,19,27800,1463.16,23,16600,722,11200,apc
2024-07-22,16,25600,1600.0,10,5600,560,20000,apc
2024-07-19,20,29600,1480.0,8,10500,1312,19100,apc
2024-07-18,27,20800,770.37,12,9700,808,11100,apc
2024-07-17,14,6500,464.29,16,13400,838,-6900,apc
2024-07-16,14,9200,657.14,13,10100,777,-900,apc
2024-07-15,18,11300,627.78,13,10100,777,1200,apc
2024-07-12,13,4500,346.15,9,5200,578,-700,apc
2024-07-11,21,12400,590.48,9,9300,1033,3100,apc
2024-07-10,19,18100,952.63,15,8400,560,9700,apc
2024-07-09,13,16600,1276.92,15,29200,1947,-12600,apc
2024-07-08,23,9600,417.39,14,10000,714,-400,apc
2024-07-05,25,22500,900.0,21,17500,833,5000,apc
2024-07-04,14,9800,700.0,14,9800,700,0,apc
2024-07-03,7,11000,1571.43,13,8900,685,2100,apc
2024-07-02,16,11100,693.75,14,7600,543,3500,apc
2024-07-01,18,11400,633.33,15,12800,853,-1400,apc
2024-06-28,26,20300,780.77,23,14200,617,6100,apc
2024-06-27,21,15200,723.81,23,21500,935,-6300,apc
2024-06-26,29,13800,475.86,33,15100,458,-1300,apc
2024-06-25,29,15500,534.48,41,56800,1385,-41300,apc
2024-06-24,60,70700,1178.33,40,46300,1158,24400,apc
2024-06-21,44,68100,1547.73,24,57500,2396,10600,apc
2024-06-20,23,11100,482.61,30,12300,410,-1200,apc
2024-06-19,39,11100,284.62,28,17000,607,-5900,apc
2024-06-18,31,26200,845.16,33,14400,436,11800,apc
2024-06-17,33,38900,1178.79,38,16000,421,22900,apc
2024-06-14,28,48800,1742.86,30,13800,460,35000,apc
2024-06-13,36,59900,1663.89,29,20000,690,39900,apc
2024-06-12,18,39800,2211.11,27,14600,541,25200,apc
2024-06-11,26,44400,1707.69,24,13900,579,30500,apc
2024-06-10,30,43300,1443.33,28,13200,471,30100,apc
2024-06-07,22,34800,1581.82,25,12500,500,22300,apc
2024-06-06,30,38100,1270.0,28,11700,418,26400,apc
2024-06-05,44,61300,1393.18,33,34000,1030,27300,apc
2024-06-04,35,49400,1411.43,32,28700,897,20700,apc
2024-06-03,28,37100,1325.0,28,16400,586,20700,apc
2024-05-31,27,40800,1511.11,23,16200,704,24600,apc
2024-05-30,26,44900,1726.92,24,27800,1158,17100,apc
2024-05-29,47,49500,1053.19,36,21100,586,28400,apc
2024-05-28,39,26400,676.92,37,21200,573,5200,apc
2024-05-27,30,51500,1716.67,36,20300,564,31200,apc
2024-05-24,34,32400,952.94,34,17800,524,14600,apc
2024-05-23,27,29800,1103.7,21,33200,1581,-3400,apc
2024-05-22,38,25900,681.58,38,20100,529,5800,apc
2024-05-21,33,28600,866.67,35,29300,837,-700,apc
2024-05-20,16,16900,1056.25,35,19700,563,-2800,apc
2024-05-17,43,49000,1139.53,55,36800,669,12200,apc
2024-05-16,36,25900,719.44,41,27800,678,-1900,apc
2024-05-15,100,78900,789.0,77,57000,740,21900,apc
2024-04-26,38,43900,1155.26,35,29600,846,14300,apc
2024-04-25,24,35700,1487.5,24,30800,1283,4900,apc
2024-04-24,17,21700,1276.47,33,37600,1139,-15900,apc
2024-04-23,39,71500,1833.33,40,49500,1238,22000,apc
2024-04-22,57,90000,1578.95,36,49200,1367,40800,apc
2024-04-19,30,49400,1646.67,39,43200,1108,6200,apc
2024-04-17,63,130600,2073.02,33,28700,870,101900,apc
2024-04-16,31,47100,1519.35,42,36600,871,10500,apc
2024-04-15,163,151700,930.67,184,131800,716,19900,apc
2024-04-12,109,119500,1096.33,47,37300,794,82200,apc
2024-04-11,102,167900,1646.08,36,36800,1022,131100,apc
2024-04-10,97,208900,2153.61,63,57600,914,151300,apc
2024-04-09,50,58400,1168.0,54,55000,1019,3400,apc
2024-04-08,80,99400,1242.5,80,53200,665,46200,apc
2024-04-05,65,114200,1756.92,67,102800,1534,11400,apc
2024-04-04,56,80000,1428.57,54,86300,1598,-6300,apc
2024-04-03,121,105500,871.9,74,56100,758,49400,apc
2024-04-02,166,94200,567.47,123,146200,1189,-52000,apc
2024-04-01,80,48700,608.75,44,133600,3036,-84900,apc
2024-03-29,66,33600,509.09,46,25900,563,7700,apc
2024-03-28,59,26900,455.93,34,20500,603,6400,apc
2024-03-27,100,65300,653.0,99,103800,1048,-38500,apc
2024-03-26,72,20100,279.17,34,13000,382,7100,apc
2024-03-25,93,37300,401.08,32,34600,1081,2700,apc
2024-03-22,78,42500,544.87,39,23000,590,19500,apc
2024-03-21,47,16500,351.06,34,37900,1115,-21400,apc
2024-03-20,34,8000,235.29,30,7300,243,700,apc
2024-03-19,43,12300,286.05,21,15500,738,-3200,apc
2024-03-18,52,20600,396.15,25,22200,888,-1600,apc
2024-03-15,31,9000,290.32,23,20700,900,-11700,apc
2024-03-14,55,21300,387.27,35,47700,1363,-26400,apc
2024-03-13,47,19700,419.15,27,30800,1141,-11100,apc
2024-03-12,41,11600,282.93,24,50300,2096,-38700,apc
2024-03-11,27,7000,259.26,24,31500,1312,-24500,apc
2024-03-08,28,8200,292.86,32,35400,1106,-27200,apc
2024-03-07,29,13700,472.41,24,28800,1200,-15100,apc
2024-03-06,39,14000,358.97,37,19900,538,-5900,apc
2024-03-05,41,26500,646.34,37,40200,1086,-13700,apc
2024-03-04,45,10500,233.33,22,37700,1714,-27200,apc
2024-03-01,47,23100,491.49,26,98400,3785,-75300,apc
2024-02-29,26,11200,430.77,25,16300,652,-5100,apc
2024-02-28,88,49500,562.5,81,141600,1748,-92100,apc
2024-02-27,66,49200,745.45,42,63200,1505,-14000,apc
2024-02-26,39,12000,307.69,41,53400,1302,-41400,apc
2024-02-23,47,28300,602.13,28,49800,1779,-21500,apc
2024-02-22,32,12300,384.38,23,43900,1909,-31600,apc
2024-02-21,50,29700,594.0,28,46400,1657,-16700,apc
2024-02-20,46,14600,317.39,33,17500,530,-2900,apc
2024-02-19,64,18900,295.31,41,17400,424,1500,apc
2024-02-16,47,48300,1027.66,24,12400,517,35900,apc
2024-02-15,16,5800,362.5,17,4900,288,900,apc
2024-02-07,0,0,0.0,0,0,0,0,apc
2024-02-06,24,14900,620.83,24,12900,538,2000,apc
2024-02-05,35,15700,448.57,35,19200,549,-3500,apc
2024-02-02,52,28200,542.31,61,38900,638,-10700,apc
2024-02-01,53,35400,667.92,61,115900,1900,-80500,apc
2024-01-31,63,22600,358.73,55,21600,393,1000,apc
2024-01-30,50,44000,880.0,57,42300,742,1700,apc
2024-01-29,64,23300,364.06,56,46300,827,-23000,apc
2024-01-26,81,53300,658.02,67,101800,1519,-48500,apc
2024-01-25,102,94100,922.55,71,90300,1272,3800,apc
2024-01-24,100,85200,852.0,60,95200,1587,-10000,apc
2024-01-23,71,68400,963.38,47,67800,1443,600,apc
2024-01-22,80,39700,496.25,29,49200,1697,-9500,apc
2024-01-19,48,20100,418.75,14,9900,707,10200,apc
2024-01-18,30,9800,326.67,10,9600,960,200,apc
2024-01-17,18,7700,427.78,16,13800,862,-6100,apc
2024-01-16,16,4200,262.5,21,14500,690,-10300,apc
2024-01-15,18,8600,477.78,18,15100,839,-6500,apc
2024-01-12,18,7700,427.78,23,9000,391,-1300,apc
2024-01-11,15,11000,733.33,23,21500,935,-10500,apc
2024-01-10,0,0,0.0,0,0,0,0,apc
2024-01-09,31,40900,1319.35,20,10800,540,30100,apc
2024-01-08,28,18200,650.0,36,28400,789,-10200,apc
2024-01-05,29,10500,362.07,12,10100,842,400,apc
2024-01-04,33,13900,421.21,29,20900,721,-7000,apc
2024-01-03,34,12200,358.82,24,11900,496,300,apc
2024-01-02,22,4400,200.0,17,12200,718,-7800,apc
2024-09-12,589,612900,1040.58,339,799800,2359,-186900,apg
2024-09-11,177,151000,853.11,74,183900,2485,-32900,apg
2024-09-10,194,168500,868.56,132,419400,3177,-250900,apg
2024-09-09,137,224300,1637.23,94,192400,2047,31900,apg
2024-09-06,144,320700,2227.08,188,197500,1051,123200,apg
2024-09-05,180,291900,1621.67,93,188000,2022,103900,apg
2024-09-04,198,305400,1542.42,156,255700,1639,49700,apg
2024-08-30,128,318800,2490.62,103,195900,1902,122900,apg
2024-08-29,208,425400,2045.19,119,262800,2208,162600,apg
2024-08-28,256,440300,1719.92,143,299600,2095,140700,apg
2024-08-27,350,631200,1803.43,253,635600,2512,-4400,apg
2024-08-26,209,183300,877.03,126,252800,2006,-69500,apg
2024-08-23,188,174000,925.53,150,199700,1331,-25700,apg
2024-08-22,146,142100,973.29,153,327000,2137,-184900,apg
2024-08-21,175,126200,721.14,198,495600,2503,-369400,apg
2024-08-20,150,166700,1111.33,192,370900,1932,-204200,apg
2024-08-19,107,158000,1476.64,160,220000,1375,-62000,apg
2024-08-16,262,406200,1550.38,273,335300,1228,70900,apg
2024-08-15,152,154400,1015.79,159,265500,1670,-111100,apg
2024-08-14,203,119600,589.16,223,309200,1387,-189600,apg
2024-08-13,283,368700,1302.83,319,545600,1710,-176900,apg
2024-08-12,215,385600,1793.49,180,190500,1058,195100,apg
2024-08-08,72,59100,820.83,71,74000,1042,-14900,apg
2024-08-07,150,180600,1204.0,120,320700,2672,-140100,apg
2024-08-06,117,73200,625.64,144,173600,1206,-100400,apg
2024-08-05,186,177900,956.45,176,383500,2179,-205600,apg
2024-08-02,139,104700,753.24,138,219400,1590,-114700,apg
2024-08-01,138,82700,599.28,130,201000,1546,-118300,apg
2024-07-31,87,52500,603.45,99,91100,920,-38600,apg
2024-07-30,85,41300,485.88,77,103400,1343,-62100,apg
2024-07-29,92,110600,1202.17,75,73400,979,37200,apg
2024-07-26,164,120400,734.15,123,125800,1023,-5400,apg
2024-07-25,89,216700,2434.83,90,95000,1056,121700,apg
2024-07-24,144,158000,1097.22,124,179600,1448,-21600,apg
2024-07-22,342,636400,1860.82,296,694300,2346,-57900,apg
2024-07-19,226,254800,1127.43,145,353400,2437,-98600,apg
2024-07-18,82,55700,679.27,106,209000,1972,-153300,apg
2024-07-17,69,50000,724.64,158,173100,1096,-123100,apg
2024-07-16,53,53900,1016.98,142,166300,1171,-112400,apg
2024-07-15,90,117100,1301.11,144,229700,1595,-112600,apg
2024-07-12,107,137700,1286.92,116,209300,1804,-71600,apg
2024-07-11,84,93700,1115.48,153,266600,1742,-172900,apg
2024-07-10,115,113200,984.35,148,275900,1864,-162700,apg
2024-07-09,106,169000,1594.34,179,272800,1524,-103800,apg
2024-07-08,132,96000,727.27,114,196900,1727,-100900,apg
2024-07-05,199,158600,796.98,127,246800,1943,-88200,apg
2024-07-04,76,88200,1160.53,125,224500,1796,-136300,apg
2024-07-03,104,117500,1129.81,114,120500,1057,-3000,apg
2024-07-02,111,85800,772.97,81,124400,1536,-38600,apg
2024-07-01,125,105800,846.4,85,181300,2133,-75500,apg
2024-06-28,182,164700,904.95,142,221000,1556,-56300,apg
2024-06-27,166,270900,1631.93,253,485400,1919,-214500,apg
2024-06-26,231,602600,2608.66,307,435000,1417,167600,apg
2024-06-25,170,166200,977.65,126,112200,890,54000,apg
2024-06-24,287,276300,962.72,190,336900,1773,-60600,apg
2024-06-21,130,128800,990.77,177,272600,1540,-143800,apg
2024-06-20,141,160900,1141.13,116,188800,1628,-27900,apg
2024-06-19,123,93300,758.54,112,167000,1491,-73700,apg
2024-06-18,152,146800,965.79,128,271700,2123,-124900,apg
2024-06-17,278,280300,1008.27,227,607000,2674,-326700,apg
2024-06-14,152,188200,1238.16,223,372700,1671,-184500,apg
2024-06-13,251,198000,788.84,209,411900,1971,-213900,apg
2024-06-12,181,239500,1323.2,256,518100,2024,-278600,apg
2024-06-11,161,156200,970.19,195,344500,1767,-188300,apg
2024-06-10,152,149300,982.24,145,337400,2327,-188100,apg
2024-06-07,184,142800,776.09,158,317500,2009,-174700,apg
2024-06-06,169,163300,966.27,169,186400,1103,-23100,apg
2024-06-05,186,163000,876.34,204,342800,1680,-179800,apg
2024-06-04,184,148700,808.15,231,283200,1226,-134500,apg
2024-06-03,157,209900,1336.94,177,262600,1484,-52700,apg
2024-05-31,157,167600,1067.52,232,328800,1417,-161200,apg
2024-05-30,201,664500,3305.97,164,697600,4254,-33100,apg
2024-05-29,206,219900,1067.48,127,212000,1669,7900,apg
2024-05-28,286,347800,1216.08,127,432100,3402,-84300,apg
2024-05-27,188,148600,790.43,154,349600,2270,-201000,apg
2024-05-24,369,528700,1432.79,290,519200,1790,9500,apg
2024-05-23,273,280800,1028.57,175,449800,2570,-169000,apg
2024-05-22,208,295400,1420.19,360,600300,1668,-304900,apg
2024-05-21,126,115800,919.05,171,401600,2349,-285800,apg
2024-05-20,284,445700,1569.37,209,450900,2157,-5200,apg
2024-05-17,199,268900,1351.26,248,513000,2069,-244100,apg
2024-05-16,164,279900,1706.71,297,572800,1929,-292900,apg
2024-05-15,220,539200,2450.91,285,548800,1926,-9600,apg
2024-05-14,142,235700,1659.86,181,364500,2014,-128800,apg
2024-05-13,246,806800,3279.67,187,1001900,5358,-195100,apg
2024-05-10,248,327800,1321.77,153,408100,2667,-80300,apg
2024-05-09,457,1372300,3002.84,443,1992900,4499,-620600,apg
2024-05-08,212,744100,3509.91,352,986900,2804,-242800,apg
2024-05-07,185,479500,2591.89,229,282500,1234,197000,apg
2024-05-06,195,597000,3061.54,173,485100,2804,111900,apg
2024-05-03,150,372900,2486.0,152,215000,1414,157900,apg
2024-05-02,155,235100,1516.77,143,337700,2362,-102600,apg
2024-04-26,160,346100,2163.12,216,404300,1872,-58200,apg
2024-04-25,98,170100,1735.71,203,366700,1806,-196600,apg
2024-04-24,248,460000,1854.84,284,455200,1603,4800,apg
2024-04-23,185,330200,1784.86,243,536100,2206,-205900,apg
2024-04-22,482,1004900,2084.85,368,1171200,3183,-166300,apg
2024-04-19,354,597800,1688.7,378,2232300,5906,-1634500,apg
2024-04-17,166,306300,1845.18,315,704900,2238,-398600,apg
2024-04-16,227,602000,2651.98,412,838100,2034,-236100,apg
2024-04-15,217,501800,2312.44,337,789300,2342,-287500,apg
2024-04-12,173,558100,3226.01,240,1567200,6530,-1009100,apg
2024-04-11,108,266900,2471.3,159,441700,2778,-174800,apg
2024-04-10,86,212700,2473.26,211,402300,1907,-189600,apg
2024-04-09,151,361900,2396.69,183,588600,3216,-226700,apg
2024-04-08,178,443400,2491.01,207,487400,2355,-44000,apg
2024-04-05,141,382100,2709.93,251,547400,2181,-165300,apg
2024-04-04,130,393000,3023.08,247,560400,2269,-167400,apg
2024-04-03,175,340900,1948.0,197,569600,2891,-228700,apg
2024-04-02,165,346800,2101.82,201,454100,2259,-107300,apg
2024-04-01,200,363000,1815.0,402,607200,1510,-244200,apg
2024-03-29,167,379200,2270.66,264,553800,2098,-174600,apg
2024-03-28,189,425900,2253.44,365,664200,1820,-238300,apg
2024-03-27,188,403700,2147.34,391,650700,1664,-247000,apg
2024-03-26,307,643300,2095.44,381,725100,1903,-81800,apg
2024-03-25,475,1062100,2236.0,634,1655900,2612,-593800,apg
2024-03-22,287,635900,2215.68,503,1256600,2498,-620700,apg
2024-03-21,370,727900,1967.3,702,1659800,2364,-931900,apg
2024-03-20,330,815000,2469.7,662,1052300,1590,-237300,apg
2024-03-19,262,809400,3089.31,599,1302600,2175,-493200,apg
2024-03-18,624,1237200,1982.69,660,1492600,2262,-255400,apg
2024-03-15,488,1259900,2581.76,634,1270500,2004,-10600,apg
2024-03-14,568,1586600,2793.31,842,1605200,1906,-18600,apg
2024-03-13,261,658400,2522.61,454,952000,2097,-293600,apg
2024-03-12,330,818500,2480.3,382,1118500,2928,-300000,apg
2024-03-11,217,531000,2447.0,350,996300,2847,-465300,apg
2024-03-08,343,754100,2198.54,508,911900,1795,-157800,apg
2024-03-07,361,771800,2137.95,480,1186800,2472,-415000,apg
2024-03-06,240,453500,1889.58,437,835000,1911,-381500,apg
2024-03-05,257,532200,2070.82,417,802500,1924,-270300,apg
2024-03-04,468,1166600,2492.74,690,1827600,2649,-661000,apg
2024-03-01,222,621100,2797.75,502,1200400,2391,-579300,apg
2024-02-29,248,486600,1962.1,477,1007000,2111,-520400,apg
2024-02-28,162,529800,3270.37,458,908300,1983,-378500,apg
2024-02-27,234,407300,1740.6,480,1006100,2096,-598800,apg
2024-02-26,331,713100,2154.38,452,893400,1977,-180300,apg
2024-02-23,432,1362400,3153.7,529,1780400,3366,-418000,apg
2024-02-22,257,724000,2817.12,406,989800,2438,-265800,apg
2024-02-21,732,2001900,2734.84,414,1142200,2759,859700,apg
2024-02-20,271,611200,2255.35,466,1137200,2440,-526000,apg
2024-02-19,619,1561900,2523.26,795,2161900,2719,-600000,apg
2024-02-16,212,441800,2083.96,575,1526500,2655,-1084700,apg
2024-02-15,346,852200,2463.01,741,1440900,1945,-588700,apg
2024-02-07,0,0,0.0,0,0,0,0,apg
2024-02-06,329,1008300,3064.74,484,1269600,2623,-261300,apg
2024-02-05,378,933200,2468.78,658,1610100,2447,-676900,apg
2024-02-02,252,1011400,4013.49,594,1683700,2835,-672300,apg
2024-02-01,233,751500,3225.32,350,1187100,3392,-435600,apg
2024-01-31,216,555200,2570.37,472,1132200,2399,-577000,apg
2024-01-30,155,374500,2416.13,330,791300,2398,-416800,apg
2024-01-29,201,516500,2569.65,455,1131400,2487,-614900,apg
2024-01-26,200,533700,2668.5,470,1137400,2420,-603700,apg
2024-01-25,160,375300,2345.62,416,1059500,2547,-684200,apg
2024-01-24,330,798300,2419.09,708,1699500,2400,-901200,apg
2024-01-23,469,1298900,2769.51,776,1949800,2513,-650900,apg
2024-01-22,246,704100,2862.2,422,1222800,2898,-518700,apg
2024-01-19,199,627300,3152.26,568,1508800,2656,-881500,apg
2024-01-18,237,538300,2271.31,546,1537700,2816,-999400,apg
2024-01-17,730,2353400,3223.84,960,3023500,3149,-670100,apg
2024-01-16,264,697600,2642.42,318,770100,2422,-72500,apg
2024-01-15,149,370600,2487.25,325,901100,2773,-530500,apg
2024-01-12,426,1076700,2527.46,561,1442000,2570,-365300,apg
2024-01-11,223,575300,2579.82,473,1018200,2153,-442900,apg
2024-01-10,0,0,0.0,0,0,0,0,apg
2024-01-09,224,636600,2841.96,511,1164700,2279,-528100,apg
2024-01-08,356,1054300,2961.52,542,1575800,2907,-521500,apg
2024-01-05,283,979900,3462.54,475,1282300,2700,-302400,apg
2024-01-04,327,1134800,3470.34,616,1449700,2353,-314900,apg
2024-01-03,390,1046500,2683.33,288,814800,2829,231700,apg
2024-01-02,548,1656200,3022.26,555,2270400,4091,-614200,apg
2024-09-12,415,1072700,2584.82,297,895100,3014,177600,api
2024-09-11,594,1211500,2039.56,309,1097300,3551,114200,api
2024-09-10,1036,2180600,2104.83,499,2226200,4461,-45600,api
2024-09-09,366,593200,1620.77,267,696700,2609,-103500,api
2024-09-06,493,1054800,2139.55,330,927300,2810,127500,api
2024-09-05,848,1794200,2115.8,525,1829400,3485,-35200,api
2024-09-04,571,1326000,2322.24,435,1464700,3367,-138700,api
2024-08-30,476,907400,1906.3,414,1201000,2901,-293600,api
2024-08-29,700,1782900,2547.0,918,2328400,2536,-545500,api
2024-08-28,602,1300000,2159.47,461,1309000,2839,-9000,api
2024-08-27,517,1263900,2444.68,446,1336500,2997,-72600,api
2024-08-26,731,1665600,2278.52,550,1887500,3432,-221900,api
2024-08-23,1187,3550300,2990.99,1283,3882200,3026,-331900,api
2024-08-22,959,3999500,4170.49,775,2210000,2852,1789500,api
2024-08-21,473,809400,1711.21,523,1679600,3211,-870200,api
2024-08-20,709,1896500,2674.89,609,2069200,3398,-172700,api
2024-08-19,399,1002300,2512.03,413,1611600,3902,-609300,api
2024-08-16,434,1558600,3591.24,547,1918300,3507,-359700,api
2024-08-15,289,751300,2599.65,260,1106700,4257,-355400,api
2024-08-14,295,959500,3252.54,284,1256200,4423,-296700,api
2024-08-13,369,1094800,2966.94,345,1168700,3388,-73900,api
2024-08-12,280,774900,2767.5,287,906800,3160,-131900,api
2024-08-09,318,1036400,3259.12,427,1210000,2834,-173600,api
2024-08-08,542,1488900,2747.05,376,1474000,3920,14900,api
2024-08-07,379,1176700,3104.75,438,1593400,3638,-416700,api
2024-08-06,601,1566600,2606.66,599,1653200,2760,-86600,api
2024-08-05,801,1459400,1821.97,530,2152900,4062,-693500,api
2024-08-02,828,1641200,1982.13,504,1751300,3475,-110100,api
2024-08-01,1092,2169300,1986.54,525,2575700,4906,-406400,api
2024-07-31,464,751600,1619.83,499,1870200,3748,-1118600,api
2024-07-30,800,3061100,3826.38,870,2664800,3063,396300,api
2024-07-29,302,1047800,3469.54,364,1121100,3080,-73300,api
2024-07-26,329,675700,2053.8,358,868100,2425,-192400,api
2024-07-25,287,845900,2947.39,275,850000,3091,-4100,api
2024-07-24,504,1089300,2161.31,337,1007900,2991,81400,api
2024-07-23,282,531600,1885.11,271,732700,2704,-201100,api
2024-07-22,724,1252800,1730.39,399,1390700,3485,-137900,api
2024-07-19,457,916600,2005.69,466,1406900,3019,-490300,api
2024-07-18,558,1341700,2404.48,502,1578200,3144,-236500,api
2024-07-17,758,1756300,2317.02,680,2267300,3334,-511000,api
2024-07-16,448,1374100,3067.19,673,2089600,3105,-715500,api
2024-07-15,821,1668300,2032.03,849,2425400,2857,-757100,api
2024-07-12,658,1986400,3018.84,498,1184600,2379,801800,api
2024-07-11,371,564700,1522.1,323,943200,2920,-378500,api
2024-07-10,555,811100,1461.44,339,1277300,3768,-466200,api
2024-07-09,539,1123600,2084.6,407,1332500,3274,-208900,api
2024-07-08,583,1032000,1770.15,459,1440800,3139,-408800,api
2024-07-05,370,561700,1518.11,332,816600,2460,-254900,api
2024-07-04,566,952700,1683.22,354,1117100,3156,-164400,api
2024-07-03,357,771300,2160.5,240,855000,3562,-83700,api
2024-07-02,437,812400,1859.04,345,925000,2681,-112600,api
2024-07-01,414,726900,1755.8,272,699300,2571,27600,api
2024-06-28,701,1247600,1779.74,387,1626000,4202,-378400,api
2024-06-27,552,997200,1806.52,372,1552000,4172,-554800,api
2024-06-26,687,1214500,1767.83,435,1343400,3088,-128900,api
2024-06-25,587,1112900,1895.91,431,1288700,2990,-175800,api
2024-06-24,956,1925000,2013.6,674,2731200,4052,-806200,api
2024-06-21,1002,3200200,3193.81,847,2726400,3219,473800,api
2024-06-20,949,1482200,1561.85,631,2006000,3179,-523800,api
2024-06-19,1034,1659000,1604.45,683,2334100,3417,-675100,api
2024-06-18,680,1373400,2019.71,710,2058500,2899,-685100,api
2024-06-17,791,2318500,2931.1,905,2057900,2274,260600,api
2024-06-14,2009,3873200,1927.92,944,3586900,3800,286300,api
2024-06-13,943,1714000,1817.6,601,2468600,4107,-754600,api
2024-06-12,906,1616300,1784.0,804,1970200,2450,-353900,api
2024-06-11,1102,1699800,1542.47,704,2281500,3241,-581700,api
2024-06-10,994,1691900,1702.11,851,2448400,2877,-756500,api
2024-06-07,1653,3108300,1880.4,799,3022700,3783,85600,api
2024-06-06,1144,2067300,1807.08,1002,2477200,2472,-409900,api
2024-06-05,1375,3231700,2350.33,758,2427200,3202,804500,api
2024-06-04,2136,3804700,1781.23,1103,5048400,4577,-1243700,api
2024-06-03,1534,2742400,1787.74,1170,4429300,3786,-1686900,api
2024-05-31,954,1292300,1354.61,749,2173000,2901,-880700,api
2024-05-30,2516,6384800,2537.68,1890,6669600,3529,-284800,api
2024-05-29,1057,2105200,1991.67,764,4505900,5898,-2400700,api
2024-05-28,835,1675200,2006.23,223,686800,3080,988400,api
2024-05-27,699,1963100,2808.44,338,1064500,3149,898600,api
2024-05-24,1217,3585200,2945.93,992,3043800,3068,541400,api
2024-05-23,1590,4196600,2639.37,1182,3608800,3053,587800,api
2024-05-22,1257,4659900,3707.16,738,4080900,5530,579000,api
2024-05-21,682,2514500,3686.95,438,1524600,3481,989900,api
2024-05-20,853,3285200,3851.35,580,2020500,3484,1264700,api
2024-05-17,605,3252500,5376.03,343,2293000,6685,959500,api
2024-05-16,527,1362300,2585.01,518,2502400,4831,-1140100,api
2024-05-15,1153,4922900,4269.64,519,3984200,7677,938700,api
2024-05-14,742,2863000,3858.49,87,181300,2084,2681700,api
2024-05-13,666,3134700,4706.76,82,465200,5673,2669500,api
2024-05-10,183,625300,3416.94,187,1127700,6030,-502400,api
2024-05-09,395,1538900,3895.95,193,1144900,5932,394000,api
2024-05-08,143,320400,2240.56,172,543800,3162,-223400,api
2024-05-07,126,420300,3335.71,137,448100,3271,-27800,api
2024-05-06,173,285600,1650.87,119,442400,3718,-156800,api
2024-05-03,122,155500,1274.59,111,409800,3692,-254300,api
2024-05-02,115,232200,2019.13,103,282700,2745,-50500,api
2024-04-26,122,324300,2658.2,157,496400,3162,-172100,api
2024-04-25,202,471700,2335.15,143,414300,2897,57400,api
2024-04-24,158,543300,3438.61,120,395100,3292,148200,api
2024-04-23,246,534000,2170.73,173,677900,3918,-143900,api
2024-04-22,254,540000,2125.98,84,193900,2308,346100,api
2024-04-19,284,633300,2229.93,148,622800,4208,10500,api
2024-04-17,187,452500,2419.79,98,589900,6019,-137400,api
2024-04-16,291,651300,2238.14,186,665700,3579,-14400,api
2024-04-15,389,1006400,2587.15,254,1397700,5503,-391300,api
2024-04-12,214,335600,1568.22,138,436700,3164,-101100,api
2024-04-11,199,350700,1762.31,117,399200,3412,-48500,api
2024-04-10,246,456100,1854.07,133,438000,3293,18100,api
2024-04-09,565,1061300,1878.41,309,1117000,3615,-55700,api
2024-04-08,270,367600,1361.48,179,699800,3909,-332200,api
2024-04-05,320,462900,1446.56,183,909400,4969,-446500,api
2024-04-04,267,511800,1916.85,185,1052500,5689,-540700,api
2024-04-03,314,675800,2152.23,220,1291700,5871,-615900,api
2024-04-02,266,570500,2144.74,189,904700,4787,-334200,api
2024-04-01,197,467000,2370.56,201,964300,4798,-497300,api
2024-03-29,223,611500,2742.15,194,851600,4390,-240100,api
2024-03-28,223,564600,2531.84,197,772700,3922,-208100,api
2024-03-27,207,492300,2378.26,182,751600,4130,-259300,api
2024-03-26,166,510100,3072.89,198,749600,3786,-239500,api
2024-03-25,222,521400,2348.65,259,853400,3295,-332000,api
2024-03-22,268,648900,2421.27,303,922100,3043,-273200,api
2024-03-21,253,771600,3049.8,301,1048500,3483,-276900,api
2024-03-20,192,541200,2818.75,233,922400,3959,-381200,api
2024-03-19,276,788700,2857.61,330,1284300,3892,-495600,api
2024-03-18,361,818300,2266.76,242,995400,4113,-177100,api
2024-03-15,314,912200,2905.1,204,1001700,4910,-89500,api
2024-03-14,250,614700,2458.8,210,788600,3755,-173900,api
2024-03-13,231,610700,2643.72,213,675300,3170,-64600,api
2024-03-12,226,556400,2461.95,182,631600,3470,-75200,api
2024-03-11,208,761600,3661.54,270,1209800,4481,-448200,api
2024-03-08,438,1286100,2936.3,509,2035200,3998,-749100,api
2024-03-07,480,1470900,3064.38,452,1573300,3481,-102400,api
2024-03-06,350,605300,1729.43,231,1087400,4707,-482100,api
2024-03-05,200,365100,1825.5,203,741100,3651,-376000,api
2024-03-04,276,655900,2376.45,272,839600,3087,-183700,api
2024-03-01,311,499500,1606.11,157,702500,4475,-203000,api
2024-02-29,256,458000,1789.06,171,724300,4236,-266300,api
2024-02-28,252,406200,1611.9,178,616700,3465,-210500,api
2024-02-27,247,430600,1743.32,158,640100,4051,-209500,api
2024-02-26,158,345100,2184.18,138,524900,3804,-179800,api
2024-02-23,234,477500,2040.6,240,777100,3238,-299600,api
2024-02-22,246,685500,2786.59,197,810800,4116,-125300,api
2024-02-21,179,581500,3248.6,222,785500,3538,-204000,api
2024-02-20,234,639000,2730.77,207,844200,4078,-205200,api
2024-02-19,253,663600,2622.92,171,582700,3408,80900,api
2024-02-16,155,435900,2812.26,143,562200,3931,-126300,api
2024-02-15,205,291000,1419.51,137,393500,2872,-102500,api
2024-02-07,194,339800,1751.55,106,428300,4041,-88500,api
2024-02-06,336,632800,1883.33,137,778000,5679,-145200,api
2024-02-05,188,417800,2222.34,144,785900,5458,-368100,api
2024-02-02,184,522100,2837.5,188,1044500,5556,-522400,api
2024-02-01,199,406400,2042.21,158,777400,4920,-371000,api
2024-01-31,225,790000,3511.11,278,989900,3561,-199900,api
2024-01-30,150,337600,2250.67,144,668300,4641,-330700,api
2024-01-29,142,438500,3088.03,182,686700,3773,-248200,api
2024-01-26,218,709000,3252.29,195,733700,3763,-24700,api
2024-01-25,186,510500,2744.62,171,769000,4497,-258500,api
2024-01-24,214,528200,2468.22,199,669000,3362,-140800,api
2024-01-23,206,346900,1683.98,166,624000,3759,-277100,api
2024-01-22,180,433700,2409.44,160,586700,3667,-153000,api
2024-01-19,194,521000,2685.57,208,776600,3734,-255600,api
2024-01-18,190,386500,2034.21,152,584800,3847,-198300,api
2024-01-17,272,770600,2833.09,154,1100300,7145,-329700,api
2024-01-16,246,586800,2385.37,150,704200,4695,-117400,api
2024-01-15,222,322800,1454.05,164,678800,4139,-356000,api
2024-01-12,340,653900,1923.24,204,1596400,7825,-942500,api
2024-01-11,174,428900,2464.94,177,1384000,7819,-955100,api
2024-01-10,206,466800,2266.02,177,1230500,6952,-763700,api
2024-01-09,240,550300,2292.92,204,1403400,6879,-853100,api
2024-01-08,147,335800,2284.35,237,691800,2919,-356000,api
2024-01-05,222,630700,2840.99,270,1038600,3847,-407900,api
2024-01-04,241,580400,2408.3,270,1115800,4133,-535400,api
2024-01-03,283,543600,1920.85,211,838600,3974,-295000,api
2024-01-02,214,414400,1936.45,237,798600,3370,-384200,api
2024-09-12,0,0,0.0,0,0,0,0,apl
2024-09-11,0,0,0.0,0,0,0,0,apl
2024-09-10,0,0,0.0,0,0,0,0,apl
2024-09-09,0,0,0.0,0,0,0,0,apl
2024-09-06,1,500,500.0,0,0,0,500,apl
2024-09-05,1,500,500.0,0,0,0,500,apl
2024-09-04,2,5400,2700.0,0,0,0,5400,apl
2024-08-30,6,400,66.67,1,100,100,300,apl
2024-08-29,2,200,100.0,1,100,100,100,apl
2024-08-28,2,300,150.0,1,100,100,200,apl
2024-08-27,0,0,0.0,0,0,0,0,apl
2024-08-26,1,100,100.0,0,0,0,100,apl
2024-08-23,3,1500,500.0,0,0,0,1500,apl
2024-08-22,7,500,71.43,0,0,0,500,apl
2024-08-21,3,400,133.33,1,100,100,300,apl
2024-08-20,1,200,200.0,1,100,100,100,apl
2024-08-19,2,300,150.0,0,0,0,300,apl
2024-08-16,5,1100,220.0,1,500,500,600,apl
2024-08-15,5,3800,760.0,6,3700,617,100,apl
2024-08-14,1,100,100.0,2,1200,600,-1100,apl
2024-08-13,0,0,0.0,3,2100,700,-2100,apl
2024-08-12,0,0,0.0,1,100,100,-100,apl
2024-08-09,0,0,0.0,1,100,100,-100,apl
2024-08-08,0,0,0.0,1,200,200,-200,apl
2024-08-07,0,0,0.0,3,1500,500,-1500,apl
2024-08-06,0,0,0.0,2,1600,800,-1600,apl
2024-08-05,0,0,0.0,2,400,200,-400,apl
2024-08-02,0,0,0.0,2,200,100,-200,apl
2024-08-01,0,0,0.0,2,400,200,-400,apl
2024-07-31,0,0,0.0,3,1700,567,-1700,apl
2024-07-30,0,0,0.0,3,1700,567,-1700,apl
2024-07-29,1,100,100.0,4,1700,425,-1600,apl
2024-07-26,0,0,0.0,4,1500,375,-1500,apl
2024-07-25,0,0,0.0,4,4500,1125,-4500,apl
2024-07-24,0,0,0.0,7,4500,643,-4500,apl
2024-07-23,1,100,100.0,5,1600,320,-1500,apl
2024-07-22,2,100,50.0,4,1600,400,-1500,apl
2024-07-19,0,0,0.0,4,1700,425,-1700,apl
2024-07-18,0,0,0.0,4,1500,375,-1500,apl
2024-07-17,1,0,0.0,5,1100,220,-1100,apl
2024-07-16,1,100,100.0,7,900,129,-800,apl
2024-07-15,1,0,0.0,4,500,125,-500,apl
2024-07-12,3,200,66.67,2,200,100,0,apl
2024-07-11,1,100,100.0,1,100,100,0,apl
2024-07-10,2,100,50.0,1,100,100,0,apl
2024-07-09,1,100,100.0,0,0,0,100,apl
2024-07-08,2,200,100.0,0,0,0,200,apl
2024-07-05,1,100,100.0,0,0,0,100,apl
2024-07-04,0,0,0.0,0,0,0,0,apl
2024-07-03,4,700,175.0,0,0,0,700,apl
2024-07-02,1,100,100.0,0,0,0,100,apl
2024-07-01,1,300,300.0,0,0,0,300,apl
2024-06-28,1,200,200.0,1,200,200,0,apl
2024-06-27,3,300,100.0,2,1400,700,-1100,apl
2024-06-26,1,0,0.0,2,200,100,-200,apl
2024-06-25,1,500,500.0,1,100,100,400,apl
2024-06-24,0,0,0.0,1,500,500,-500,apl
2024-06-21,0,0,0.0,1,300,300,-300,apl
2024-06-20,1,0,0.0,2,700,350,-700,apl
2024-06-19,1,700,700.0,3,1200,400,-500,apl
2024-06-18,2,0,0.0,1,500,500,-500,apl
2024-06-17,1,100,100.0,1,100,100,0,apl
2024-06-14,0,0,0.0,0,0,0,0,apl
2024-06-13,1,100,100.0,1,100,100,0,apl
2024-06-12,0,0,0.0,0,0,0,0,apl
2024-06-11,0,0,0.0,0,0,0,0,apl
2024-06-10,1,0,0.0,1,100,100,-100,apl
2024-06-07,0,0,0.0,0,0,0,0,apl
2024-06-06,2,100,50.0,3,300,100,-200,apl
2024-06-05,2,300,150.0,2,200,100,100,apl
2024-06-04,1,100,100.0,2,200,100,-100,apl
2024-06-03,2,1200,600.0,2,200,100,1000,apl
2024-05-31,0,0,0.0,1,100,100,-100,apl
2024-05-30,0,0,0.0,1,100,100,-100,apl
2024-05-29,1,100,100.0,1,100,100,0,apl
2024-05-28,3,400,133.33,1,100,100,300,apl
2024-05-27,1,100,100.0,1,100,100,0,apl
2024-05-24,1,100,100.0,5,900,180,-800,apl
2024-05-23,0,0,0.0,1,100,100,-100,apl
2024-05-22,0,0,0.0,5,500,100,-500,apl
2024-05-21,0,0,0.0,5,700,140,-700,apl
2024-05-20,0,0,0.0,4,700,175,-700,apl
2024-05-17,1,100,100.0,6,700,117,-600,apl
2024-05-16,0,0,0.0,7,800,114,-800,apl
2024-05-15,1,0,0.0,4,800,200,-800,apl
2024-05-14,1,0,0.0,3,600,200,-600,apl
2024-05-13,1,500,500.0,3,500,167,0,apl
2024-05-10,0,0,0.0,3,600,200,-600,apl
2024-05-09,0,0,0.0,4,500,125,-500,apl
2024-05-08,1,200,200.0,3,400,133,-200,apl
2024-05-07,1,100,100.0,5,600,120,-500,apl
2024-05-06,1,0,0.0,3,500,167,-500,apl
2024-05-03,0,0,0.0,2,300,150,-300,apl
2024-05-02,1,0,0.0,2,300,150,-300,apl
2024-04-26,1,0,0.0,1,200,200,-200,apl
2024-04-25,1,0,0.0,2,300,150,-300,apl
2024-04-24,2,0,0.0,2,300,150,-300,apl
2024-04-23,1,0,0.0,0,0,0,0,apl
2024-04-22,1,200,200.0,0,0,0,200,apl
2024-04-19,1,100,100.0,3,400,133,-300,apl
2024-04-17,2,100,50.0,4,900,225,-800,apl
2024-04-16,2,200,100.0,2,400,200,-200,apl
2024-04-15,3,600,200.0,4,1300,325,-700,apl
2024-04-12,2,200,100.0,3,1000,333,-800,apl
2024-04-11,0,0,0.0,0,0,0,0,apl
2024-04-10,3,700,233.33,6,1600,267,-900,apl
2024-04-09,0,0,0.0,0,0,0,0,apl
2024-04-08,0,0,0.0,0,0,0,0,apl
2024-04-05,6,100,16.67,2,100,50,0,apl
2024-04-04,2,100,50.0,2,800,400,-700,apl
2024-04-03,0,0,0.0,0,0,0,0,apl
2024-04-02,0,0,0.0,0,0,0,0,apl
2024-04-01,1,100,100.0,0,0,0,100,apl
2024-03-29,3,500,166.67,2,1500,750,-1000,apl
2024-03-28,0,0,0.0,0,0,0,0,apl
2024-03-27,1,0,0.0,0,0,0,0,apl
2024-03-26,0,0,0.0,0,0,0,0,apl
2024-03-25,0,0,0.0,0,0,0,0,apl
2024-03-22,1,500,500.0,1,500,500,0,apl
2024-03-21,1,500,500.0,1,500,500,0,apl
2024-03-20,1,500,500.0,1,200,200,300,apl
2024-03-19,0,0,0.0,0,0,0,0,apl
2024-03-18,0,0,0.0,0,0,0,0,apl
2024-03-15,0,0,0.0,0,0,0,0,apl
2024-03-14,0,0,0.0,0,0,0,0,apl
2024-03-13,0,0,0.0,0,0,0,0,apl
2024-03-12,0,0,0.0,0,0,0,0,apl
2024-03-11,0,0,0.0,0,0,0,0,apl
2024-03-08,1,0,0.0,0,0,0,0,apl
2024-03-07,0,0,0.0,0,0,0,0,apl
2024-03-06,0,0,0.0,0,0,0,0,apl
2024-03-05,1,200,200.0,0,0,0,200,apl
2024-03-04,1,200,200.0,1,200,200,0,apl
2024-03-01,0,0,0.0,2,300,150,-300,apl
2024-02-29,0,0,0.0,0,0,0,0,apl
2024-02-28,1,0,0.0,0,0,0,0,apl
2024-02-27,0,0,0.0,1,200,200,-200,apl
2024-02-26,0,0,0.0,0,0,0,0,apl
2024-02-23,0,0,0.0,0,0,0,0,apl
2024-02-22,2,400,200.0,0,0,0,400,apl
2024-02-21,1,200,200.0,0,0,0,200,apl
2024-02-20,0,0,0.0,1,200,200,-200,apl
2024-02-19,0,0,0.0,1,200,200,-200,apl
2024-02-16,0,0,0.0,0,0,0,0,apl
2024-02-15,0,0,0.0,0,0,0,0,apl
2024-02-07,0,0,0.0,0,0,0,0,apl
2024-02-06,0,0,0.0,1,100,100,-100,apl
2024-02-05,1,400,400.0,1,400,400,0,apl
2024-02-02,0,0,0.0,0,0,0,0,apl
2024-02-01,0,0,0.0,0,0,0,0,apl
2024-01-31,0,0,0.0,0,0,0,0,apl
2024-01-30,0,0,0.0,0,0,0,0,apl
2024-01-29,2,300,150.0,0,0,0,300,apl
2024-01-26,2,300,150.0,1,100,100,200,apl
2024-01-25,0,0,0.0,0,0,0,0,apl
2024-01-24,0,0,0.0,0,0,0,0,apl
2024-01-23,1,100,100.0,0,0,0,100,apl
2024-01-22,1,200,200.0,0,0,0,200,apl
2024-01-19,1,200,200.0,0,0,0,200,apl
2024-01-18,1,200,200.0,0,0,0,200,apl
2024-01-17,1,200,200.0,0,0,0,200,apl
2024-01-16,1,200,200.0,0,0,0,200,apl
2024-01-15,2,600,300.0,2,400,200,200,apl
2024-01-12,1,200,200.0,3,300,100,-100,apl
2024-01-11,2,300,150.0,2,600,300,-300,apl
2024-01-10,3,300,100.0,5,2800,560,-2500,apl
2024-01-09,2,200,100.0,1,100,100,100,apl
2024-01-08,0,0,0.0,1,300,300,-300,apl
2024-01-05,3,500,166.67,3,1000,333,-500,apl
2024-01-04,2,300,150.0,1,300,300,0,apl
2024-01-03,1,100,100.0,1,300,300,-200,apl
2024-01-02,0,0,0.0,1,100,100,-100,apl
2024-09-12,21,11300,538.1,29,22400,772,-11100,app
2024-09-11,23,18800,817.39,29,22500,776,-3700,app
2024-09-10,19,14900,784.21,28,17700,632,-2800,app
2024-09-09,23,17000,739.13,24,17100,712,-100,app
2024-09-06,77,47000,610.39,45,51900,1153,-4900,app
2024-09-05,64,33900,529.69,52,44200,850,-10300,app
2024-09-04,37,16400,443.24,29,11700,403,4700,app
2024-08-30,43,20800,483.72,28,23000,821,-2200,app
2024-08-29,59,33200,562.71,32,42400,1325,-9200,app
2024-08-28,23,12100,526.09,22,12700,577,-600,app
2024-08-27,2,100,50.0,6,1200,200,-1100,app
2024-08-26,7,4600,657.14,11,7300,664,-2700,app
2024-08-23,8,3700,462.5,5,3300,660,400,app
2024-08-22,17,8700,511.76,18,6900,383,1800,app
2024-08-21,0,0,0.0,12,10700,892,-10700,app
2024-08-20,2,300,150.0,10,7700,770,-7400,app
2024-08-19,4,800,200.0,19,28200,1484,-27400,app
2024-08-16,0,0,0.0,16,27400,1712,-27400,app
2024-08-15,0,0,0.0,12,26600,2217,-26600,app
2024-08-14,1,0,0.0,11,29600,2691,-29600,app
2024-08-13,0,0,0.0,10,24700,2470,-24700,app
2024-08-12,0,0,0.0,10,25600,2560,-25600,app
2024-08-09,0,0,0.0,17,14700,865,-14700,app
2024-08-08,4,500,125.0,15,13900,927,-13400,app
2024-08-07,3,3100,1033.33,13,3100,238,0,app
2024-08-06,0,0,0.0,14,4500,321,-4500,app
2024-08-05,1,0,0.0,13,6200,477,-6200,app
2024-08-02,0,0,0.0,13,7700,592,-7700,app
2024-08-01,0,0,0.0,12,8200,683,-8200,app
2024-07-31,0,0,0.0,8,2000,250,-2000,app
2024-07-30,0,0,0.0,9,800,89,-800,app
2024-07-29,2,1700,850.0,4,2200,550,-500,app
2024-07-26,2,1200,600.0,8,1200,150,0,app
2024-07-25,1,1100,1100.0,5,2800,560,-1700,app
2024-07-24,0,0,0.0,5,1800,360,-1800,app
2024-07-23,2,1100,550.0,3,1500,500,-400,app
2024-07-22,0,0,0.0,8,3300,412,-3300,app
2024-07-19,9,3700,411.11,14,3400,243,300,app
2024-07-18,5,2800,560.0,13,3400,262,-600,app
2024-07-17,11,9700,881.82,11,4000,364,5700,app
2024-07-16,22,11700,531.82,14,6400,457,5300,app
2024-07-15,3,4100,1366.67,15,5900,393,-1800,app
2024-07-12,5,6200,1240.0,16,8600,538,-2400,app
2024-07-11,12,7900,658.33,25,11400,456,-3500,app
2024-07-10,5,3700,740.0,27,17700,656,-14000,app
2024-07-09,18,15100,838.89,24,16300,679,-1200,app
2024-07-08,20,12000,600.0,17,13100,771,-1100,app
2024-07-05,18,9500,527.78,26,19800,762,-10300,app
2024-07-04,8,5500,687.5,27,15500,574,-10000,app
2024-07-03,7,7800,1114.29,35,27700,791,-19900,app
2024-07-02,9,7700,855.56,26,15700,604,-8000,app
2024-07-01,10,8200,820.0,12,7800,650,400,app
2024-06-28,16,21900,1368.75,14,6500,464,15400,app
2024-06-27,25,24200,968.0,26,11900,458,12300,app
2024-06-26,6,6700,1116.67,37,15200,411,-8500,app
2024-06-25,10,17600,1760.0,29,11600,400,6000,app
2024-06-24,22,15400,700.0,14,6800,486,8600,app
2024-06-21,43,20800,483.72,25,15000,600,5800,app
2024-06-20,19,5700,300.0,36,15200,422,-9500,app
2024-06-19,44,16500,375.0,23,9500,413,7000,app
2024-06-18,45,26700,593.33,17,8600,506,18100,app
2024-06-17,25,12800,512.0,15,9000,600,3800,app
2024-06-14,41,8600,209.76,26,21200,815,-12600,app
2024-06-13,41,9300,226.83,45,30600,680,-21300,app
2024-06-12,35,56100,1602.86,36,48500,1347,7600,app
2024-06-11,28,93300,3332.14,44,58600,1332,34700,app
2024-06-10,62,63000,1016.13,62,54300,876,8700,app
2024-06-07,34,35800,1052.94,28,13800,493,22000,app
2024-06-06,56,37400,667.86,28,14600,521,22800,app
2024-06-05,35,57000,1628.57,24,43600,1817,13400,app
2024-06-04,31,24400,787.1,26,36200,1392,-11800,app
2024-06-03,52,18300,351.92,44,31800,723,-13500,app
2024-05-31,33,27500,833.33,59,44800,759,-17300,app
2024-05-30,42,46500,1107.14,34,43000,1265,3500,app
2024-05-29,32,47400,1481.25,27,35400,1311,12000,app
2024-05-28,42,93900,2235.71,14,70500,5036,23400,app
2024-05-27,37,600700,16235.14,25,552300,22092,48400,app
2024-05-24,25,770400,30816.0,17,770800,45341,-400,app
2024-05-23,46,861500,18728.26,37,833700,22532,27800,app
2024-05-22,44,625200,14209.09,33,561300,17009,63900,app
2024-05-21,14,42200,3014.29,10,3400,340,38800,app
2024-05-20,15,40200,2680.0,18,5100,283,35100,app
2024-05-17,20,71300,3565.0,29,39700,1369,31600,app
2024-05-16,54,148300,2746.3,59,67300,1141,81000,app
2024-05-15,18,70100,3894.44,13,15500,1192,54600,app
2024-05-14,25,52200,2088.0,12,16000,1333,36200,app
2024-05-13,19,58700,3089.47,14,16800,1200,41900,app
2024-05-10,14,53400,3814.29,27,19000,704,34400,app
2024-05-09,20,190300,9515.0,32,149900,4684,40400,app
2024-05-08,6,17700,2950.0,13,18400,1415,-700,app
2024-05-07,25,52500,2100.0,21,32600,1552,19900,app
2024-05-06,11,36200,3290.91,19,32300,1700,3900,app
2024-05-03,15,44800,2986.67,42,84500,2012,-39700,app
2024-05-02,38,177000,4657.89,41,123600,3015,53400,app
2024-04-26,34,103500,3044.12,38,85500,2250,18000,app
2024-04-25,8,32300,4037.5,8,46700,5838,-14400,app
2024-04-24,12,17000,1416.67,7,17300,2471,-300,app
2024-04-23,8,900,112.5,13,29100,2238,-28200,app
2024-04-22,8,9100,1137.5,23,25600,1113,-16500,app
2024-04-19,7,15300,2185.71,10,8900,890,6400,app
2024-04-17,18,25300,1405.56,8,10300,1288,15000,app
2024-04-16,7,15200,2171.43,16,17900,1119,-2700,app
2024-04-15,4,10500,2625.0,13,33900,2608,-23400,app
2024-04-12,12,16200,1350.0,16,16900,1056,-700,app
2024-04-11,18,19600,1088.89,20,24900,1245,-5300,app
2024-04-10,23,30600,1330.43,18,36600,2033,-6000,app
2024-04-09,25,39900,1596.0,16,33600,2100,6300,app
2024-04-08,21,49100,2338.1,11,13000,1182,36100,app
2024-04-05,15,44600,2973.33,26,68400,2631,-23800,app
2024-04-04,43,72100,1676.74,26,41600,1600,30500,app
2024-04-03,22,15600,709.09,12,22400,1867,-6800,app
2024-04-02,17,13000,764.71,23,20900,909,-7900,app
2024-04-01,13,12300,946.15,5,6700,1340,5600,app
2024-03-29,18,22400,1244.44,4,3400,850,19000,app
2024-03-28,12,11600,966.67,11,14400,1309,-2800,app
2024-03-27,11,8600,781.82,10,7600,760,1000,app
2024-03-26,5,1700,340.0,8,7700,962,-6000,app
2024-03-25,7,1200,171.43,7,9100,1300,-7900,app
2024-03-22,19,16400,863.16,11,33600,3055,-17200,app
2024-03-21,29,15500,534.48,5,4900,980,10600,app
2024-03-20,35,29100,831.43,12,14300,1192,14800,app
2024-03-19,11,5200,472.73,15,23100,1540,-17900,app
2024-03-18,13,17000,1307.69,26,33400,1285,-16400,app
2024-03-15,9,5000,555.56,13,16400,1262,-11400,app
2024-03-14,10,6700,670.0,7,14600,2086,-7900,app
2024-03-13,20,5100,255.0,10,6500,650,-1400,app
2024-03-12,20,16400,820.0,24,26300,1096,-9900,app
2024-03-11,12,9200,766.67,20,19100,955,-9900,app
2024-03-08,8,5800,725.0,9,15500,1722,-9700,app
2024-03-07,23,11200,486.96,19,28600,1505,-17400,app
2024-03-06,22,12400,563.64,30,27700,923,-15300,app
2024-03-05,21,11400,542.86,17,11100,653,300,app
2024-03-04,17,8800,517.65,13,18600,1431,-9800,app
2024-03-01,20,9600,480.0,18,16800,933,-7200,app
2024-02-29,13,6300,484.62,13,25000,1923,-18700,app
2024-02-28,21,20900,995.24,15,28100,1873,-7200,app
2024-02-27,8,5500,687.5,15,30100,2007,-24600,app
2024-02-26,11,4400,400.0,10,24400,2440,-20000,app
2024-02-23,21,13200,628.57,18,20300,1128,-7100,app
2024-02-22,11,7800,709.09,6,12100,2017,-4300,app
2024-02-21,17,7500,441.18,8,15600,1950,-8100,app
2024-02-20,26,8300,319.23,11,21800,1982,-13500,app
2024-02-19,14,6100,435.71,14,23600,1686,-17500,app
2024-02-16,10,5600,560.0,15,31600,2107,-26000,app
2024-02-15,11,5100,463.64,8,9300,1162,-4200,app
2024-02-07,14,8800,628.57,8,11100,1388,-2300,app
2024-02-06,9,11200,1244.44,7,12100,1729,-900,app
2024-02-05,9,5800,644.44,7,17700,2529,-11900,app
2024-02-02,23,18200,791.3,19,23900,1258,-5700,app
2024-02-01,11,14600,1327.27,9,10200,1133,4400,app
2024-01-31,15,19500,1300.0,11,15100,1373,4400,app
2024-01-30,23,38100,1656.52,16,32300,2019,5800,app
2024-01-29,17,14500,852.94,17,31100,1829,-16600,app
2024-01-26,15,17400,1160.0,18,19500,1083,-2100,app
2024-01-25,11,12800,1163.64,6,11200,1867,1600,app
2024-01-24,18,15700,872.22,11,23700,2155,-8000,app
2024-01-23,11,16100,1463.64,10,23800,2380,-7700,app
2024-01-22,8,15900,1987.5,10,22500,2250,-6600,app
2024-01-19,13,14800,1138.46,12,19000,1583,-4200,app
2024-01-18,14,12000,857.14,10,12800,1280,-800,app
2024-01-17,12,12100,1008.33,6,11200,1867,900,app
2024-01-16,19,16700,878.95,12,26200,2183,-9500,app
2024-01-15,10,17300,1730.0,8,18600,2325,-1300,app
2024-01-12,6,3400,566.67,12,22300,1858,-18900,app
2024-01-11,17,16900,994.12,16,19000,1188,-2100,app
2024-01-10,16,13100,818.75,11,25800,2345,-12700,app
2024-01-09,20,24700,1235.0,12,17900,1492,6800,app
2024-01-08,13,12100,930.77,13,21800,1677,-9700,app
2024-01-05,14,11400,814.29,11,22800,2073,-11400,app
2024-01-04,13,10900,838.46,17,26900,1582,-16000,app
2024-01-03,15,8900,593.33,17,28300,1665,-19400,app
2024-01-02,22,18000,818.18,19,27100,1426,-9100,app
2024-09-12,250,667600,2670.4,215,743600,3459,-76000,aps
2024-09-11,423,790700,1869.27,258,881300,3416,-90600,aps
2024-09-10,394,922500,2341.37,336,1320200,3929,-397700,aps
2024-09-09,254,644100,2535.83,297,982800,3309,-338700,aps
2024-09-06,409,1035100,2530.81,306,1049100,3428,-14000,aps
2024-09-05,447,1007100,2253.02,298,1150800,3862,-143700,aps
2024-09-04,586,1154400,1969.97,300,1439700,4799,-285300,aps
2024-08-30,320,911700,2849.06,476,2122200,4458,-1210500,aps
2024-08-29,413,1052900,2549.39,680,2129100,3131,-1076200,aps
2024-08-28,496,1336300,2694.15,463,1999000,4317,-662700,aps
2024-08-27,445,1361800,3060.22,427,1754500,4109,-392700,aps
2024-08-26,635,1627100,2562.36,688,2553800,3712,-926700,aps
2024-08-23,763,2149000,2816.51,1250,4423600,3539,-2274600,aps
2024-08-22,985,3896000,3955.33,1065,4269500,4009,-373500,aps
2024-08-21,327,876000,2678.9,469,1377200,2936,-501200,aps
2024-08-20,479,1425700,2976.41,497,1851700,3726,-426000,aps
2024-08-19,318,845300,2658.18,377,1630000,4324,-784700,aps
2024-08-16,523,1559100,2981.07,588,1796100,3055,-237000,aps
2024-08-15,247,909500,3682.19,297,1194000,4020,-284500,aps
2024-08-14,357,1138400,3188.8,352,1619900,4602,-481500,aps
2024-08-13,393,1026800,2612.72,311,1104700,3552,-77900,aps
2024-08-12,600,1427700,2379.5,298,1856200,6229,-428500,aps
2024-08-09,358,1079700,3015.92,383,1402500,3662,-322800,aps
2024-08-08,316,557800,1765.19,295,709700,2406,-151900,aps
2024-08-07,318,817800,2571.7,272,1165600,4285,-347800,aps
2024-08-06,445,1088900,2446.97,349,1095600,3139,-6700,aps
2024-08-05,739,1340400,1813.8,450,1890700,4202,-550300,aps
2024-08-02,573,1473100,2570.86,455,1532600,3368,-59500,aps
2024-08-01,645,1469300,2277.98,512,2158300,4215,-689000,aps
2024-07-31,325,835800,2571.69,529,1914700,3619,-1078900,aps
2024-07-30,617,1927700,3124.31,889,2825000,3178,-897300,aps
2024-07-29,270,619000,2292.59,363,973700,2682,-354700,aps
2024-07-26,269,704300,2618.22,521,1383400,2655,-679100,aps
2024-07-25,231,671100,2905.19,336,933300,2778,-262200,aps
2024-07-24,496,1368300,2758.67,452,1255000,2777,113300,aps
2024-07-23,382,573200,1500.52,340,1063700,3129,-490500,aps
2024-07-22,580,1193700,2058.1,524,1570400,2997,-376700,aps
2024-07-19,504,1278200,2536.11,748,2476300,3311,-1198100,aps
2024-07-18,677,1940200,2865.88,847,2278900,2691,-338700,aps
2024-07-17,714,1575300,2206.3,661,2096100,3171,-520800,aps
2024-07-16,639,1351200,2114.55,702,2037400,2902,-686200,aps
2024-07-15,542,1302800,2403.69,691,2158700,3124,-855900,aps
2024-07-12,894,2946100,3295.41,817,3005500,3679,-59400,aps
2024-07-11,338,558600,1652.66,323,975600,3020,-417000,aps
2024-07-10,463,941600,2033.69,387,1413000,3651,-471400,aps
2024-07-09,651,1424700,2188.48,373,1684100,4515,-259400,aps
2024-07-08,470,779200,1657.87,410,1100500,2684,-321300,aps
2024-07-05,385,622600,1617.14,430,1025800,2386,-403200,aps
2024-07-04,307,588200,1915.96,398,992300,2493,-404100,aps
2024-07-03,319,554500,1738.24,264,878700,3328,-324200,aps
2024-07-02,336,642300,1911.61,291,750800,2580,-108500,aps
2024-07-01,339,525400,1549.85,277,578100,2087,-52700,aps
2024-06-28,424,742400,1750.94,387,1027400,2655,-285000,aps
2024-06-27,419,715600,1707.88,389,1182600,3040,-467000,aps
2024-06-26,601,959900,1597.17,427,1202500,2816,-242600,aps
2024-06-25,558,970900,1739.96,477,1637200,3432,-666300,aps
2024-06-24,623,1212200,1945.75,628,2463100,3922,-1250900,aps
2024-06-21,919,2512800,2734.28,1017,3096400,3045,-583600,aps
2024-06-20,530,1043400,1968.68,497,1647700,3315,-604300,aps
2024-06-19,759,1762600,2322.27,543,2608700,4804,-846100,aps
2024-06-18,457,1068000,2336.98,524,1930600,3684,-862600,aps
2024-06-17,960,1800500,1875.52,490,2176900,4443,-376400,aps
2024-06-14,1257,2550200,2028.8,932,3597800,3860,-1047600,aps
2024-06-13,593,1099600,1854.3,789,2361400,2993,-1261800,aps
2024-06-12,801,2466000,3078.65,1180,3292600,2790,-826600,aps
2024-06-11,927,1864100,2010.9,738,2244600,3041,-380500,aps
2024-06-10,833,1854700,2226.53,806,2833700,3516,-979000,aps
2024-06-07,871,2591800,2975.66,1145,3540200,3092,-948400,aps
2024-06-06,1069,2004000,1874.65,881,2989100,3393,-985100,aps
2024-06-05,1438,3664600,2548.4,1337,3978600,2976,-314000,aps
2024-06-04,1356,3248900,2395.94,1013,2830400,2794,418500,aps
2024-06-03,2435,5292400,2173.47,1335,7310100,5476,-2017700,aps
2024-05-31,1509,2962400,1963.15,1449,4652000,3210,-1689600,aps
2024-05-30,2698,6619100,2453.34,1637,4704400,2874,1914700,aps
2024-05-29,1910,4805400,2515.92,1102,6226600,5650,-1421200,aps
2024-05-28,1459,3523500,2415.01,560,2162100,3861,1361400,aps
2024-05-27,1178,3719900,3157.81,764,2377300,3112,1342600,aps
2024-05-24,1348,3720800,2760.24,1083,4901800,4526,-1181000,aps
2024-05-23,1330,3306200,2485.86,1140,3898900,3420,-592700,aps
2024-05-22,1365,4452100,3261.61,1522,4779300,3140,-327200,aps
2024-05-21,888,2552600,2874.55,962,3143400,3268,-590800,aps
2024-05-20,1183,3792200,3205.58,1541,4778100,3101,-985900,aps
2024-05-17,752,3358300,4465.82,678,2128900,3140,1229400,aps
2024-05-16,1015,2273600,2240.0,684,2952800,4317,-679200,aps
2024-05-15,1218,3837100,3150.33,1236,4999600,4045,-1162500,aps
2024-05-14,1317,5205400,3952.47,701,3643000,5197,1562400,aps
2024-05-13,612,3026300,4944.93,263,708000,2692,2318300,aps
2024-05-10,348,755600,2171.26,481,1573400,3271,-817800,aps
2024-05-09,699,2303700,3295.71,701,1924000,2745,379700,aps
2024-05-08,290,716800,2471.72,278,741700,2668,-24900,aps
2024-05-07,267,471400,1765.54,297,826900,2784,-355500,aps
2024-05-06,364,624700,1716.21,296,840200,2839,-215500,aps
2024-05-03,301,460700,1530.56,186,709000,3812,-248300,aps
2024-05-02,316,616300,1950.32,199,740300,3720,-124000,aps
2024-04-26,471,872300,1852.02,289,1170000,4048,-297700,aps
2024-04-25,266,439100,1650.75,267,933900,3498,-494800,aps
2024-04-24,397,783800,1974.31,254,1176300,4631,-392500,aps
2024-04-23,332,488900,1472.59,285,1092300,3833,-603400,aps
2024-04-22,483,920700,1906.21,350,801100,2289,119600,aps
2024-04-19,400,679000,1697.5,256,864800,3378,-185800,aps
2024-04-17,427,605600,1418.27,236,1047400,4438,-441800,aps
2024-04-16,651,1281000,1967.74,335,1264400,3774,16600,aps
2024-04-15,1211,2519700,2080.68,579,3317700,5730,-798000,aps
2024-04-12,385,649100,1685.97,274,1214500,4432,-565400,aps
2024-04-11,385,673800,1750.13,237,1046700,4416,-372900,aps
2024-04-10,306,554400,1811.76,290,1031400,3557,-477000,aps
2024-04-09,449,988100,2200.67,251,944900,3765,43200,aps
2024-04-08,448,816700,1822.99,283,1436300,5075,-619600,aps
2024-04-05,671,1010600,1506.11,307,1198100,3903,-187500,aps
2024-04-04,459,692800,1509.37,357,1260500,3531,-567700,aps
2024-04-03,452,851600,1884.07,498,1820100,3655,-968500,aps
2024-04-02,443,921500,2080.14,399,1674800,4197,-753300,aps
2024-04-01,456,773600,1696.49,351,1415700,4033,-642100,aps
2024-03-29,475,925300,1948.0,357,1587100,4446,-661800,aps
2024-03-28,453,1164400,2570.42,529,2205200,4169,-1040800,aps
2024-03-27,467,1102800,2361.46,434,1621800,3737,-519000,aps
2024-03-26,592,1343400,2269.26,374,1385500,3705,-42100,aps
2024-03-25,715,1708300,2389.23,485,1892800,3903,-184500,aps
2024-03-22,564,1345500,2385.64,678,2621300,3866,-1275800,aps
2024-03-21,583,1731100,2969.3,830,3509100,4228,-1778000,aps
2024-03-20,399,798400,2001.0,608,2130600,3504,-1332200,aps
2024-03-19,852,2432200,2854.69,1191,3405100,2859,-972900,aps
2024-03-18,850,2215300,2606.24,569,2281900,4010,-66600,aps
2024-03-15,501,1035200,2066.27,528,1921200,3639,-886000,aps
2024-03-14,601,1708000,2841.93,980,3088600,3152,-1380600,aps
2024-03-13,871,1609300,1847.65,573,2117000,3695,-507700,aps
2024-03-12,712,1541600,2165.17,454,1689400,3721,-147800,aps
2024-03-11,869,2036000,2342.92,941,3233700,3436,-1197700,aps
2024-03-08,1394,3261000,2339.31,1439,4225000,2936,-964000,aps
2024-03-07,1314,4597500,3498.86,1237,3549200,2869,1048300,aps
2024-03-06,487,839900,1724.64,432,1703500,3943,-863600,aps
2024-03-05,454,764100,1683.04,407,1669600,4102,-905500,aps
2024-03-04,587,1276800,2175.13,567,1641000,2894,-364200,aps
2024-03-01,615,1080000,1756.1,424,1504100,3547,-424100,aps
2024-02-29,464,607900,1310.13,416,1452000,3490,-844100,aps
2024-02-28,377,655300,1738.2,431,1266300,2938,-611000,aps
2024-02-27,525,881800,1679.62,415,1342500,3235,-460700,aps
2024-02-26,435,759100,1745.06,365,1275700,3495,-516600,aps
2024-02-23,541,788000,1456.56,458,1621900,3541,-833900,aps
2024-02-22,462,698000,1510.82,388,1334600,3440,-636600,aps
2024-02-21,486,754500,1552.47,457,1492400,3266,-737900,aps
2024-02-20,614,1134000,1846.91,477,1515600,3177,-381600,aps
2024-02-19,535,1061300,1983.74,373,1239500,3323,-178200,aps
2024-02-16,399,777400,1948.37,337,916700,2720,-139300,aps
2024-02-15,299,450400,1506.35,262,743600,2838,-293200,aps
2024-02-07,244,601100,2463.52,343,1033400,3013,-432300,aps
2024-02-06,307,713800,2325.08,336,1092000,3250,-378200,aps
2024-02-05,407,654300,1607.62,315,985300,3128,-331000,aps
2024-02-02,441,744500,1688.21,372,1304000,3505,-559500,aps
2024-02-01,366,813600,2222.95,334,1065400,3190,-251800,aps
2024-01-31,376,566500,1506.65,395,1158600,2933,-592100,aps
2024-01-30,269,498300,1852.42,292,896600,3071,-398300,aps
2024-01-29,289,440200,1523.18,379,1139900,3008,-699700,aps
2024-01-26,301,483300,1605.65,404,1427300,3533,-944000,aps
2024-01-25,277,498800,1800.72,355,1109800,3126,-611000,aps
2024-01-24,333,752700,2260.36,429,1236900,2883,-484200,aps
2024-01-23,333,567600,1704.5,391,1163400,2975,-595800,aps
2024-01-22,361,550300,1524.38,329,1198200,3642,-647900,aps
2024-01-19,366,690300,1886.07,475,1389400,2925,-699100,aps
2024-01-18,263,464100,1764.64,378,1085100,2871,-621000,aps
2024-01-17,563,1537700,2731.26,631,2113300,3349,-575600,aps
2024-01-16,380,736300,1937.63,284,650200,2289,86100,aps
2024-01-15,295,569100,1929.15,292,1005500,3443,-436400,aps
2024-01-12,549,824100,1501.09,376,1188400,3161,-364300,aps
2024-01-11,343,816000,2379.01,426,975300,2289,-159300,aps
2024-01-10,543,815000,1500.92,417,1826200,4379,-1011200,aps
2024-01-09,454,684600,1507.93,400,1567900,3920,-883300,aps
2024-01-08,510,887300,1739.8,480,1148000,2392,-260700,aps
2024-01-05,469,1094600,2333.9,472,1544500,3272,-449900,aps
2024-01-04,440,858300,1950.68,488,1330300,2726,-472000,aps
2024-01-03,427,726400,1701.17,394,1120700,2844,-394300,aps
2024-01-02,447,764500,1710.29,411,1234200,3003,-469700,aps
2024-09-12,1,0,0.0,7,800,114,-800,arm
2024-09-11,0,0,0.0,8,1300,162,-1300,arm
2024-09-10,0,0,0.0,6,1500,250,-1500,arm
2024-09-09,6,600,100.0,10,1200,120,-600,arm
2024-09-06,0,0,0.0,4,1100,275,-1100,arm
2024-09-05,1,100,100.0,5,700,140,-600,arm
2024-09-04,6,500,83.33,7,1300,186,-800,arm
2024-08-30,2,1100,550.0,3,800,267,300,arm
2024-08-29,3,300,100.0,1,100,100,200,arm
2024-08-28,15,5100,340.0,3,3600,1200,1500,arm
2024-08-27,4,400,100.0,2,200,100,200,arm
2024-08-26,6,3900,650.0,1,100,100,3800,arm
2024-08-23,1,300,300.0,1,100,100,200,arm
2024-08-22,3,600,200.0,0,0,0,600,arm
2024-08-21,5,1500,300.0,0,0,0,1500,arm
2024-08-20,6,1400,233.33,0,0,0,1400,arm
2024-08-19,3,600,200.0,2,200,100,400,arm
2024-08-16,2,200,100.0,3,300,100,-100,arm
2024-08-15,0,0,0.0,1,100,100,-100,arm
2024-08-14,1,100,100.0,3,300,100,-200,arm
2024-08-13,2,300,150.0,2,300,150,0,arm
2024-08-12,4,500,125.0,3,500,167,0,arm
2024-08-09,4,800,200.0,3,400,133,400,arm
2024-08-08,3,700,233.33,2,300,150,400,arm
2024-08-07,6,2100,350.0,4,600,150,1500,arm
2024-08-06,2,200,100.0,8,1100,138,-900,arm
2024-08-05,5,1300,260.0,4,2100,525,-800,arm
2024-08-02,2,200,100.0,5,2500,500,-2300,arm
2024-08-01,2,200,100.0,10,2400,240,-2200,arm
2024-07-31,0,0,0.0,8,2600,325,-2600,arm
2024-07-30,0,0,0.0,9,3000,333,-3000,arm
2024-07-29,2,200,100.0,4,2400,600,-2200,arm
2024-07-26,6,1200,200.0,4,2300,575,-1100,arm
2024-07-25,5,600,120.0,1,100,100,500,arm
2024-07-24,8,2900,362.5,7,2800,400,100,arm
2024-07-23,6,700,116.67,6,3100,517,-2400,arm
2024-07-22,2,300,150.0,6,3400,567,-3100,arm
2024-07-19,1,100,100.0,5,3300,660,-3200,arm
2024-07-18,0,0,0.0,6,3400,567,-3400,arm
2024-07-17,0,0,0.0,9,4100,456,-4100,arm
2024-07-16,0,0,0.0,7,3800,543,-3800,arm
2024-07-15,0,0,0.0,6,3800,633,-3800,arm
2024-07-12,0,0,0.0,7,4000,571,-4000,arm
2024-07-11,0,0,0.0,6,3800,633,-3800,arm
2024-07-10,0,0,0.0,7,4000,571,-4000,arm
2024-07-09,0,0,0.0,7,4000,571,-4000,arm
2024-07-08,0,0,0.0,6,3800,633,-3800,arm
2024-07-05,0,0,0.0,6,3800,633,-3800,arm
2024-07-04,0,0,0.0,5,3400,680,-3400,arm
2024-07-03,0,0,0.0,7,3900,557,-3900,arm
2024-07-02,1,200,200.0,5,3500,700,-3300,arm
2024-07-01,1,100,100.0,10,3000,300,-2900,arm
2024-06-28,1,100,100.0,6,3300,550,-3200,arm
2024-06-27,4,0,0.0,1,200,200,-200,arm
2024-06-26,7,1100,157.14,6,1000,167,100,arm
2024-06-25,10,1800,180.0,4,1000,250,800,arm
2024-06-24,45,14200,315.56,5,2800,560,11400,arm
2024-06-21,4,2000,500.0,4,700,175,1300,arm
2024-06-20,3,1100,366.67,2,600,300,500,arm
2024-06-19,4,1600,400.0,4,1700,425,-100,arm
2024-06-18,6,2900,483.33,5,2000,400,900,arm
2024-06-17,4,2100,525.0,3,1100,367,1000,arm
2024-06-14,3,2000,666.67,1,100,100,1900,arm
2024-06-13,8,2100,262.5,3,1100,367,1000,arm
2024-06-12,5,1200,240.0,1,100,100,1100,arm
2024-06-11,2,1000,500.0,2,200,100,800,arm
2024-06-10,1,2000,2000.0,4,1300,325,700,arm
2024-06-07,3,1100,366.67,5,2000,400,-900,arm
2024-06-06,4,1000,250.0,1,100,100,900,arm
2024-06-05,11,5500,500.0,2,1100,550,4400,arm
2024-06-04,4,1300,325.0,0,0,0,1300,arm
2024-06-03,3,1100,366.67,3,300,100,800,arm
2024-05-31,4,1700,425.0,4,1600,400,100,arm
2024-05-30,0,0,0.0,2,1300,650,-1300,arm
2024-05-29,1,100,100.0,6,2900,483,-2800,arm
2024-05-28,0,0,0.0,3,1700,567,-1700,arm
2024-05-27,0,0,0.0,3,1500,500,-1500,arm
2024-05-24,0,0,0.0,6,2600,433,-2600,arm
2024-05-23,1,100,100.0,3,2800,933,-2700,arm
2024-05-22,1,100,100.0,3,1600,533,-1500,arm
2024-05-21,1,100,100.0,3,2300,767,-2200,arm
2024-05-20,0,0,0.0,2,1100,550,-1100,arm
2024-05-17,13,3000,230.77,6,3400,567,-400,arm
2024-05-16,6,2700,450.0,1,200,200,2500,arm
2024-05-15,9,3000,333.33,4,1600,400,1400,arm
2024-05-14,1,400,400.0,5,1800,360,-1400,arm
2024-05-13,1,200,200.0,5,2200,440,-2000,arm
2024-05-10,0,0,0.0,3,800,267,-800,arm
2024-05-09,2,300,150.0,4,1300,325,-1000,arm
2024-05-08,0,0,0.0,3,1100,367,-1100,arm
2024-05-07,0,0,0.0,3,1100,367,-1100,arm
2024-05-06,0,0,0.0,4,1300,325,-1300,arm
2024-05-03,0,0,0.0,3,1500,500,-1500,arm
2024-05-02,0,0,0.0,3,700,233,-700,arm
2024-04-26,0,0,0.0,4,1900,475,-1900,arm
2024-04-25,1,100,100.0,3,600,200,-500,arm
2024-04-24,0,0,0.0,2,800,400,-800,arm
2024-04-23,0,0,0.0,1,200,200,-200,arm
2024-04-22,0,0,0.0,2,400,200,-400,arm
2024-04-19,2,200,100.0,2,800,400,-600,arm
2024-04-17,0,0,0.0,0,0,0,0,arm
2024-04-16,0,0,0.0,1,500,500,-500,arm
2024-04-15,1,100,100.0,0,0,0,100,arm
2024-04-12,3,700,233.33,0,0,0,700,arm
2024-04-11,4,1700,425.0,1,100,100,1600,arm
2024-04-10,2,1600,800.0,0,0,0,1600,arm
2024-04-09,1,100,100.0,0,0,0,100,arm
2024-04-08,2,200,100.0,0,0,0,200,arm
2024-04-05,1,100,100.0,1,100,100,0,arm
2024-04-04,1,0,0.0,0,0,0,0,arm
2024-04-03,2,400,200.0,2,200,100,200,arm
2024-04-02,0,0,0.0,1,200,200,-200,arm
2024-04-01,0,0,0.0,2,300,150,-300,arm
2024-03-29,0,0,0.0,1,200,200,-200,arm
2024-03-28,0,0,0.0,2,400,200,-400,arm
2024-03-27,2,0,0.0,1,200,200,-200,arm
2024-03-26,1,0,0.0,2,500,250,-500,arm
2024-03-25,0,0,0.0,1,200,200,-200,arm
2024-03-22,0,0,0.0,1,200,200,-200,arm
2024-03-21,1,0,0.0,1,300,300,-300,arm
2024-03-20,1,300,300.0,1,300,300,0,arm
2024-03-19,0,0,0.0,1,300,300,-300,arm
2024-03-18,1,100,100.0,3,400,133,-300,arm
2024-03-15,1,200,200.0,1,200,200,0,arm
2024-03-14,1,100,100.0,0,0,0,100,arm
2024-03-13,4,400,100.0,4,400,100,0,arm
2024-03-12,0,0,0.0,3,400,133,-400,arm
2024-03-11,0,0,0.0,4,1500,375,-1500,arm
2024-03-08,0,0,0.0,2,1200,600,-1200,arm
2024-03-07,2,400,200.0,2,1300,650,-900,arm
2024-03-06,5,700,140.0,2,700,350,0,arm
2024-03-05,3,400,133.33,2,300,150,100,arm
2024-03-04,2,200,100.0,1,100,100,100,arm
2024-03-01,0,0,0.0,0,0,0,0,arm
2024-02-29,0,0,0.0,0,0,0,0,arm
2024-02-28,2,600,300.0,1,100,100,500,arm
2024-02-27,1,100,100.0,0,0,0,100,arm
2024-02-26,2,1100,550.0,0,0,0,1100,arm
2024-02-23,3,200,66.67,0,0,0,200,arm
2024-02-22,2,1200,600.0,0,0,0,1200,arm
2024-02-21,2,300,150.0,0,0,0,300,arm
2024-02-20,2,3200,1600.0,0,0,0,3200,arm
2024-02-19,2,1700,850.0,0,0,0,1700,arm
2024-02-16,3,1400,466.67,0,0,0,1400,arm
2024-02-15,3,1300,433.33,0,0,0,1300,arm
2024-02-07,6,2400,400.0,1,100,100,2300,arm
2024-02-06,5,2200,440.0,1,100,100,2100,arm
2024-02-05,2,200,100.0,1,100,100,100,arm
2024-02-02,6,1000,166.67,1,100,100,900,arm
2024-02-01,5,500,100.0,3,400,133,100,arm
2024-01-31,5,1200,240.0,1,100,100,1100,arm
2024-01-30,3,1500,500.0,0,0,0,1500,arm
2024-01-29,8,1600,200.0,1,100,100,1500,arm
2024-01-26,4,800,200.0,0,0,0,800,arm
2024-01-25,4,1300,325.0,0,0,0,1300,arm
2024-01-24,6,1400,233.33,0,0,0,1400,arm
2024-01-23,5,1200,240.0,0,0,0,1200,arm
2024-01-22,4,400,100.0,0,0,0,400,arm
2024-01-19,4,1200,300.0,0,0,0,1200,arm
2024-01-18,5,1300,260.0,0,0,0,1300,arm
2024-01-17,7,2100,300.0,0,0,0,2100,arm
2024-01-16,7,1000,142.86,0,0,0,1000,arm
2024-01-15,6,1200,200.0,1,100,100,1100,arm
2024-01-12,7,600,85.71,0,0,0,600,arm
2024-01-11,3,400,133.33,2,200,100,200,arm
2024-01-10,3,100,33.33,0,0,0,100,arm
2024-01-09,4,6500,1625.0,1,100,100,6400,arm
2024-01-08,1,100,100.0,3,300,100,-200,arm
2024-01-05,0,0,0.0,0,0,0,0,arm
2024-01-04,0,0,0.0,1,300,300,-300,arm
2024-01-03,0,0,0.0,0,0,0,0,arm
2024-01-02,2,300,150.0,1,100,100,200,arm
2024-09-12,0,0,0.0,0,0,0,0,art
2024-09-11,0,0,0.0,0,0,0,0,art
2024-09-10,0,0,0.0,0,0,0,0,art
2024-09-09,0,0,0.0,0,0,0,0,art
2024-09-06,0,0,0.0,0,0,0,0,art
2024-09-05,0,0,0.0,0,0,0,0,art
2024-09-04,0,0,0.0,0,0,0,0,art
2024-08-30,0,0,0.0,0,0,0,0,art
2024-08-29,0,0,0.0,0,0,0,0,art
2024-08-28,0,0,0.0,0,0,0,0,art
2024-08-27,0,0,0.0,0,0,0,0,art
2024-08-26,0,0,0.0,0,0,0,0,art
2024-08-23,0,0,0.0,0,0,0,0,art
2024-08-22,0,0,0.0,0,0,0,0,art
2024-08-21,0,0,0.0,0,0,0,0,art
2024-08-20,0,0,0.0,0,0,0,0,art
2024-08-19,0,0,0.0,0,0,0,0,art
2024-08-16,0,0,0.0,0,0,0,0,art
2024-08-15,0,0,0.0,0,0,0,0,art
2024-08-14,0,0,0.0,0,0,0,0,art
2024-08-13,0,0,0.0,0,0,0,0,art
2024-08-12,0,0,0.0,0,0,0,0,art
2024-08-09,0,0,0.0,0,0,0,0,art
2024-08-08,0,0,0.0,0,0,0,0,art
2024-08-07,0,0,0.0,0,0,0,0,art
2024-08-06,0,0,0.0,0,0,0,0,art
2024-08-05,0,0,0.0,0,0,0,0,art
2024-08-02,0,0,0.0,0,0,0,0,art
2024-08-01,0,0,0.0,0,0,0,0,art
2024-07-31,0,0,0.0,0,0,0,0,art
2024-07-30,0,0,0.0,0,0,0,0,art
2024-07-29,0,0,0.0,0,0,0,0,art
2024-07-26,0,0,0.0,0,0,0,0,art
2024-07-25,0,0,0.0,0,0,0,0,art
2024-07-24,0,0,0.0,0,0,0,0,art
2024-07-23,0,0,0.0,0,0,0,0,art
2024-07-22,0,0,0.0,0,0,0,0,art
2024-07-19,0,0,0.0,0,0,0,0,art
2024-07-18,0,0,0.0,0,0,0,0,art
2024-07-17,0,0,0.0,0,0,0,0,art
2024-07-16,0,0,0.0,0,0,0,0,art
2024-07-15,0,0,0.0,0,0,0,0,art
2024-07-12,0,0,0.0,0,0,0,0,art
2024-07-11,0,0,0.0,0,0,0,0,art
2024-07-10,0,0,0.0,0,0,0,0,art
2024-07-09,0,0,0.0,0,0,0,0,art
2024-07-08,0,0,0.0,0,0,0,0,art
2024-07-05,0,0,0.0,0,0,0,0,art
2024-07-04,0,0,0.0,0,0,0,0,art
2024-07-03,0,0,0.0,0,0,0,0,art
2024-07-02,0,0,0.0,0,0,0,0,art
2024-07-01,0,0,0.0,0,0,0,0,art
2024-06-28,0,0,0.0,0,0,0,0,art
2024-06-27,0,0,0.0,0,0,0,0,art
2024-06-26,0,0,0.0,0,0,0,0,art
2024-06-25,0,0,0.0,0,0,0,0,art
2024-06-24,0,0,0.0,0,0,0,0,art
2024-06-21,0,0,0.0,0,0,0,0,art
2024-06-20,0,0,0.0,0,0,0,0,art
2024-06-19,0,0,0.0,0,0,0,0,art
2024-06-18,0,0,0.0,0,0,0,0,art
2024-06-17,0,0,0.0,0,0,0,0,art
2024-06-14,0,0,0.0,0,0,0,0,art
2024-06-13,0,0,0.0,0,0,0,0,art
2024-06-12,0,0,0.0,0,0,0,0,art
2024-06-11,0,0,0.0,0,0,0,0,art
2024-06-10,0,0,0.0,0,0,0,0,art
2024-06-07,0,0,0.0,0,0,0,0,art
2024-06-06,0,0,0.0,0,0,0,0,art
2024-06-05,0,0,0.0,0,0,0,0,art
2024-06-04,0,0,0.0,0,0,0,0,art
2024-06-03,0,0,0.0,0,0,0,0,art
2024-05-31,0,0,0.0,0,0,0,0,art
2024-05-30,0,0,0.0,0,0,0,0,art
2024-05-29,0,0,0.0,0,0,0,0,art
2024-05-28,0,0,0.0,0,0,0,0,art
2024-05-27,0,0,0.0,0,0,0,0,art
2024-05-24,0,0,0.0,0,0,0,0,art
2024-05-23,0,0,0.0,0,0,0,0,art
2024-05-22,0,0,0.0,0,0,0,0,art
2024-05-21,0,0,0.0,0,0,0,0,art
2024-05-20,0,0,0.0,0,0,0,0,art
2024-05-17,0,0,0.0,0,0,0,0,art
2024-05-16,0,0,0.0,0,0,0,0,art
2024-05-15,0,0,0.0,0,0,0,0,art
2024-05-14,0,0,0.0,0,0,0,0,art
2024-05-13,0,0,0.0,0,0,0,0,art
2024-05-10,0,0,0.0,0,0,0,0,art
2024-05-09,0,0,0.0,0,0,0,0,art
2024-05-08,0,0,0.0,0,0,0,0,art
2024-05-07,0,0,0.0,0,0,0,0,art
2024-05-06,0,0,0.0,0,0,0,0,art
2024-05-03,0,0,0.0,0,0,0,0,art
2024-05-02,0,0,0.0,0,0,0,0,art
2024-04-26,0,0,0.0,0,0,0,0,art
2024-04-25,0,0,0.0,0,0,0,0,art
2024-04-24,0,0,0.0,0,0,0,0,art
2024-04-23,0,0,0.0,0,0,0,0,art
2024-04-22,0,0,0.0,0,0,0,0,art
2024-04-19,0,0,0.0,0,0,0,0,art
2024-04-17,0,0,0.0,0,0,0,0,art
2024-04-16,0,0,0.0,0,0,0,0,art
2024-04-15,0,0,0.0,0,0,0,0,art
2024-04-12,0,0,0.0,0,0,0,0,art
2024-04-11,0,0,0.0,0,0,0,0,art
2024-04-10,0,0,0.0,0,0,0,0,art
2024-04-09,0,0,0.0,0,0,0,0,art
2024-04-08,0,0,0.0,0,0,0,0,art
2024-04-05,0,0,0.0,0,0,0,0,art
2024-04-04,0,0,0.0,0,0,0,0,art
2024-04-03,0,0,0.0,0,0,0,0,art
2024-04-02,0,0,0.0,0,0,0,0,art
2024-04-01,0,0,0.0,0,0,0,0,art
2024-03-29,0,0,0.0,0,0,0,0,art
2024-03-28,0,0,0.0,0,0,0,0,art
2024-03-27,0,0,0.0,0,0,0,0,art
2024-03-26,0,0,0.0,0,0,0,0,art
2024-03-25,0,0,0.0,0,0,0,0,art
2024-03-22,0,0,0.0,0,0,0,0,art
2024-03-21,0,0,0.0,0,0,0,0,art
2024-03-20,0,0,0.0,0,0,0,0,art
2024-03-19,0,0,0.0,0,0,0,0,art
2024-03-18,0,0,0.0,0,0,0,0,art
2024-03-15,0,0,0.0,0,0,0,0,art
2024-03-14,0,0,0.0,0,0,0,0,art
2024-03-13,0,0,0.0,0,0,0,0,art
2024-03-12,0,0,0.0,0,0,0,0,art
2024-03-11,0,0,0.0,0,0,0,0,art
2024-03-08,0,0,0.0,0,0,0,0,art
2024-03-07,0,0,0.0,0,0,0,0,art
2024-03-06,0,0,0.0,0,0,0,0,art
2024-03-05,0,0,0.0,0,0,0,0,art
2024-03-04,0,0,0.0,0,0,0,0,art
2024-03-01,0,0,0.0,0,0,0,0,art
2024-02-29,0,0,0.0,0,0,0,0,art
2024-02-28,0,0,0.0,0,0,0,0,art
2024-02-27,0,0,0.0,0,0,0,0,art
2024-02-26,0,0,0.0,0,0,0,0,art
2024-02-23,0,0,0.0,0,0,0,0,art
2024-02-22,0,0,0.0,0,0,0,0,art
2024-02-21,0,0,0.0,0,0,0,0,art
2024-02-20,0,0,0.0,0,0,0,0,art
2024-02-19,0,0,0.0,0,0,0,0,art
2024-02-16,0,0,0.0,0,0,0,0,art
2024-02-15,0,0,0.0,0,0,0,0,art
2024-02-07,0,0,0.0,0,0,0,0,art
2024-02-06,0,0,0.0,0,0,0,0,art
2024-02-05,0,0,0.0,0,0,0,0,art
2024-02-02,0,0,0.0,0,0,0,0,art
2024-02-01,0,0,0.0,0,0,0,0,art
2024-01-31,0,0,0.0,0,0,0,0,art
2024-01-30,0,0,0.0,0,0,0,0,art
2024-01-29,0,0,0.0,0,0,0,0,art
2024-01-26,0,0,0.0,0,0,0,0,art
2024-01-25,0,0,0.0,0,0,0,0,art
2024-01-24,0,0,0.0,0,0,0,0,art
2024-01-23,0,0,0.0,0,0,0,0,art
2024-01-22,0,0,0.0,0,0,0,0,art
2024-01-19,0,0,0.0,0,0,0,0,art
2024-01-18,0,0,0.0,0,0,0,0,art
2024-01-17,0,0,0.0,0,0,0,0,art
2024-01-16,0,0,0.0,0,0,0,0,art
2024-01-15,0,0,0.0,0,0,0,0,art
2024-01-12,0,0,0.0,0,0,0,0,art
2024-01-11,0,0,0.0,0,0,0,0,art
2024-01-10,0,0,0.0,0,0,0,0,art
2024-01-09,0,0,0.0,0,0,0,0,art
2024-01-08,0,0,0.0,0,0,0,0,art
2024-01-05,0,0,0.0,0,0,0,0,art
2024-01-04,0,0,0.0,0,0,0,0,art
2024-01-03,0,0,0.0,0,0,0,0,art
2024-01-02,0,0,0.0,0,0,0,0,art
2024-09-12,394,2174300,5518.53,435,1570500,3610,603800,asm
2024-09-11,723,2627800,3634.58,514,2232300,4343,395500,asm
2024-09-10,752,1785200,2373.94,624,2176300,3488,-391100,asm
2024-09-09,623,1223500,1963.88,426,1310400,3076,-86900,asm
2024-09-06,973,1813900,1864.23,421,1970300,4680,-156400,asm
2024-09-05,744,1329200,1786.56,500,1661400,3323,-332200,asm
2024-09-04,1139,2081600,1827.57,661,2048700,3099,32900,asm
2024-08-30,758,1204900,1589.58,607,1907900,3143,-703000,asm
2024-08-29,819,1491500,1821.12,971,2705800,2787,-1214300,asm
2024-08-28,1271,4561300,3588.75,1022,4166800,4077,394500,asm
2024-08-27,798,2009200,2517.79,836,2469700,2954,-460500,asm
2024-08-26,860,3136200,3646.74,935,3516500,3761,-380300,asm
2024-08-23,1113,2120100,1904.85,893,2948800,3302,-828700,asm
2024-08-22,1206,2069000,1715.59,814,2636300,3239,-567300,asm
2024-08-21,739,1982600,2682.81,713,2738100,3840,-755500,asm
2024-08-20,976,3874700,3969.98,959,3263200,3403,611500,asm
2024-08-19,643,1489700,2316.8,610,1882000,3085,-392300,asm
2024-08-16,907,3209600,3538.7,1085,2871400,2646,338200,asm
2024-08-15,460,1486200,3230.87,411,1115700,2715,370500,asm
2024-08-14,481,973800,2024.53,539,1084800,2013,-111000,asm
2024-08-13,577,1253300,2172.1,546,1320500,2418,-67200,asm
2024-08-12,513,1046500,2039.96,356,972100,2731,74400,asm
2024-08-08,724,1472700,2034.12,520,1627500,3130,-154800,asm
2024-08-07,616,1360900,2209.25,530,1366500,2578,-5600,asm
2024-08-06,1077,2342700,2175.21,662,2361200,3567,-18500,asm
2024-08-05,1670,3409200,2041.44,766,4603300,6010,-1194100,asm
2024-08-02,1155,1884500,1631.6,464,1566400,3376,318100,asm
2024-08-01,1155,1837000,1590.48,652,2873100,4407,-1036100,asm
2024-07-31,814,2067500,2539.93,549,2075500,3781,-8000,asm
2024-07-30,788,1320300,1675.51,522,2050100,3927,-729800,asm
2024-07-29,465,655900,1410.54,512,1400800,2736,-744900,asm
2024-07-26,462,1145800,2480.09,602,1592200,2645,-446400,asm
2024-07-25,629,1578800,2510.02,368,945600,2570,633200,asm
2024-07-24,1001,1891300,1889.41,583,1672700,2869,218600,asm
2024-07-22,1437,2667600,1856.37,614,2546700,4148,120900,asm
2024-07-19,1561,2787100,1785.46,752,3242000,4311,-454900,asm
2024-07-18,1488,2623400,1763.04,783,2860100,3653,-236700,asm
2024-07-17,1867,5202100,2786.34,1205,6991600,5802,-1789500,asm
2024-07-16,1261,2488600,1973.51,813,3372200,4148,-883600,asm
2024-07-15,1036,2901500,2800.68,834,3253400,3901,-351900,asm
2024-07-12,1751,7841300,4478.18,1924,7182300,3733,659000,asm
2024-07-11,1302,6616200,5081.57,1602,6407500,4000,208700,asm
2024-07-10,999,3228600,3231.83,1004,4153400,4137,-924800,asm
2024-07-09,931,3943200,4235.45,1506,5205700,3457,-1262500,asm
2024-07-08,833,3051100,3662.79,1157,3650400,3155,-599300,asm
2024-07-05,911,2629000,2885.84,827,3314600,4008,-685600,asm
2024-07-04,904,2177800,2409.07,1028,4377900,4259,-2200100,asm
2024-07-03,798,2298500,2880.33,1018,3276500,3219,-978000,asm
2024-07-02,793,2366500,2984.24,886,2779800,3137,-413300,asm
2024-07-01,853,1970700,2310.32,650,1956100,3009,14600,asm
2024-06-28,1380,2868500,2078.62,860,3527100,4101,-658600,asm
2024-06-27,860,2959900,3441.74,678,2660100,3923,299800,asm
2024-06-26,1185,3679600,3105.15,1004,3891400,3876,-211800,asm
2024-06-25,1304,3275900,2512.19,749,3173200,4237,102700,asm
2024-06-24,3185,8392600,2635.04,1550,8305500,5358,87100,asm
2024-06-21,1430,5415600,3787.13,1010,4967800,4919,447800,asm
2024-06-20,2058,5426300,2636.69,1238,6144500,4963,-718200,asm
2024-06-19,1269,4656400,3669.35,1933,7352200,3804,-2695800,asm
2024-06-18,1467,7215700,4918.68,1046,4454300,4258,2761400,asm
2024-06-17,2107,4989400,2368.01,1214,5225300,4304,-235900,asm
2024-06-14,1882,5634500,2993.89,1753,8562000,4884,-2927500,asm
2024-06-13,1531,5272400,3443.76,1833,7788900,4249,-2516500,asm
2024-06-12,1732,6493800,3749.31,1469,7298200,4968,-804400,asm
2024-06-11,2224,6521500,2932.33,1860,8808900,4736,-2287400,asm
2024-06-10,3044,16387300,5383.48,3196,12573400,3934,3813900,asm
2024-06-07,1598,5579300,3491.43,1316,5731000,4355,-151700,asm
2024-06-06,2007,6438500,3208.02,1541,8132600,5277,-1694100,asm
2024-06-05,2046,6856900,3351.37,1661,7973100,4800,-1116200,asm
2024-06-04,1606,5685900,3540.41,1715,7107800,4144,-1421900,asm
2024-06-03,1757,6793200,3866.36,2304,10730500,4657,-3937300,asm
2024-05-31,2148,7260500,3380.12,2310,9416000,4076,-2155500,asm
2024-05-30,2844,12462400,4382.0,2653,10739300,4048,1723100,asm
2024-05-29,2808,15998700,5697.54,3901,14854200,3808,1144500,asm
2024-05-28,1222,5710800,4673.32,1491,6313700,4235,-602900,asm
2024-05-27,1412,4108800,2909.92,1078,4921400,4565,-812600,asm
2024-05-24,3183,10992700,3453.57,2226,11529400,5179,-536700,asm
2024-05-23,2208,8757300,3966.17,1774,8338000,4700,419300,asm
2024-05-22,2985,10004000,3351.42,2455,10404100,4238,-400100,asm
2024-05-21,2841,12420600,4371.91,2245,10448100,4654,1972500,asm
2024-05-20,2420,12362100,5108.31,2856,10618400,3718,1743700,asm
2024-05-17,1990,11508700,5783.27,2675,10963500,4099,545200,asm
2024-05-16,1481,6329200,4273.6,1974,8903500,4510,-2574300,asm
2024-05-15,1617,7654300,4733.64,1733,7837700,4523,-183400,asm
2024-05-14,2284,7894800,3456.57,1194,8372500,7012,-477700,asm
2024-05-13,2225,8497900,3819.28,1419,7780900,5483,717000,asm
2024-05-10,1663,6816400,4098.86,1332,5893600,4425,922800,asm
2024-05-09,3290,18074000,5493.62,3722,19383900,5208,-1309900,asm
2024-05-08,2256,9382600,4158.95,1985,10150800,5114,-768200,asm
2024-05-07,3084,13473300,4368.77,1054,11340300,10759,2133000,asm
2024-05-06,1703,10029300,5889.2,1043,6728100,6451,3301200,asm
2024-05-03,846,3787800,4477.3,974,3726400,3826,61400,asm
2024-05-02,734,2037400,2775.75,649,2241200,3453,-203800,asm
2024-04-26,1324,4492700,3393.28,865,3848200,4449,644500,asm
2024-04-25,1223,3501300,2862.88,857,5027200,5866,-1525900,asm
2024-04-24,1078,6625700,6146.29,1583,5827300,3681,798400,asm
2024-04-23,913,3680400,4031.11,1204,4170200,3464,-489800,asm
2024-04-22,1259,5447400,4326.77,1250,4308800,3447,1138600,asm
2024-04-19,2421,9434900,3897.11,1813,8781000,4843,653900,asm
2024-04-17,1872,5597500,2990.12,1328,5710400,4300,-112900,asm
2024-04-16,4464,17316100,3879.05,3288,21104000,6418,-3787900,asm
2024-04-15,2054,6150300,2994.3,1900,14683100,7728,-8532800,asm
2024-04-12,2089,8979700,4298.56,2457,10312500,4197,-1332800,asm
2024-04-11,2087,6254300,2996.79,1220,6486800,5317,-232500,asm
2024-04-10,1983,6677100,3367.17,1557,10753700,6907,-4076600,asm
2024-04-09,1404,7982900,5685.83,1375,6268000,4559,1714900,asm
2024-04-08,1915,8074600,4216.5,1440,6052500,4203,2022100,asm
2024-04-05,3412,16679500,4888.48,3018,12766800,4230,3912700,asm
2024-04-04,3268,10471300,3204.19,1842,10496600,5698,-25300,asm
2024-04-03,2357,6549900,2778.91,2043,8003200,3917,-1453300,asm
2024-04-02,2027,9081300,4480.17,2005,7427000,3704,1654300,asm
2024-04-01,1924,8964800,4659.46,1481,7704300,5202,1260500,asm
2024-03-29,1898,6542700,3447.15,1733,8182800,4722,-1640100,asm
2024-03-28,2337,10265700,4392.68,2683,9572000,3568,693700,asm
2024-03-27,2142,6779500,3165.03,1942,9017800,4644,-2238300,asm
2024-03-26,3719,22622100,6082.84,2213,12365400,5588,10256700,asm
2024-03-25,2689,8996500,3345.67,1862,7366700,3956,1629800,asm
2024-03-22,2553,10044900,3934.55,2473,8182100,3309,1862800,asm
2024-03-21,3210,23185800,7222.99,2797,13535700,4839,9650100,asm
2024-03-20,1400,5360800,3829.14,1159,4973300,4291,387500,asm
2024-03-19,1765,6077000,3443.06,1307,6263100,4792,-186100,asm
2024-03-18,3428,12934400,3773.16,2788,14874300,5335,-1939900,asm
2024-03-15,2079,6499800,3126.41,2141,10319400,4820,-3819600,asm
2024-03-14,2858,12961500,4535.16,3423,15074100,4404,-2112600,asm
2024-03-13,1642,6823900,4155.85,1981,8496900,4289,-1673000,asm
2024-03-12,1222,3646500,2984.04,1008,5044700,5005,-1398200,asm
2024-03-11,1968,10092400,5128.25,2346,9248500,3942,843900,asm
2024-03-08,2005,6570300,3276.96,1122,6292600,5608,277700,asm
2024-03-07,1480,4668800,3154.59,1134,4422300,3900,246500,asm
2024-03-06,1842,5871000,3187.3,1310,7015000,5355,-1144000,asm
2024-03-05,1583,6393600,4038.91,1888,7510300,3978,-1116700,asm
2024-03-04,1602,5027900,3138.51,2169,8164000,3764,-3136100,asm
2024-03-01,1425,5158300,3619.86,1931,6399300,3314,-1241000,asm
2024-02-29,2130,9768400,4586.1,3076,12928500,4203,-3160100,asm
2024-02-28,1809,6231100,3444.5,1890,7211000,3815,-979900,asm
2024-02-27,2311,10342100,4475.16,3223,12711500,3944,-2369400,asm
2024-02-26,2931,19519800,6659.77,2064,8905300,4315,10614500,asm
2024-02-23,1429,5140900,3597.55,1973,9408200,4768,-4267300,asm
2024-02-22,1741,9988800,5737.39,1874,7577100,4043,2411700,asm
2024-02-21,1130,4119800,3645.84,1174,4946000,4213,-826200,asm
2024-02-20,1181,3980000,3370.03,1623,5536300,3411,-1556300,asm
2024-02-19,1428,4788200,3353.08,1657,5655800,3413,-867600,asm
2024-02-16,1838,11536200,6276.5,2063,7085200,3434,4451000,asm
2024-02-15,1063,3609800,3395.86,887,3171300,3575,438500,asm
2024-02-07,0,0,0.0,0,0,0,0,asm
2024-02-06,837,2756500,3293.31,560,2390500,4269,366000,asm
2024-02-05,1089,2471800,2269.79,817,4402000,5388,-1930200,asm
2024-02-02,842,2816500,3345.01,887,4335500,4888,-1519000,asm
2024-02-01,630,2362900,3750.63,687,2440900,3553,-78000,asm
2024-01-31,1560,5732900,3674.94,927,5613100,6055,119800,asm
2024-01-30,525,2252000,4289.52,1207,5071400,4202,-2819400,asm
2024-01-29,942,4945800,5250.32,1544,5068900,3283,-123100,asm
2024-01-26,1099,4319000,3929.94,1390,4594600,3305,-275600,asm
2024-01-25,882,3324600,3769.39,846,3006700,3554,317900,asm
2024-01-24,1163,3470600,2984.18,845,4195000,4964,-724400,asm
2024-01-23,1147,4605400,4015.17,692,2836400,4099,1769000,asm
2024-01-22,1896,6179600,3259.28,1122,7327300,6531,-1147700,asm
2024-01-19,839,3847300,4585.58,949,4221100,4448,-373800,asm
2024-01-18,908,4772300,5255.84,994,3598400,3620,1173900,asm
2024-01-17,1037,3905200,3765.86,903,3722400,4122,182800,asm
2024-09-12,40,140300,3507.5,51,164500,3225,-24200,asp
2024-09-11,37,23100,624.32,32,81900,2559,-58800,asp
2024-09-10,51,26900,527.45,38,92900,2445,-66000,asp
2024-09-09,24,19000,791.67,43,90200,2098,-71200,asp
2024-09-06,67,35200,525.37,32,44600,1394,-9400,asp
2024-09-05,46,53000,1152.17,38,85100,2239,-32100,asp
2024-09-04,55,71900,1307.27,40,76100,1902,-4200,asp
2024-08-30,44,34900,793.18,42,129300,3079,-94400,asp
2024-08-29,95,80000,842.11,48,102000,2125,-22000,asp
2024-08-28,66,61000,924.24,39,78300,2008,-17300,asp
2024-08-27,74,90200,1218.92,46,121100,2633,-30900,asp
2024-08-26,58,83800,1444.83,51,91300,1790,-7500,asp
2024-08-23,75,82600,1101.33,35,86800,2480,-4200,asp
2024-08-22,81,98900,1220.99,67,145700,2175,-46800,asp
2024-08-21,73,114900,1573.97,54,118400,2193,-3500,asp
2024-08-20,88,103800,1179.55,55,156200,2840,-52400,asp
2024-08-19,72,97600,1355.56,48,160300,3340,-62700,asp
2024-08-16,76,77100,1014.47,55,313800,5705,-236700,asp
2024-08-15,72,63900,887.5,30,225000,7500,-161100,asp
2024-08-14,37,69200,1870.27,37,53000,1432,16200,asp
2024-08-13,56,68800,1228.57,40,84300,2108,-15500,asp
2024-08-12,38,65800,1731.58,38,70600,1858,-4800,asp
2024-08-08,66,138600,2100.0,50,103300,2066,35300,asp
2024-08-07,60,151300,2521.67,44,114700,2607,36600,asp
2024-08-06,66,85400,1293.94,24,69700,2904,15700,asp
2024-08-05,72,62200,863.89,61,192200,3151,-130000,asp
2024-08-02,37,23100,624.32,54,165400,3063,-142300,asp
2024-08-01,46,45000,978.26,47,118300,2517,-73300,asp
2024-07-31,58,65000,1120.69,43,99200,2307,-34200,asp
2024-07-30,47,31700,674.47,42,89600,2133,-57900,asp
2024-07-29,47,46100,980.85,46,99800,2170,-53700,asp
2024-07-26,41,81600,1990.24,43,137100,3188,-55500,asp
2024-07-25,40,90100,2252.5,41,111300,2715,-21200,asp
2024-07-24,56,60600,1082.14,43,80400,1870,-19800,asp
2024-07-22,46,58800,1278.26,73,202100,2768,-143300,asp
2024-07-19,67,72600,1083.58,55,94300,1715,-21700,asp
2024-07-18,43,42200,981.4,51,82000,1608,-39800,asp
2024-07-17,82,67600,824.39,61,121400,1990,-53800,asp
2024-07-16,47,57600,1225.53,69,134000,1942,-76400,asp
2024-07-15,95,120200,1265.26,56,103800,1854,16400,asp
2024-07-12,135,326500,2418.52,132,293800,2226,32700,asp
2024-07-11,51,66100,1296.08,57,94700,1661,-28600,asp
2024-07-10,44,39400,895.45,63,129300,2052,-89900,asp
2024-07-09,53,61500,1160.38,42,134200,3195,-72700,asp
2024-07-08,50,40700,814.0,42,118100,2812,-77400,asp
2024-07-05,45,50100,1113.33,47,111900,2381,-61800,asp
2024-07-04,58,62200,1072.41,51,105300,2065,-43100,asp
2024-07-03,53,91100,1718.87,66,147400,2233,-56300,asp
2024-07-02,64,90100,1407.81,49,123700,2524,-33600,asp
2024-07-01,58,86000,1482.76,77,158200,2055,-72200,asp
2024-06-28,54,128200,2374.07,87,202600,2329,-74400,asp
2024-06-27,87,185600,2133.33,97,228600,2357,-43000,asp
2024-06-26,90,155200,1724.44,77,180000,2338,-24800,asp
2024-06-25,100,100300,1003.0,67,137000,2045,-36700,asp
2024-06-24,54,67400,1248.15,137,254500,1858,-187100,asp
2024-06-21,84,143500,1708.33,86,180800,2102,-37300,asp
2024-06-20,118,277800,2354.24,139,329600,2371,-51800,asp
2024-06-19,96,149800,1560.42,75,231800,3091,-82000,asp
2024-06-18,63,110400,1752.38,77,240200,3119,-129800,asp
2024-06-17,62,85000,1370.97,71,164500,2317,-79500,asp
2024-06-14,96,201500,2098.96,133,264600,1989,-63100,asp
2024-06-13,144,250800,1741.67,115,349700,3041,-98900,asp
2024-06-12,100,131100,1311.0,105,312000,2971,-180900,asp
2024-06-11,93,191000,2053.76,112,293100,2617,-102100,asp
2024-06-10,100,188600,1886.0,117,219200,1874,-30600,asp
2024-06-07,77,92100,1196.1,100,234400,2344,-142300,asp
2024-06-06,128,165000,1289.06,120,216900,1808,-51900,asp
2024-06-05,120,162500,1354.17,144,235400,1635,-72900,asp
2024-06-04,112,224200,2001.79,145,312100,2152,-87900,asp
2024-06-03,114,136300,1195.61,136,218500,1607,-82200,asp
2024-05-31,116,118300,1019.83,138,390200,2828,-271900,asp
2024-05-30,179,278300,1554.75,142,511300,3601,-233000,asp
2024-05-29,234,293600,1254.7,248,843700,3402,-550100,asp
2024-05-28,137,365400,2667.15,126,278800,2213,86600,asp
2024-05-27,171,269900,1578.36,88,176300,2003,93600,asp
2024-05-24,337,644200,1911.57,269,705500,2623,-61300,asp
2024-05-23,434,958100,2207.6,212,234200,1105,723900,asp
2024-05-22,114,152000,1333.33,104,123800,1190,28200,asp
2024-05-21,133,135300,1017.29,93,150700,1620,-15400,asp
2024-05-20,135,137200,1016.3,115,157700,1371,-20500,asp
2024-05-17,88,194500,2210.23,75,200700,2676,-6200,asp
2024-05-16,95,150600,1585.26,76,120100,1580,30500,asp
2024-05-15,110,152300,1384.55,65,139300,2143,13000,asp
2024-05-14,101,177800,1760.4,62,158500,2556,19300,asp
2024-05-13,97,115200,1187.63,66,78000,1182,37200,asp
2024-05-10,103,179100,1738.83,91,145300,1597,33800,asp
2024-05-09,108,181700,1682.41,77,132700,1723,49000,asp
2024-05-08,111,236800,2133.33,77,147200,1912,89600,asp
2024-05-07,134,983600,7340.3,68,260300,3828,723300,asp
2024-05-06,135,439300,3254.07,65,460100,7078,-20800,asp
2024-05-03,117,156300,1335.9,59,206200,3495,-49900,asp
2024-05-02,104,269700,2593.27,69,195300,2830,74400,asp
2024-04-26,91,240600,2643.96,56,81200,1450,159400,asp
2024-04-25,136,492500,3621.32,81,230300,2843,262200,asp
2024-04-24,127,243400,1916.54,69,173000,2507,70400,asp
2024-04-23,71,58100,818.31,73,77900,1067,-19800,asp
2024-04-22,93,469900,5052.69,45,105400,2342,364500,asp
2024-04-19,156,170500,1092.95,85,124300,1462,46200,asp
2024-04-17,115,148600,1292.17,91,136400,1499,12200,asp
2024-04-16,184,478500,2600.54,125,336300,2690,142200,asp
2024-04-15,212,183100,863.68,112,409200,3654,-226100,asp
2024-04-12,145,188400,1299.31,81,270900,3344,-82500,asp
2024-04-11,111,110200,992.79,72,137700,1912,-27500,asp
2024-04-10,202,264900,1311.39,106,319100,3010,-54200,asp
2024-04-09,119,131500,1105.04,101,277700,2750,-146200,asp
2024-04-08,123,205500,1670.73,99,218700,2209,-13200,asp
2024-04-05,108,174600,1616.67,105,201600,1920,-27000,asp
2024-04-04,69,131200,1901.45,88,158600,1802,-27400,asp
2024-04-03,157,385000,2452.23,118,430000,3644,-45000,asp
2024-04-02,102,239100,2344.12,83,169700,2045,69400,asp
2024-04-01,134,349500,2608.21,122,472000,3869,-122500,asp
2024-03-29,134,182500,1361.94,100,274800,2748,-92300,asp
2024-03-28,132,109400,828.79,102,221700,2174,-112300,asp
2024-03-27,178,343100,1927.53,121,394800,3263,-51700,asp
2024-03-26,176,287800,1635.23,127,265500,2091,22300,asp
2024-03-25,237,610400,2575.53,197,570200,2894,40200,asp
2024-03-22,367,1446200,3940.6,167,844800,5059,601400,asp
2024-03-21,466,1631600,3501.29,188,1528100,8128,103500,asp
2024-03-20,170,291200,1712.94,125,427300,3418,-136100,asp
2024-03-19,162,258500,1595.68,109,243600,2235,14900,asp
2024-03-18,183,217700,1189.62,89,255900,2875,-38200,asp
2024-03-15,107,252000,2355.14,328,233400,712,18600,asp
2024-03-14,98,123800,1263.27,77,131500,1708,-7700,asp
2024-03-13,115,160800,1398.26,86,170900,1987,-10100,asp
2024-03-12,61,79100,1296.72,71,151900,2139,-72800,asp
2024-03-11,86,115600,1344.19,97,153000,1577,-37400,asp
2024-03-08,114,271900,2385.09,71,228200,3214,43700,asp
2024-03-07,86,82600,960.47,65,96100,1478,-13500,asp
2024-03-06,113,268800,2378.76,75,105400,1405,163400,asp
2024-03-05,105,463700,4416.19,89,119900,1347,343800,asp
2024-03-04,130,174000,1338.46,64,124600,1947,49400,asp
2024-03-01,179,299400,1672.63,68,106400,1565,193000,asp
2024-02-29,106,147800,1394.34,61,177400,2908,-29600,asp
2024-02-28,143,112600,787.41,90,314800,3498,-202200,asp
2024-02-27,138,250900,1818.12,76,177500,2336,73400,asp
2024-02-26,119,78500,659.66,57,98300,1725,-19800,asp
2024-02-23,133,158300,1190.23,75,238500,3180,-80200,asp
2024-02-22,178,268800,1510.11,58,132500,2284,136300,asp
2024-02-21,122,217100,1779.51,73,148400,2033,68700,asp
2024-02-20,117,220700,1886.32,64,131300,2052,89400,asp
2024-02-19,93,119800,1288.17,64,77300,1208,42500,asp
2024-02-16,136,254500,1871.32,95,229600,2417,24900,asp
2024-02-15,73,100100,1371.23,65,110500,1700,-10400,asp
2024-02-07,0,0,0.0,0,0,0,0,asp
2024-02-06,79,96100,1216.46,97,221100,2279,-125000,asp
2024-02-05,159,318200,2001.26,54,91000,1685,227200,asp
2024-02-02,66,81300,1231.82,117,262400,2243,-181100,asp
2024-02-01,64,46300,723.44,86,159500,1855,-113200,asp
2024-01-31,60,57400,956.67,58,103800,1790,-46400,asp
2024-01-30,76,73100,961.84,117,210400,1798,-137300,asp
2024-01-29,70,87400,1248.57,83,141200,1701,-53800,asp
2024-01-26,60,79300,1321.67,67,187000,2791,-107700,asp
2024-01-25,117,173600,1483.76,72,184200,2558,-10600,asp
2024-01-24,102,141100,1383.33,83,166200,2002,-25100,asp
2024-01-23,89,92800,1042.7,80,179300,2241,-86500,asp
2024-01-22,118,166400,1410.17,69,183700,2662,-17300,asp
2024-01-19,113,163600,1447.79,92,130100,1414,33500,asp
2024-01-18,77,93700,1216.88,81,123700,1527,-30000,asp
2024-01-17,125,179500,1436.0,84,143400,1707,36100,asp
2024-01-16,89,172700,1940.45,69,126800,1838,45900,asp
2024-01-15,73,150900,2067.12,56,113000,2018,37900,asp
2024-01-12,105,138400,1318.1,94,164600,1751,-26200,asp
2024-01-11,169,257400,1523.08,106,259800,2451,-2400,asp
2024-01-10,0,0,0.0,0,0,0,0,asp
2024-01-09,132,171500,1299.24,100,304900,3049,-133400,asp
2024-01-08,100,222100,2221.0,131,199900,1526,22200,asp
2024-01-05,124,308900,2491.13,147,358300,2437,-49400,asp
2024-01-04,173,414500,2395.95,202,413000,2045,1500,asp
2024-01-03,188,376300,2001.6,149,243400,1634,132900,asp
2024-01-02,173,242500,1401.73,94,123700,1316,118800,asp
2024-09-12,0,0,0.0,0,0,0,0,ata
2024-09-11,0,0,0.0,0,0,0,0,ata
2024-09-10,0,0,0.0,0,0,0,0,ata
2024-09-09,0,0,0.0,0,0,0,0,ata
2024-09-06,21,55000,2619.05,21,136400,6495,-81400,ata
2024-09-05,0,0,0.0,0,0,0,0,ata
2024-09-04,0,0,0.0,0,0,0,0,ata
2024-08-30,15,46700,3113.33,16,42100,2631,4600,ata
2024-08-29,0,0,0.0,0,0,0,0,ata
2024-08-28,0,0,0.0,0,0,0,0,ata
2024-08-27,0,0,0.0,0,0,0,0,ata
2024-08-26,0,0,0.0,0,0,0,0,ata
2024-08-23,15,21400,1426.67,21,120800,5752,-99400,ata
2024-08-22,0,0,0.0,0,0,0,0,ata
2024-08-21,0,0,0.0,0,0,0,0,ata
2024-08-20,0,0,0.0,0,0,0,0,ata
2024-08-19,0,0,0.0,0,0,0,0,ata
2024-08-16,34,23500,691.18,23,96700,4204,-73200,ata
2024-08-15,0,0,0.0,0,0,0,0,ata
2024-08-14,0,0,0.0,0,0,0,0,ata
2024-08-13,0,0,0.0,0,0,0,0,ata
2024-08-12,0,0,0.0,0,0,0,0,ata
2024-08-09,28,35100,1253.57,18,105300,5850,-70200,ata
2024-08-08,0,0,0.0,0,0,0,0,ata
2024-08-07,0,0,0.0,0,0,0,0,ata
2024-08-06,0,0,0.0,0,0,0,0,ata
2024-08-05,0,0,0.0,0,0,0,0,ata
2024-08-02,10,9000,900.0,15,155700,10380,-146700,ata
2024-08-01,0,0,0.0,0,0,0,0,ata
2024-07-31,0,0,0.0,0,0,0,0,ata
2024-07-30,0,0,0.0,0,0,0,0,ata
2024-07-29,0,0,0.0,0,0,0,0,ata
2024-07-26,6,11400,1900.0,20,149200,7460,-137800,ata
2024-07-25,0,0,0.0,0,0,0,0,ata
2024-07-24,0,0,0.0,0,0,0,0,ata
2024-07-23,0,0,0.0,0,0,0,0,ata
2024-07-22,0,0,0.0,0,0,0,0,ata
2024-07-19,16,38600,2412.5,19,135700,7142,-97100,ata
2024-07-18,0,0,0.0,0,0,0,0,ata
2024-07-17,0,0,0.0,0,0,0,0,ata
2024-07-16,0,0,0.0,0,0,0,0,ata
2024-07-15,0,0,0.0,0,0,0,0,ata
2024-07-12,28,87300,3117.86,19,165800,8726,-78500,ata
2024-07-11,0,0,0.0,0,0,0,0,ata
2024-07-10,0,0,0.0,0,0,0,0,ata
2024-07-09,0,0,0.0,0,0,0,0,ata
2024-07-08,0,0,0.0,0,0,0,0,ata
2024-07-05,23,34100,1482.61,20,139900,6995,-105800,ata
2024-07-04,0,0,0.0,0,0,0,0,ata
2024-07-03,0,0,0.0,0,0,0,0,ata
2024-07-02,0,0,0.0,0,0,0,0,ata
2024-07-01,0,0,0.0,0,0,0,0,ata
2024-06-28,23,53200,2313.04,18,145600,8089,-92400,ata
2024-06-27,0,0,0.0,0,0,0,0,ata
2024-06-26,0,0,0.0,0,0,0,0,ata
2024-06-25,0,0,0.0,0,0,0,0,ata
2024-06-24,0,0,0.0,0,0,0,0,ata
2024-06-21,22,86100,3913.64,22,154400,7018,-68300,ata
2024-06-20,0,0,0.0,0,0,0,0,ata
2024-06-19,0,0,0.0,0,0,0,0,ata
2024-06-18,0,0,0.0,0,0,0,0,ata
2024-06-17,0,0,0.0,0,0,0,0,ata
2024-06-14,34,135800,3994.12,31,196700,6345,-60900,ata
2024-06-13,0,0,0.0,0,0,0,0,ata
2024-06-12,0,0,0.0,0,0,0,0,ata
2024-06-11,0,0,0.0,0,0,0,0,ata
2024-06-10,0,0,0.0,0,0,0,0,ata
2024-06-07,46,225600,4904.35,32,167300,5228,58300,ata
2024-06-06,0,0,0.0,0,0,0,0,ata
2024-06-05,0,0,0.0,0,0,0,0,ata
2024-06-04,0,0,0.0,0,0,0,0,ata
2024-06-03,0,0,0.0,0,0,0,0,ata
2024-05-31,17,33400,1964.71,20,140700,7035,-107300,ata
2024-05-30,0,0,0.0,0,0,0,0,ata
2024-05-29,0,0,0.0,0,0,0,0,ata
2024-05-28,0,0,0.0,0,0,0,0,ata
2024-05-27,0,0,0.0,0,0,0,0,ata
2024-05-24,17,41100,2417.65,28,135300,4832,-94200,ata
2024-05-23,0,0,0.0,0,0,0,0,ata
2024-05-22,0,0,0.0,0,0,0,0,ata
2024-05-21,0,0,0.0,0,0,0,0,ata
2024-05-20,0,0,0.0,0,0,0,0,ata
2024-05-17,19,48800,2568.42,33,126700,3839,-77900,ata
2024-05-16,0,0,0.0,0,0,0,0,ata
2024-05-15,0,0,0.0,0,0,0,0,ata
2024-05-14,0,0,0.0,0,0,0,0,ata
2024-05-13,0,0,0.0,0,0,0,0,ata
2024-05-10,17,28900,1700.0,18,80200,4456,-51300,ata
2024-05-09,0,0,0.0,0,0,0,0,ata
2024-05-08,0,0,0.0,0,0,0,0,ata
2024-05-07,0,0,0.0,0,0,0,0,ata
2024-05-06,0,0,0.0,0,0,0,0,ata
2024-05-03,15,35100,2340.0,12,109100,9092,-74000,ata
2024-05-02,0,0,0.0,0,0,0,0,ata
2024-04-26,13,36500,2807.69,7,71000,10143,-34500,ata
2024-04-25,0,0,0.0,0,0,0,0,ata
2024-04-24,0,0,0.0,0,0,0,0,ata
2024-04-23,0,0,0.0,0,0,0,0,ata
2024-04-22,0,0,0.0,0,0,0,0,ata
2024-04-19,19,142700,7510.53,26,236100,9081,-93400,ata
2024-04-17,0,0,0.0,0,0,0,0,ata
2024-04-16,0,0,0.0,0,0,0,0,ata
2024-04-15,0,0,0.0,0,0,0,0,ata
2024-04-12,29,70000,2413.79,28,212500,7589,-142500,ata
2024-04-11,0,0,0.0,0,0,0,0,ata
2024-04-10,0,0,0.0,0,0,0,0,ata
2024-04-09,0,0,0.0,0,0,0,0,ata
2024-04-08,0,0,0.0,0,0,0,0,ata
2024-04-05,9,26800,2977.78,21,158000,7524,-131200,ata
2024-04-04,0,0,0.0,0,0,0,0,ata
2024-04-03,0,0,0.0,0,0,0,0,ata
2024-04-02,0,0,0.0,0,0,0,0,ata
2024-04-01,0,0,0.0,0,0,0,0,ata
2024-03-29,27,140300,5196.3,32,236800,7400,-96500,ata
2024-03-28,0,0,0.0,0,0,0,0,ata
2024-03-27,0,0,0.0,0,0,0,0,ata
2024-03-26,0,0,0.0,0,0,0,0,ata
2024-03-25,0,0,0.0,0,0,0,0,ata
2024-03-22,26,59900,2303.85,39,117600,3015,-57700,ata
2024-03-21,0,0,0.0,0,0,0,0,ata
2024-03-20,0,0,0.0,0,0,0,0,ata
2024-03-19,0,0,0.0,0,0,0,0,ata
2024-03-18,0,0,0.0,0,0,0,0,ata
2024-03-15,45,155400,3453.33,75,189500,2527,-34100,ata
2024-03-14,0,0,0.0,0,0,0,0,ata
2024-03-13,0,0,0.0,0,0,0,0,ata
2024-03-12,0,0,0.0,0,0,0,0,ata
2024-03-11,0,0,0.0,0,0,0,0,ata
2024-03-08,35,161100,4602.86,29,115300,3976,45800,ata
2024-03-07,0,0,0.0,0,0,0,0,ata
2024-03-06,0,0,0.0,0,0,0,0,ata
2024-03-05,0,0,0.0,0,0,0,0,ata
2024-03-04,0,0,0.0,0,0,0,0,ata
2024-03-01,22,27000,1227.27,31,156100,5035,-129100,ata
2024-02-29,0,0,0.0,0,0,0,0,ata
2024-02-28,0,0,0.0,0,0,0,0,ata
2024-02-27,0,0,0.0,0,0,0,0,ata
2024-02-26,0,0,0.0,0,0,0,0,ata
2024-02-23,32,100200,3131.25,20,82100,4105,18100,ata
2024-02-22,0,0,0.0,0,0,0,0,ata
2024-02-21,0,0,0.0,0,0,0,0,ata
2024-02-20,0,0,0.0,0,0,0,0,ata
2024-02-19,0,0,0.0,0,0,0,0,ata
2024-02-16,30,48200,1606.67,22,120300,5468,-72100,ata
2024-02-15,0,0,0.0,0,0,0,0,ata
2024-02-07,0,0,0.0,0,0,0,0,ata
2024-02-06,0,0,0.0,0,0,0,0,ata
2024-02-05,0,0,0.0,0,0,0,0,ata
2024-02-02,15,46000,3066.67,17,78400,4612,-32400,ata
2024-02-01,0,0,0.0,0,0,0,0,ata
2024-01-31,0,0,0.0,0,0,0,0,ata
2024-01-30,0,0,0.0,0,0,0,0,ata
2024-01-29,0,0,0.0,0,0,0,0,ata
2024-01-26,32,353700,11053.12,22,80600,3664,273100,ata
2024-01-25,0,0,0.0,0,0,0,0,ata
2024-01-24,0,0,0.0,0,0,0,0,ata
2024-01-23,0,0,0.0,0,0,0,0,ata
2024-01-22,0,0,0.0,0,0,0,0,ata
2024-01-19,27,209000,7740.74,27,108000,4000,101000,ata
2024-01-18,0,0,0.0,0,0,0,0,ata
2024-01-17,0,0,0.0,0,0,0,0,ata
2024-01-16,0,0,0.0,0,0,0,0,ata
2024-01-15,0,0,0.0,0,0,0,0,ata
2024-01-12,17,21200,1247.06,22,83600,3800,-62400,ata
2024-01-11,0,0,0.0,0,0,0,0,ata
2024-01-10,0,0,0.0,0,0,0,0,ata
2024-01-09,0,0,0.0,0,0,0,0,ata
2024-01-08,0,0,0.0,0,0,0,0,ata
2024-01-05,23,123800,5382.61,18,182800,10156,-59000,ata
2024-01-04,0,0,0.0,0,0,0,0,ata
2024-01-03,0,0,0.0,0,0,0,0,ata
2024-01-02,0,0,0.0,0,0,0,0,ata
2024-09-12,0,0,0.0,0,0,0,0,atg
2024-09-11,0,0,0.0,0,0,0,0,atg
2024-09-10,0,0,0.0,0,0,0,0,atg
2024-09-09,0,0,0.0,0,0,0,0,atg
2024-09-06,10,31600,3160.0,11,23900,2173,7700,atg
2024-09-05,0,0,0.0,0,0,0,0,atg
2024-09-04,0,0,0.0,0,0,0,0,atg
2024-08-30,15,38900,2593.33,15,41000,2733,-2100,atg
2024-08-29,0,0,0.0,0,0,0,0,atg
2024-08-28,0,0,0.0,0,0,0,0,atg
2024-08-27,0,0,0.0,0,0,0,0,atg
2024-08-26,0,0,0.0,0,0,0,0,atg
2024-08-23,15,75700,5046.67,12,62200,5183,13500,atg
2024-08-22,0,0,0.0,0,0,0,0,atg
2024-08-21,0,0,0.0,0,0,0,0,atg
2024-08-20,0,0,0.0,0,0,0,0,atg
2024-08-19,0,0,0.0,0,0,0,0,atg
2024-08-16,9,5800,644.44,11,41700,3791,-35900,atg
2024-08-15,0,0,0.0,0,0,0,0,atg
2024-08-14,0,0,0.0,0,0,0,0,atg
2024-08-13,0,0,0.0,0,0,0,0,atg
2024-08-12,0,0,0.0,0,0,0,0,atg
2024-08-09,17,93800,5517.65,12,94800,7900,-1000,atg
2024-08-08,0,0,0.0,0,0,0,0,atg
2024-08-07,0,0,0.0,0,0,0,0,atg
2024-08-06,0,0,0.0,0,0,0,0,atg
2024-08-05,0,0,0.0,0,0,0,0,atg
2024-08-02,11,5700,518.18,9,18900,2100,-13200,atg
2024-08-01,0,0,0.0,0,0,0,0,atg
2024-07-31,0,0,0.0,0,0,0,0,atg
2024-07-30,0,0,0.0,0,0,0,0,atg
2024-07-29,0,0,0.0,0,0,0,0,atg
2024-07-26,16,7400,462.5,26,25500,981,-18100,atg
2024-07-25,0,0,0.0,0,0,0,0,atg
2024-07-24,0,0,0.0,0,0,0,0,atg
2024-07-23,0,0,0.0,0,0,0,0,atg
2024-07-22,0,0,0.0,0,0,0,0,atg
2024-07-19,25,38700,1548.0,22,50500,2295,-11800,atg
2024-07-18,0,0,0.0,0,0,0,0,atg
2024-07-17,0,0,0.0,0,0,0,0,atg
2024-07-16,0,0,0.0,0,0,0,0,atg
2024-07-15,0,0,0.0,0,0,0,0,atg
2024-07-12,39,49900,1279.49,30,110300,3677,-60400,atg
2024-07-11,0,0,0.0,0,0,0,0,atg
2024-07-10,0,0,0.0,0,0,0,0,atg
2024-07-09,0,0,0.0,0,0,0,0,atg
2024-07-08,0,0,0.0,0,0,0,0,atg
2024-07-05,6,1400,233.33,23,77100,3352,-75700,atg
2024-07-04,0,0,0.0,0,0,0,0,atg
2024-07-03,0,0,0.0,0,0,0,0,atg
2024-07-02,0,0,0.0,0,0,0,0,atg
2024-07-01,0,0,0.0,0,0,0,0,atg
2024-06-28,12,40400,3366.67,29,153000,5276,-112600,atg
2024-06-27,0,0,0.0,0,0,0,0,atg
2024-06-26,0,0,0.0,0,0,0,0,atg
2024-06-25,0,0,0.0,0,0,0,0,atg
2024-06-24,0,0,0.0,0,0,0,0,atg
2024-06-21,14,250600,17900.0,37,315400,8524,-64800,atg
2024-06-20,0,0,0.0,0,0,0,0,atg
2024-06-19,0,0,0.0,0,0,0,0,atg
2024-06-18,0,0,0.0,0,0,0,0,atg
2024-06-17,0,0,0.0,0,0,0,0,atg
2024-06-14,15,64600,4306.67,24,100400,4183,-35800,atg
2024-06-13,0,0,0.0,0,0,0,0,atg
2024-06-12,0,0,0.0,0,0,0,0,atg
2024-06-11,0,0,0.0,0,0,0,0,atg
2024-06-10,0,0,0.0,0,0,0,0,atg
2024-06-07,26,302300,11626.92,54,394600,7307,-92300,atg
2024-06-06,0,0,0.0,0,0,0,0,atg
2024-06-05,0,0,0.0,0,0,0,0,atg
2024-06-04,0,0,0.0,0,0,0,0,atg
2024-06-03,0,0,0.0,0,0,0,0,atg
2024-05-31,28,83500,2982.14,49,238600,4869,-155100,atg
2024-05-30,0,0,0.0,0,0,0,0,atg
2024-05-29,0,0,0.0,0,0,0,0,atg
2024-05-28,0,0,0.0,0,0,0,0,atg
2024-05-27,0,0,0.0,0,0,0,0,atg
2024-05-24,22,316000,14363.64,52,502100,9656,-186100,atg
2024-05-23,0,0,0.0,0,0,0,0,atg
2024-05-22,0,0,0.0,0,0,0,0,atg
2024-05-21,0,0,0.0,0,0,0,0,atg
2024-05-20,0,0,0.0,0,0,0,0,atg
2024-05-17,25,207900,8316.0,57,374800,6575,-166900,atg
2024-05-16,0,0,0.0,0,0,0,0,atg
2024-05-15,0,0,0.0,0,0,0,0,atg
2024-05-14,0,0,0.0,0,0,0,0,atg
2024-05-13,0,0,0.0,0,0,0,0,atg
2024-05-10,40,326300,8157.5,70,513600,7337,-187300,atg
2024-05-09,0,0,0.0,0,0,0,0,atg
2024-05-08,0,0,0.0,0,0,0,0,atg
2024-05-07,0,0,0.0,0,0,0,0,atg
2024-05-06,0,0,0.0,0,0,0,0,atg
2024-05-03,36,174400,4844.44,64,391100,6111,-216700,atg
2024-05-02,0,0,0.0,0,0,0,0,atg
2024-04-26,44,342200,7777.27,75,416900,5559,-74700,atg
2024-04-25,0,0,0.0,0,0,0,0,atg
2024-04-24,0,0,0.0,0,0,0,0,atg
2024-04-23,0,0,0.0,0,0,0,0,atg
2024-04-22,0,0,0.0,0,0,0,0,atg
2024-04-19,73,192900,2642.47,102,500900,4911,-308000,atg
2024-04-17,0,0,0.0,0,0,0,0,atg
2024-04-16,0,0,0.0,0,0,0,0,atg
2024-04-15,0,0,0.0,0,0,0,0,atg
2024-04-12,48,382500,7968.75,39,206100,5285,176400,atg
2024-04-11,0,0,0.0,0,0,0,0,atg
2024-04-10,0,0,0.0,0,0,0,0,atg
2024-04-09,0,0,0.0,0,0,0,0,atg
2024-04-08,0,0,0.0,0,0,0,0,atg
2024-04-05,86,538000,6255.81,92,516400,5613,21600,atg
2024-04-04,0,0,0.0,0,0,0,0,atg
2024-04-03,0,0,0.0,0,0,0,0,atg
2024-04-02,0,0,0.0,0,0,0,0,atg
2024-04-01,0,0,0.0,0,0,0,0,atg
2024-03-29,59,372200,6308.47,68,340100,5001,32100,atg
2024-03-28,0,0,0.0,0,0,0,0,atg
2024-03-27,0,0,0.0,0,0,0,0,atg
2024-03-26,0,0,0.0,0,0,0,0,atg
2024-03-25,0,0,0.0,0,0,0,0,atg
2024-03-22,40,218700,5467.5,39,154400,3959,64300,atg
2024-03-21,0,0,0.0,0,0,0,0,atg
2024-03-20,0,0,0.0,0,0,0,0,atg
2024-03-19,0,0,0.0,0,0,0,0,atg
2024-03-18,0,0,0.0,0,0,0,0,atg
2024-03-15,49,207300,4230.61,48,199500,4156,7800,atg
2024-03-14,0,0,0.0,0,0,0,0,atg
2024-03-13,0,0,0.0,0,0,0,0,atg
2024-03-12,0,0,0.0,0,0,0,0,atg
2024-03-11,0,0,0.0,0,0,0,0,atg
2024-03-08,61,401300,6578.69,67,383300,5721,18000,atg
2024-03-07,0,0,0.0,0,0,0,0,atg
2024-03-06,0,0,0.0,0,0,0,0,atg
2024-03-05,0,0,0.0,0,0,0,0,atg
2024-03-04,0,0,0.0,0,0,0,0,atg
2024-03-01,50,209400,4188.0,57,253200,4442,-43800,atg
2024-02-29,0,0,0.0,0,0,0,0,atg
2024-02-28,0,0,0.0,0,0,0,0,atg
2024-02-27,0,0,0.0,0,0,0,0,atg
2024-02-26,0,0,0.0,0,0,0,0,atg
2024-02-23,40,185000,4625.0,61,234000,3836,-49000,atg
2024-02-22,0,0,0.0,0,0,0,0,atg
2024-02-21,0,0,0.0,0,0,0,0,atg
2024-02-20,0,0,0.0,0,0,0,0,atg
2024-02-19,0,0,0.0,0,0,0,0,atg
2024-02-16,40,143200,3580.0,20,157900,7895,-14700,atg
2024-02-15,0,0,0.0,0,0,0,0,atg
2024-02-07,0,0,0.0,0,0,0,0,atg
2024-02-06,0,0,0.0,0,0,0,0,atg
2024-02-05,0,0,0.0,0,0,0,0,atg
2024-02-02,33,170300,5160.61,27,121200,4489,49100,atg
2024-02-01,0,0,0.0,0,0,0,0,atg
2024-01-31,0,0,0.0,0,0,0,0,atg
2024-01-30,0,0,0.0,0,0,0,0,atg
2024-01-29,0,0,0.0,0,0,0,0,atg
2024-01-26,26,204000,7846.15,26,262400,10092,-58400,atg
2024-01-25,0,0,0.0,0,0,0,0,atg
2024-01-24,0,0,0.0,0,0,0,0,atg
2024-01-23,0,0,0.0,0,0,0,0,atg
2024-01-22,0,0,0.0,0,0,0,0,atg
2024-01-19,16,43400,2712.5,10,68700,6870,-25300,atg
2024-01-18,0,0,0.0,0,0,0,0,atg
2024-01-17,0,0,0.0,0,0,0,0,atg
2024-01-16,0,0,0.0,0,0,0,0,atg
2024-01-15,0,0,0.0,0,0,0,0,atg
2024-01-12,23,71000,3086.96,16,137800,8612,-66800,atg
2024-01-11,0,0,0.0,0,0,0,0,atg
2024-01-10,0,0,0.0,0,0,0,0,atg
2024-01-09,0,0,0.0,0,0,0,0,atg
2024-01-08,0,0,0.0,0,0,0,0,atg
2024-01-05,46,413600,8991.3,34,464300,13656,-50700,atg
2024-01-04,0,0,0.0,0,0,0,0,atg
2024-01-03,0,0,0.0,0,0,0,0,atg
2024-01-02,0,0,0.0,0,0,0,0,atg
2024-09-12,0,0,0.0,2,3500,1750,-3500,ats
2024-09-11,0,0,0.0,1,1800,1800,-1800,ats
2024-09-10,0,0,0.0,2,2000,1000,-2000,ats
2024-09-09,0,0,0.0,4,3800,950,-3800,ats
2024-09-06,0,0,0.0,3,2200,733,-2200,ats
2024-09-05,1,3000,3000.0,4,5100,1275,-2100,ats
2024-09-04,0,0,0.0,4,2100,525,-2100,ats
2024-08-30,0,0,0.0,6,2100,350,-2100,ats
2024-08-29,0,0,0.0,4,2500,625,-2500,ats
2024-08-28,0,0,0.0,5,2100,420,-2100,ats
2024-08-27,0,0,0.0,5,5700,1140,-5700,ats
2024-08-26,0,0,0.0,5,5200,1040,-5200,ats
2024-08-23,0,0,0.0,4,5100,1275,-5100,ats
2024-08-22,0,0,0.0,4,8000,2000,-8000,ats
2024-08-21,0,0,0.0,4,5000,1250,-5000,ats
2024-08-20,0,0,0.0,5,5100,1020,-5100,ats
2024-08-19,0,0,0.0,4,5400,1350,-5400,ats
2024-08-16,2,300,150.0,5,5300,1060,-5000,ats
2024-08-15,1,100,100.0,7,5900,843,-5800,ats
2024-08-14,1,100,100.0,8,4200,525,-4100,ats
2024-08-13,1,600,600.0,5,4800,960,-4200,ats
2024-08-12,0,0,0.0,9,8200,911,-8200,ats
2024-08-09,1,500,500.0,7,8300,1186,-7800,ats
2024-08-08,0,0,0.0,6,7500,1250,-7500,ats
2024-08-07,3,1100,366.67,7,7900,1129,-6800,ats
2024-08-06,5,9300,1860.0,14,21800,1557,-12500,ats
2024-08-05,0,0,0.0,6,10900,1817,-10900,ats
2024-08-02,0,0,0.0,5,11200,2240,-11200,ats
2024-08-01,0,0,0.0,6,10900,1817,-10900,ats
2024-07-31,0,0,0.0,4,10700,2675,-10700,ats
2024-07-30,0,0,0.0,7,11300,1614,-11300,ats
2024-07-29,0,0,0.0,9,11000,1222,-11000,ats
2024-07-26,0,0,0.0,7,11200,1600,-11200,ats
2024-07-25,1,2000,2000.0,6,8800,1467,-6800,ats
2024-07-24,0,0,0.0,7,8300,1186,-8300,ats
2024-07-23,0,0,0.0,5,7800,1560,-7800,ats
2024-07-22,0,0,0.0,7,7100,1014,-7100,ats
2024-07-19,1,100,100.0,9,6400,711,-6300,ats
2024-07-18,0,0,0.0,7,5600,800,-5600,ats
2024-07-17,1,100,100.0,6,5100,850,-5000,ats
2024-07-16,3,1000,333.33,7,4700,671,-3700,ats
2024-07-15,0,0,0.0,5,2800,560,-2800,ats
2024-07-12,0,0,0.0,5,2200,440,-2200,ats
2024-07-11,0,0,0.0,6,2500,417,-2500,ats
2024-07-10,1,500,500.0,5,4300,860,-3800,ats
2024-07-09,7,2500,357.14,4,1300,325,1200,ats
2024-07-08,1,400,400.0,4,3200,800,-2800,ats
2024-07-05,0,0,0.0,4,3100,775,-3100,ats
2024-07-04,1,100,100.0,4,2700,675,-2600,ats
2024-07-03,6,2400,400.0,3,1600,533,800,ats
2024-07-02,1,200,200.0,3,1800,600,-1600,ats
2024-07-01,6,21100,3516.67,5,20600,4120,500,ats
2024-06-28,6,2100,350.0,7,1600,229,500,ats
2024-06-27,5,1800,360.0,10,600,60,1200,ats
2024-06-26,4,700,175.0,7,900,129,-200,ats
2024-06-25,4,300,75.0,1,400,400,-100,ats
2024-06-24,6,1500,250.0,10,3400,340,-1900,ats
2024-06-21,6,800,133.33,10,2300,230,-1500,ats
2024-06-20,14,4000,285.71,20,32000,1600,-28000,ats
2024-06-19,22,9900,450.0,24,17900,746,-8000,ats
2024-06-18,21,7200,342.86,22,12000,545,-4800,ats
2024-06-17,16,7500,468.75,21,13700,652,-6200,ats
2024-06-14,12,8700,725.0,12,8000,667,700,ats
2024-06-13,2,200,100.0,8,8000,1000,-7800,ats
2024-06-12,10,23800,2380.0,12,25200,2100,-1400,ats
2024-06-11,11,28600,2600.0,12,5000,417,23600,ats
2024-06-10,10,26300,2630.0,10,2500,250,23800,ats
2024-06-07,4,400,100.0,7,2900,414,-2500,ats
2024-06-06,7,800,114.29,6,2000,333,-1200,ats
2024-06-05,3,800,266.67,5,1400,280,-600,ats
2024-06-04,3,600,200.0,6,900,150,-300,ats
2024-06-03,3,400,133.33,1,100,100,300,ats
2024-05-31,3,400,133.33,0,0,0,400,ats
2024-05-30,2,200,100.0,0,0,0,200,ats
2024-05-29,5,500,100.0,0,0,0,500,ats
2024-05-28,2,300,150.0,0,0,0,300,ats
2024-05-27,2,400,200.0,0,0,0,400,ats
2024-05-24,7,400,57.14,2,300,150,100,ats
2024-05-23,3,300,100.0,9,2000,222,-1700,ats
2024-05-22,2,3200,1600.0,8,2900,362,300,ats
2024-05-21,13,1000,76.92,3,500,167,500,ats
2024-05-20,11,1100,100.0,12,4000,333,-2900,ats
2024-05-17,11,1300,118.18,12,2700,225,-1400,ats
2024-05-16,2,200,100.0,1,100,100,100,ats
2024-05-15,1,100,100.0,1,1800,1800,-1700,ats
2024-05-14,1,100,100.0,3,2200,733,-2100,ats
2024-05-13,1,100,100.0,2,1900,950,-1800,ats
2024-05-10,1,100,100.0,2,400,200,-300,ats
2024-05-09,3,22500,7500.0,5,22600,4520,-100,ats
2024-05-08,2,200,100.0,6,700,117,-500,ats
2024-05-07,3,500,166.67,1,200,200,300,ats
2024-05-06,4,700,175.0,1,100,100,600,ats
2024-05-03,2,600,300.0,1,100,100,500,ats
2024-05-02,3,500,166.67,1,100,100,400,ats
2024-04-26,4,1200,300.0,3,1000,333,200,ats
2024-04-25,4,1300,325.0,2,1100,550,200,ats
2024-04-24,3,1100,366.67,1,100,100,1000,ats
2024-04-23,3,3100,1033.33,0,0,0,3100,ats
2024-04-22,5,7600,1520.0,3,1100,367,6500,ats
2024-04-19,3,800,266.67,2,100,50,700,ats
2024-04-17,5,300,60.0,1,100,100,200,ats
2024-04-16,4,1300,325.0,0,0,0,1300,ats
2024-04-15,1,100,100.0,1,100,100,0,ats
2024-04-12,2,200,100.0,0,0,0,200,ats
2024-04-11,2,200,100.0,0,0,0,200,ats
2024-04-10,1,100,100.0,0,0,0,100,ats
2024-04-09,4,300,75.0,1,100,100,200,ats
2024-04-08,1,200,200.0,0,0,0,200,ats
2024-04-05,2,100,50.0,1,100,100,0,ats
2024-04-04,1,100,100.0,0,0,0,100,ats
2024-04-03,1,100,100.0,0,0,0,100,ats
2024-04-02,4,15100,3775.0,1,12400,12400,2700,ats
2024-04-01,2,100,50.0,0,0,0,100,ats
2024-03-29,1,100,100.0,0,0,0,100,ats
2024-03-28,1,100,100.0,0,0,0,100,ats
2024-03-27,0,0,0.0,0,0,0,0,ats
2024-03-26,0,0,0.0,0,0,0,0,ats
2024-03-25,1,3400,3400.0,0,0,0,3400,ats
2024-03-22,8,900,112.5,1,100,100,800,ats
2024-03-21,1,1100,1100.0,0,0,0,1100,ats
2024-03-20,3,1000,333.33,0,0,0,1000,ats
2024-03-19,3,200,66.67,0,0,0,200,ats
2024-03-18,3,0,0.0,1,0,0,0,ats
2024-03-15,3,1000,333.33,0,0,0,1000,ats
2024-03-14,6,400,66.67,0,0,0,400,ats
2024-03-13,9,1300,144.44,1,200,200,1100,ats
2024-03-12,6,1300,216.67,3,300,100,1000,ats
2024-03-11,6,2300,383.33,3,800,267,1500,ats
2024-03-08,6,1300,216.67,4,1700,425,-400,ats
2024-03-07,5,2100,420.0,2,400,200,1700,ats
2024-03-06,6,1000,166.67,2,400,200,600,ats
2024-03-05,0,0,0.0,0,0,0,0,ats
2024-03-04,0,0,0.0,0,0,0,0,ats
2024-03-01,1,0,0.0,1,100,100,-100,ats
2024-02-29,0,0,0.0,0,0,0,0,ats
2024-02-28,3,200,66.67,0,0,0,200,ats
2024-02-27,1,100,100.0,1,200,200,-100,ats
2024-02-26,0,0,0.0,1,100,100,-100,ats
2024-02-23,0,0,0.0,3,200,67,-200,ats
2024-02-22,0,0,0.0,1,100,100,-100,ats
2024-02-21,0,0,0.0,1,100,100,-100,ats
2024-02-20,0,0,0.0,1,100,100,-100,ats
2024-02-19,1,100,100.0,3,300,100,-200,ats
2024-02-16,1,100,100.0,1,100,100,0,ats
2024-02-15,0,0,0.0,1,100,100,-100,ats
2024-02-07,0,0,0.0,2,300,150,-300,ats
2024-02-06,0,0,0.0,2,100,50,-100,ats
2024-02-05,1,200,200.0,1,100,100,100,ats
2024-02-02,4,700,175.0,6,800,133,-100,ats
2024-02-01,1,300,300.0,3,100,33,200,ats
2024-01-31,0,0,0.0,1,100,100,-100,ats
2024-01-30,1,300,300.0,5,900,180,-600,ats
2024-01-29,1,300,300.0,2,200,100,100,ats
2024-01-26,1,100,100.0,4,900,225,-800,ats
2024-01-25,1,100,100.0,5,1100,220,-1000,ats
2024-01-24,0,0,0.0,2,300,150,-300,ats
2024-01-23,0,0,0.0,3,400,133,-400,ats
2024-01-22,0,0,0.0,3,400,133,-400,ats
2024-01-19,0,0,0.0,2,200,100,-200,ats
2024-01-18,0,0,0.0,2,200,100,-200,ats
2024-01-17,0,0,0.0,1,200,200,-200,ats
2024-01-16,0,0,0.0,2,300,150,-300,ats
2024-01-15,0,0,0.0,3,900,300,-900,ats
2024-01-12,0,0,0.0,4,700,175,-700,ats
2024-01-11,0,0,0.0,3,800,267,-800,ats
2024-01-10,0,0,0.0,3,500,167,-500,ats
2024-01-09,0,0,0.0,3,500,167,-500,ats
2024-01-08,0,0,0.0,5,1000,200,-1000,ats
2024-01-05,0,0,0.0,4,1100,275,-1100,ats
2024-01-04,0,0,0.0,1,100,100,-100,ats
2024-01-03,0,0,0.0,1,100,100,-100,ats
2024-01-02,0,0,0.0,2,300,150,-300,ats
2024-09-12,0,0,0.0,0,0,0,0,avf
2024-09-11,0,0,0.0,0,0,0,0,avf
2024-09-10,0,0,0.0,0,0,0,0,avf
2024-09-09,0,0,0.0,0,0,0,0,avf
2024-09-06,0,0,0.0,0,0,0,0,avf
2024-09-05,0,0,0.0,0,0,0,0,avf
2024-09-04,0,0,0.0,0,0,0,0,avf
2024-08-30,0,0,0.0,0,0,0,0,avf
2024-08-29,0,0,0.0,0,0,0,0,avf
2024-08-28,0,0,0.0,0,0,0,0,avf
2024-08-27,0,0,0.0,0,0,0,0,avf
2024-08-26,0,0,0.0,0,0,0,0,avf
2024-08-23,0,0,0.0,0,0,0,0,avf
2024-08-22,0,0,0.0,0,0,0,0,avf
2024-08-21,0,0,0.0,0,0,0,0,avf
2024-08-20,0,0,0.0,0,0,0,0,avf
2024-08-19,0,0,0.0,0,0,0,0,avf
2024-08-16,0,0,0.0,0,0,0,0,avf
2024-08-15,0,0,0.0,0,0,0,0,avf
2024-08-14,0,0,0.0,0,0,0,0,avf
2024-08-13,0,0,0.0,0,0,0,0,avf
2024-08-12,0,0,0.0,0,0,0,0,avf
2024-08-09,0,0,0.0,0,0,0,0,avf
2024-08-08,0,0,0.0,0,0,0,0,avf
2024-08-07,0,0,0.0,0,0,0,0,avf
2024-08-06,0,0,0.0,0,0,0,0,avf
2024-08-05,0,0,0.0,0,0,0,0,avf
2024-08-02,0,0,0.0,0,0,0,0,avf
2024-08-01,0,0,0.0,0,0,0,0,avf
2024-07-31,0,0,0.0,0,0,0,0,avf
2024-07-30,0,0,0.0,0,0,0,0,avf
2024-07-29,0,0,0.0,0,0,0,0,avf
2024-07-26,0,0,0.0,0,0,0,0,avf
2024-07-25,0,0,0.0,0,0,0,0,avf
2024-07-24,0,0,0.0,0,0,0,0,avf
2024-07-23,0,0,0.0,0,0,0,0,avf
2024-07-22,0,0,0.0,0,0,0,0,avf
2024-07-19,0,0,0.0,0,0,0,0,avf
2024-07-18,0,0,0.0,0,0,0,0,avf
2024-07-17,0,0,0.0,0,0,0,0,avf
2024-07-16,0,0,0.0,0,0,0,0,avf
2024-07-15,0,0,0.0,0,0,0,0,avf
2024-07-12,0,0,0.0,0,0,0,0,avf
2024-07-11,0,0,0.0,0,0,0,0,avf
2024-07-10,0,0,0.0,0,0,0,0,avf
2024-07-09,0,0,0.0,0,0,0,0,avf
2024-07-08,0,0,0.0,0,0,0,0,avf
2024-07-05,0,0,0.0,0,0,0,0,avf
2024-07-04,0,0,0.0,0,0,0,0,avf
2024-07-03,0,0,0.0,0,0,0,0,avf
2024-07-02,0,0,0.0,0,0,0,0,avf
2024-07-01,0,0,0.0,0,0,0,0,avf
2024-06-28,0,0,0.0,0,0,0,0,avf
2024-06-27,0,0,0.0,0,0,0,0,avf
2024-06-26,0,0,0.0,0,0,0,0,avf
2024-06-25,0,0,0.0,0,0,0,0,avf
2024-06-24,0,0,0.0,0,0,0,0,avf
2024-06-21,0,0,0.0,0,0,0,0,avf
2024-06-20,0,0,0.0,0,0,0,0,avf
2024-06-19,0,0,0.0,0,0,0,0,avf
2024-06-18,0,0,0.0,0,0,0,0,avf
2024-06-17,0,0,0.0,0,0,0,0,avf
2024-06-14,0,0,0.0,0,0,0,0,avf
2024-06-13,0,0,0.0,0,0,0,0,avf
2024-06-12,0,0,0.0,0,0,0,0,avf
2024-06-11,0,0,0.0,0,0,0,0,avf
2024-06-10,0,0,0.0,0,0,0,0,avf
2024-06-07,0,0,0.0,0,0,0,0,avf
2024-06-06,0,0,0.0,0,0,0,0,avf
2024-06-05,0,0,0.0,0,0,0,0,avf
2024-06-04,0,0,0.0,0,0,0,0,avf
2024-06-03,0,0,0.0,0,0,0,0,avf
2024-05-31,0,0,0.0,0,0,0,0,avf
2024-05-30,0,0,0.0,0,0,0,0,avf
2024-05-29,0,0,0.0,0,0,0,0,avf
2024-05-28,0,0,0.0,0,0,0,0,avf
2024-05-27,0,0,0.0,0,0,0,0,avf
2024-05-24,0,0,0.0,0,0,0,0,avf
2024-05-23,0,0,0.0,0,0,0,0,avf
2024-05-22,0,0,0.0,0,0,0,0,avf
2024-05-21,0,0,0.0,0,0,0,0,avf
2024-05-20,0,0,0.0,0,0,0,0,avf
2024-05-17,0,0,0.0,0,0,0,0,avf
2024-05-16,0,0,0.0,0,0,0,0,avf
2024-05-15,0,0,0.0,0,0,0,0,avf
2024-05-14,0,0,0.0,0,0,0,0,avf
2024-05-13,0,0,0.0,0,0,0,0,avf
2024-05-10,0,0,0.0,0,0,0,0,avf
2024-05-09,0,0,0.0,0,0,0,0,avf
2024-05-08,0,0,0.0,0,0,0,0,avf
2024-05-07,0,0,0.0,0,0,0,0,avf
2024-05-06,0,0,0.0,0,0,0,0,avf
2024-05-03,0,0,0.0,0,0,0,0,avf
2024-05-02,0,0,0.0,0,0,0,0,avf
2024-04-26,0,0,0.0,0,0,0,0,avf
2024-04-25,0,0,0.0,0,0,0,0,avf
2024-04-24,0,0,0.0,0,0,0,0,avf
2024-04-23,0,0,0.0,0,0,0,0,avf
2024-04-22,0,0,0.0,0,0,0,0,avf
2024-04-19,0,0,0.0,0,0,0,0,avf
2024-04-17,0,0,0.0,0,0,0,0,avf
2024-04-16,0,0,0.0,0,0,0,0,avf
2024-04-15,0,0,0.0,0,0,0,0,avf
2024-04-12,0,0,0.0,0,0,0,0,avf
2024-04-11,0,0,0.0,0,0,0,0,avf
2024-04-10,0,0,0.0,0,0,0,0,avf
2024-04-09,0,0,0.0,0,0,0,0,avf
2024-04-08,0,0,0.0,0,0,0,0,avf
2024-04-05,0,0,0.0,0,0,0,0,avf
2024-04-04,0,0,0.0,0,0,0,0,avf
2024-04-03,0,0,0.0,0,0,0,0,avf
2024-04-02,0,0,0.0,0,0,0,0,avf
2024-04-01,0,0,0.0,0,0,0,0,avf
2024-03-29,0,0,0.0,0,0,0,0,avf
2024-03-28,0,0,0.0,0,0,0,0,avf
2024-03-27,0,0,0.0,0,0,0,0,avf
2024-03-26,0,0,0.0,0,0,0,0,avf
2024-03-25,0,0,0.0,0,0,0,0,avf
2024-03-22,0,0,0.0,0,0,0,0,avf
2024-03-21,0,0,0.0,0,0,0,0,avf
2024-03-20,0,0,0.0,0,0,0,0,avf
2024-03-19,0,0,0.0,0,0,0,0,avf
2024-03-18,0,0,0.0,0,0,0,0,avf
2024-03-15,0,0,0.0,0,0,0,0,avf
2024-03-14,0,0,0.0,0,0,0,0,avf
2024-03-13,0,0,0.0,0,0,0,0,avf
2024-03-12,0,0,0.0,0,0,0,0,avf
2024-03-11,0,0,0.0,0,0,0,0,avf
2024-03-08,0,0,0.0,0,0,0,0,avf
2024-03-07,0,0,0.0,0,0,0,0,avf
2024-03-06,0,0,0.0,0,0,0,0,avf
2024-03-05,0,0,0.0,0,0,0,0,avf
2024-03-04,0,0,0.0,0,0,0,0,avf
2024-03-01,0,0,0.0,0,0,0,0,avf
2024-02-29,0,0,0.0,0,0,0,0,avf
2024-02-28,0,0,0.0,0,0,0,0,avf
2024-02-27,0,0,0.0,0,0,0,0,avf
2024-02-26,0,0,0.0,0,0,0,0,avf
2024-02-23,0,0,0.0,0,0,0,0,avf
2024-02-22,0,0,0.0,0,0,0,0,avf
2024-02-21,0,0,0.0,0,0,0,0,avf
2024-02-20,0,0,0.0,0,0,0,0,avf
2024-02-19,0,0,0.0,0,0,0,0,avf
2024-02-16,0,0,0.0,0,0,0,0,avf
2024-02-15,0,0,0.0,0,0,0,0,avf
2024-02-07,0,0,0.0,0,0,0,0,avf
2024-02-06,0,0,0.0,0,0,0,0,avf
2024-02-05,0,0,0.0,0,0,0,0,avf
2024-02-02,0,0,0.0,0,0,0,0,avf
2024-02-01,0,0,0.0,0,0,0,0,avf
2024-01-31,0,0,0.0,0,0,0,0,avf
2024-01-30,0,0,0.0,0,0,0,0,avf
2024-01-29,0,0,0.0,0,0,0,0,avf
2024-01-26,0,0,0.0,0,0,0,0,avf
2024-01-25,0,0,0.0,0,0,0,0,avf
2024-01-24,0,0,0.0,0,0,0,0,avf
2024-01-23,0,0,0.0,0,0,0,0,avf
2024-01-22,0,0,0.0,0,0,0,0,avf
2024-01-19,0,0,0.0,0,0,0,0,avf
2024-01-18,0,0,0.0,0,0,0,0,avf
2024-01-17,0,0,0.0,0,0,0,0,avf
2024-01-16,0,0,0.0,0,0,0,0,avf
2024-01-15,0,0,0.0,0,0,0,0,avf
2024-01-12,0,0,0.0,0,0,0,0,avf
2024-01-11,0,0,0.0,0,0,0,0,avf
2024-01-10,0,0,0.0,0,0,0,0,avf
2024-01-09,0,0,0.0,0,0,0,0,avf
2024-01-08,0,0,0.0,0,0,0,0,avf
2024-01-05,0,0,0.0,0,0,0,0,avf
2024-01-04,0,0,0.0,0,0,0,0,avf
2024-01-03,0,0,0.0,0,0,0,0,avf
2024-01-02,0,0,0.0,0,0,0,0,avf
2024-09-12,23,112400,4886.96,11,46800,4255,65600,avg
2024-09-11,35,19800,565.71,12,51800,4317,-32000,avg
2024-09-10,42,35000,833.33,18,51800,2878,-16800,avg
2024-09-09,43,58600,1362.79,34,80900,2379,-22300,avg
2024-09-06,22,30100,1368.18,19,48000,2526,-17900,avg
2024-09-05,23,38900,1691.3,25,71100,2844,-32200,avg
2024-09-04,52,64700,1244.23,40,75900,1898,-11200,avg
2024-08-30,36,68900,1913.89,16,57800,3612,11100,avg
2024-08-29,32,331000,10343.75,19,50700,2668,280300,avg
2024-08-28,39,93600,2400.0,38,59500,1566,34100,avg
2024-08-27,33,43600,1321.21,38,68000,1789,-24400,avg
2024-08-26,42,222200,5290.48,41,65000,1585,157200,avg
2024-08-23,82,479300,5845.12,62,113000,1823,366300,avg
2024-08-22,22,156800,7127.27,52,100800,1938,56000,avg
2024-08-21,65,403500,6207.69,89,71800,807,331700,avg
2024-08-20,68,215800,3173.53,59,98800,1675,117000,avg
2024-08-19,46,181900,3954.35,65,94100,1448,87800,avg
2024-08-16,63,239800,3806.35,83,172000,2072,67800,avg
2024-08-15,33,484700,14687.88,64,167400,2616,317300,avg
2024-08-14,103,689900,6698.06,44,78700,1789,611200,avg
2024-08-13,154,886700,5757.79,29,179400,6186,707300,avg
2024-08-12,85,319100,3754.12,19,43800,2305,275300,avg
2024-08-09,26,693900,26688.46,5,8200,1640,685700,avg
2024-09-06,0,0,0.0,0,0,0,0,b82
2024-09-05,0,0,0.0,0,0,0,0,b82
2024-09-04,0,0,0.0,0,0,0,0,b82
2024-08-30,0,0,0.0,0,0,0,0,b82
2024-08-29,0,0,0.0,0,0,0,0,b82
2024-08-28,0,0,0.0,0,0,0,0,b82
2024-08-27,0,0,0.0,0,0,0,0,b82
2024-08-26,0,0,0.0,0,0,0,0,b82
2024-08-23,0,0,0.0,0,0,0,0,b82
2024-08-22,0,0,0.0,0,0,0,0,b82
2024-08-21,0,0,0.0,0,0,0,0,b82
2024-08-20,0,0,0.0,0,0,0,0,b82
2024-08-19,0,0,0.0,0,0,0,0,b82
2024-08-16,0,0,0.0,0,0,0,0,b82
2024-08-15,0,0,0.0,0,0,0,0,b82
2024-08-14,0,0,0.0,0,0,0,0,b82
2024-08-13,0,0,0.0,0,0,0,0,b82
2024-08-12,0,0,0.0,0,0,0,0,b82
2024-08-09,0,0,0.0,0,0,0,0,b82
2024-08-08,0,0,0.0,0,0,0,0,b82
2024-08-07,0,0,0.0,0,0,0,0,b82
2024-08-06,0,0,0.0,0,0,0,0,b82
2024-08-05,0,0,0.0,0,0,0,0,b82
2024-08-02,0,0,0.0,0,0,0,0,b82
2024-08-01,0,0,0.0,0,0,0,0,b82
2024-07-31,0,0,0.0,0,0,0,0,b82
2024-07-30,0,0,0.0,0,0,0,0,b82
2024-07-29,0,0,0.0,0,0,0,0,b82
2024-07-26,0,0,0.0,0,0,0,0,b82
2024-07-25,0,0,0.0,0,0,0,0,b82
2024-07-24,0,0,0.0,0,0,0,0,b82
2024-07-23,0,0,0.0,0,0,0,0,b82
2024-07-22,0,0,0.0,0,0,0,0,b82
2024-07-19,0,0,0.0,0,0,0,0,b82
2024-07-18,0,0,0.0,0,0,0,0,b82
2024-07-17,0,0,0.0,0,0,0,0,b82
2024-07-16,0,0,0.0,0,0,0,0,b82
2024-07-15,0,0,0.0,0,0,0,0,b82
2024-07-12,0,0,0.0,0,0,0,0,b82
2024-07-11,0,0,0.0,0,0,0,0,b82
2024-07-10,0,0,0.0,0,0,0,0,b82
2024-07-09,0,0,0.0,0,0,0,0,b82
2024-07-08,0,0,0.0,0,0,0,0,b82
2024-07-05,0,0,0.0,0,0,0,0,b82
2024-07-04,0,0,0.0,0,0,0,0,b82
2024-07-03,0,0,0.0,0,0,0,0,b82
2024-07-02,0,0,0.0,0,0,0,0,b82
2024-07-01,0,0,0.0,0,0,0,0,b82
2024-06-28,0,0,0.0,0,0,0,0,b82
2024-06-27,0,0,0.0,0,0,0,0,b82
2024-06-26,0,0,0.0,0,0,0,0,b82
2024-06-25,0,0,0.0,0,0,0,0,b82
2024-06-24,0,0,0.0,0,0,0,0,b82
2024-06-21,0,0,0.0,0,0,0,0,b82
2024-06-20,0,0,0.0,0,0,0,0,b82
2024-06-19,0,0,0.0,0,0,0,0,b82
2024-06-18,0,0,0.0,0,0,0,0,b82
2024-06-17,0,0,0.0,0,0,0,0,b82
2024-06-14,0,0,0.0,0,0,0,0,b82
2024-06-13,0,0,0.0,0,0,0,0,b82
2024-06-12,0,0,0.0,0,0,0,0,b82
2024-06-11,0,0,0.0,0,0,0,0,b82
2024-06-10,0,0,0.0,0,0,0,0,b82
2024-06-07,0,0,0.0,0,0,0,0,b82
2024-06-06,0,0,0.0,0,0,0,0,b82
2024-06-05,0,0,0.0,0,0,0,0,b82
2024-06-04,0,0,0.0,0,0,0,0,b82
2024-06-03,0,0,0.0,0,0,0,0,b82
2024-05-31,0,0,0.0,0,0,0,0,b82
2024-05-30,0,0,0.0,0,0,0,0,b82
2024-05-29,0,0,0.0,0,0,0,0,b82
2024-05-28,0,0,0.0,0,0,0,0,b82
2024-05-27,0,0,0.0,0,0,0,0,b82
2024-05-24,0,0,0.0,0,0,0,0,b82
2024-05-23,0,0,0.0,0,0,0,0,b82
2024-05-22,0,0,0.0,0,0,0,0,b82
2024-05-21,0,0,0.0,0,0,0,0,b82
2024-05-20,0,0,0.0,0,0,0,0,b82
2024-05-17,0,0,0.0,0,0,0,0,b82
2024-05-16,0,0,0.0,0,0,0,0,b82
2024-05-15,0,0,0.0,0,0,0,0,b82
2024-05-14,0,0,0.0,0,0,0,0,b82
2024-05-13,0,0,0.0,0,0,0,0,b82
2024-05-10,0,0,0.0,0,0,0,0,b82
2024-05-09,0,0,0.0,0,0,0,0,b82
2024-05-08,0,0,0.0,0,0,0,0,b82
2024-05-07,0,0,0.0,0,0,0,0,b82
2024-05-06,0,0,0.0,0,0,0,0,b82
2024-05-03,0,0,0.0,0,0,0,0,b82
2024-05-02,0,0,0.0,0,0,0,0,b82
2024-04-26,0,0,0.0,0,0,0,0,b82
2024-04-25,0,0,0.0,0,0,0,0,b82
2024-04-24,0,0,0.0,0,0,0,0,b82
2024-04-23,0,0,0.0,0,0,0,0,b82
2024-04-22,0,0,0.0,0,0,0,0,b82
2024-04-19,0,0,0.0,0,0,0,0,b82
2024-04-17,0,0,0.0,0,0,0,0,b82
2024-04-16,0,0,0.0,0,0,0,0,b82
2024-04-15,0,0,0.0,0,0,0,0,b82
2024-04-12,0,0,0.0,0,0,0,0,b82
2024-04-11,0,0,0.0,0,0,0,0,b82
2024-04-10,0,0,0.0,0,0,0,0,b82
2024-04-09,0,0,0.0,0,0,0,0,b82
2024-04-08,0,0,0.0,0,0,0,0,b82
2024-04-05,0,0,0.0,0,0,0,0,b82
2024-04-04,0,0,0.0,0,0,0,0,b82
2024-04-03,0,0,0.0,0,0,0,0,b82
2024-04-02,0,0,0.0,0,0,0,0,b82
2024-04-01,0,0,0.0,0,0,0,0,b82
2024-03-29,0,0,0.0,0,0,0,0,b82
2024-03-28,0,0,0.0,0,0,0,0,b82
2024-03-27,0,0,0.0,0,0,0,0,b82
2024-03-26,0,0,0.0,0,0,0,0,b82
2024-03-25,0,0,0.0,0,0,0,0,b82
2024-03-22,0,0,0.0,0,0,0,0,b82
2024-03-21,0,0,0.0,0,0,0,0,b82
2024-03-20,0,0,0.0,0,0,0,0,b82
2024-03-19,0,0,0.0,0,0,0,0,b82
2024-03-18,0,0,0.0,0,0,0,0,b82
2024-03-15,0,0,0.0,0,0,0,0,b82
2024-03-14,0,0,0.0,0,0,0,0,b82
2024-03-13,0,0,0.0,0,0,0,0,b82
2024-03-12,0,0,0.0,0,0,0,0,b82
2024-03-11,0,0,0.0,0,0,0,0,b82
2024-03-08,0,0,0.0,0,0,0,0,b82
2024-03-07,0,0,0.0,0,0,0,0,b82
2024-03-06,0,0,0.0,0,0,0,0,b82
2024-03-05,0,0,0.0,0,0,0,0,b82
2024-03-04,0,0,0.0,0,0,0,0,b82
2024-03-01,0,0,0.0,0,0,0,0,b82
2024-02-29,0,0,0.0,0,0,0,0,b82
2024-02-28,0,0,0.0,0,0,0,0,b82
2024-02-27,0,0,0.0,0,0,0,0,b82
2024-02-26,0,0,0.0,0,0,0,0,b82
2024-02-23,0,0,0.0,0,0,0,0,b82
2024-02-22,0,0,0.0,0,0,0,0,b82
2024-02-21,0,0,0.0,0,0,0,0,b82
2024-02-20,0,0,0.0,0,0,0,0,b82
2024-02-19,0,0,0.0,0,0,0,0,b82
2024-02-16,0,0,0.0,0,0,0,0,b82
2024-02-15,0,0,0.0,0,0,0,0,b82
2024-02-07,0,0,0.0,0,0,0,0,b82
2024-02-06,0,0,0.0,0,0,0,0,b82
2024-02-05,0,0,0.0,0,0,0,0,b82
2024-02-02,0,0,0.0,0,0,0,0,b82
2024-02-01,0,0,0.0,0,0,0,0,b82
2024-01-31,0,0,0.0,0,0,0,0,b82
2024-01-30,0,0,0.0,0,0,0,0,b82
2024-01-29,0,0,0.0,0,0,0,0,b82
2024-01-26,0,0,0.0,0,0,0,0,b82
2024-01-25,0,0,0.0,0,0,0,0,b82
2024-01-24,0,0,0.0,0,0,0,0,b82
2024-01-23,0,0,0.0,0,0,0,0,b82
2024-01-22,0,0,0.0,0,0,0,0,b82
2024-01-19,0,0,0.0,0,0,0,0,b82
2024-01-18,0,0,0.0,0,0,0,0,b82
2024-01-17,0,0,0.0,0,0,0,0,b82
2024-01-16,0,0,0.0,0,0,0,0,b82
2024-01-15,0,0,0.0,0,0,0,0,b82
2024-01-12,0,0,0.0,0,0,0,0,b82
2024-01-11,0,0,0.0,0,0,0,0,b82
2024-01-10,0,0,0.0,0,0,0,0,b82
2024-01-09,0,0,0.0,0,0,0,0,b82
2024-01-08,0,0,0.0,0,0,0,0,b82
2024-01-05,0,0,0.0,0,0,0,0,b82
2024-01-04,0,0,0.0,0,0,0,0,b82
2024-01-03,0,0,0.0,0,0,0,0,b82
2024-01-02,0,0,0.0,0,0,0,0,b82
2024-09-12,14,3000,214.29,7,5000,714,-2000,bax
2024-09-11,16,3800,237.5,13,8600,662,-4800,bax
2024-09-10,10,3400,340.0,9,5400,600,-2000,bax
2024-09-09,11,3900,354.55,9,6100,678,-2200,bax
2024-09-06,23,4900,213.04,15,9200,613,-4300,bax
2024-09-05,20,8600,430.0,16,8200,512,400,bax
2024-09-04,13,2900,223.08,7,2800,400,100,bax
2024-08-30,11,3600,327.27,11,13500,1227,-9900,bax
2024-08-29,14,2700,192.86,12,13600,1133,-10900,bax
2024-08-28,35,9900,282.86,19,19000,1000,-9100,bax
2024-08-27,20,5900,295.0,16,26500,1656,-20600,bax
2024-08-26,22,4300,195.45,17,24500,1441,-20200,bax
2024-08-23,15,4100,273.33,16,17100,1069,-13000,bax
2024-08-22,30,10500,350.0,24,23100,962,-12600,bax
2024-08-21,22,7600,345.45,21,18900,900,-11300,bax
2024-08-20,17,4700,276.47,14,6000,429,-1300,bax
2024-08-19,11,4000,363.64,11,6500,591,-2500,bax
2024-08-16,10,3200,320.0,13,7400,569,-4200,bax
2024-08-15,8,3100,387.5,10,4700,470,-1600,bax
2024-08-14,10,4000,400.0,10,4800,480,-800,bax
2024-08-13,14,4400,314.29,9,4500,500,-100,bax
2024-08-12,27,24400,903.7,17,5200,306,19200,bax
2024-08-09,27,6500,240.74,19,5500,289,1000,bax
2024-08-08,37,8700,235.14,20,12000,600,-3300,bax
2024-08-07,19,3600,189.47,16,7800,488,-4200,bax
2024-08-06,23,8300,360.87,22,11900,541,-3600,bax
2024-08-05,20,4800,240.0,15,9600,640,-4800,bax
2024-08-02,10,2200,220.0,16,14000,875,-11800,bax
2024-08-01,14,2500,178.57,13,6500,500,-4000,bax
2024-07-31,24,3500,145.83,9,6100,678,-2600,bax
2024-07-30,20,17600,880.0,18,10600,589,7000,bax
2024-07-29,15,9400,626.67,13,7700,592,1700,bax
2024-07-26,14,5000,357.14,12,8500,708,-3500,bax
2024-07-25,27,11300,418.52,11,4500,409,6800,bax
2024-07-24,18,6000,333.33,14,12400,886,-6400,bax
2024-07-23,21,4200,200.0,22,16500,750,-12300,bax
2024-07-22,16,11200,700.0,14,9600,686,1600,bax
2024-07-19,14,9300,664.29,17,14800,871,-5500,bax
2024-07-18,12,4100,341.67,10,10500,1050,-6400,bax
2024-07-17,21,15000,714.29,17,12000,706,3000,bax
2024-07-16,16,10000,625.0,21,9400,448,600,bax
2024-07-15,33,24600,745.45,23,11900,517,12700,bax
2024-07-12,24,14400,600.0,15,7900,527,6500,bax
2024-07-11,15,9700,646.67,16,9100,569,600,bax
2024-07-10,31,28100,906.45,20,13100,655,15000,bax
2024-07-09,17,14000,823.53,18,13700,761,300,bax
2024-07-08,11,9700,881.82,14,10400,743,-700,bax
2024-07-05,37,30600,827.03,20,17800,890,12800,bax
2024-07-04,17,8200,482.35,14,12500,893,-4300,bax
2024-07-03,18,5700,316.67,22,13600,618,-7900,bax
2024-07-02,11,3100,281.82,18,12600,700,-9500,bax
2024-07-01,21,23200,1104.76,23,23500,1022,-300,bax
2024-06-28,9,2400,266.67,15,11600,773,-9200,bax
2024-06-27,15,6000,400.0,15,5000,333,1000,bax
2024-06-26,10,5000,500.0,11,8800,800,-3800,bax
2024-06-25,15,10900,726.67,16,7600,475,3300,bax
2024-06-24,16,15000,937.5,25,9700,388,5300,bax
2024-06-21,33,38600,1169.7,46,21600,470,17000,bax
2024-06-20,23,12400,539.13,25,12700,508,-300,bax
2024-06-19,21,15300,728.57,23,12700,552,2600,bax
2024-06-18,22,37600,1709.09,20,14400,720,23200,bax
2024-06-17,14,1900,135.71,15,7400,493,-5500,bax
2024-06-14,19,9100,478.95,23,15400,670,-6300,bax
2024-06-13,11,2600,236.36,19,9700,511,-7100,bax
2024-06-12,23,19200,834.78,28,19800,707,-600,bax
2024-06-11,24,11600,483.33,18,16300,906,-4700,bax
2024-06-10,34,21600,635.29,21,13200,629,8400,bax
2024-06-07,22,7200,327.27,18,12300,683,-5100,bax
2024-06-06,8,300,37.5,10,10800,1080,-10500,bax
2024-06-05,11,1600,145.45,12,12400,1033,-10800,bax
2024-06-04,14,16500,1178.57,16,15700,981,800,bax
2024-06-03,14,3700,264.29,21,8400,400,-4700,bax
2024-05-31,13,1800,138.46,21,8000,381,-6200,bax
2024-05-30,19,11300,594.74,22,17800,809,-6500,bax
2024-05-29,26,20500,788.46,17,8100,476,12400,bax
2024-05-28,16,10700,668.75,16,12000,750,-1300,bax
2024-05-27,14,6000,428.57,8,4800,600,1200,bax
2024-05-24,16,3100,193.75,8,4200,525,-1100,bax
2024-05-23,16,1600,100.0,5,3800,760,-2200,bax
2024-05-22,14,6300,450.0,11,6700,609,-400,bax
2024-05-21,15,3600,240.0,7,5500,786,-1900,bax
2024-05-20,19,4400,231.58,10,7800,780,-3400,bax
2024-05-17,22,9100,413.64,14,10700,764,-1600,bax
2024-05-16,25,7100,284.0,14,11900,850,-4800,bax
2024-05-15,12,2200,183.33,7,5600,800,-3400,bax
2024-05-14,13,5000,384.62,13,6700,515,-1700,bax
2024-05-13,13,4700,361.54,11,6600,600,-1900,bax
2024-05-10,7,1300,185.71,8,4300,538,-3000,bax
2024-05-09,13,7700,592.31,12,9900,825,-2200,bax
2024-05-08,11,4600,418.18,12,4600,383,0,bax
2024-05-07,24,3300,137.5,15,6200,413,-2900,bax
2024-05-06,14,9700,692.86,10,5000,500,4700,bax
2024-05-03,6,2600,433.33,10,5600,560,-3000,bax
2024-05-02,8,3000,375.0,8,5000,625,-2000,bax
2024-04-26,6,1600,266.67,3,2200,733,-600,bax
2024-04-25,11,800,72.73,10,3100,310,-2300,bax
2024-04-24,13,2100,161.54,6,3500,583,-1400,bax
2024-04-23,18,5600,311.11,12,7200,600,-1600,bax
2024-04-22,12,2300,191.67,11,5800,527,-3500,bax
2024-04-19,9,1300,144.44,11,6900,627,-5600,bax
2024-04-17,11,6600,600.0,7,3800,543,2800,bax
2024-04-16,15,2700,180.0,21,9000,429,-6300,bax
2024-04-15,9,1000,111.11,12,5700,475,-4700,bax
2024-04-12,13,2500,192.31,15,7200,480,-4700,bax
2024-04-11,7,2600,371.43,13,5100,392,-2500,bax
2024-04-10,7,3100,442.86,11,6500,591,-3400,bax
2024-04-09,7,4300,614.29,11,5200,473,-900,bax
2024-04-08,8,1800,225.0,12,3300,275,-1500,bax
2024-04-05,15,5700,380.0,11,8400,764,-2700,bax
2024-04-04,7,5000,714.29,9,7200,800,-2200,bax
2024-04-03,7,3000,428.57,12,16200,1350,-13200,bax
2024-04-02,7,2300,328.57,13,13300,1023,-11000,bax
2024-04-01,17,4200,247.06,17,10700,629,-6500,bax
2024-03-29,6,1000,166.67,17,4500,265,-3500,bax
2024-03-28,10,2800,280.0,16,6000,375,-3200,bax
2024-03-27,14,5600,400.0,14,8400,600,-2800,bax
2024-03-26,10,2600,260.0,11,3700,336,-1100,bax
2024-03-25,8,1800,225.0,11,4700,427,-2900,bax
2024-03-22,15,3700,246.67,20,5400,270,-1700,bax
2024-03-21,32,11300,353.12,18,9900,550,1400,bax
2024-03-20,6,1100,183.33,12,2500,208,-1400,bax
2024-03-19,17,4000,235.29,11,3100,282,900,bax
2024-03-18,13,3400,261.54,15,5600,373,-2200,bax
2024-03-15,8,3900,487.5,8,1800,225,2100,bax
2024-03-14,12,3900,325.0,16,4600,288,-700,bax
2024-03-13,13,6700,515.38,14,7200,514,-500,bax
2024-03-12,13,6600,507.69,11,4700,427,1900,bax
2024-03-11,14,8900,635.71,14,5900,421,3000,bax
2024-03-08,17,9300,547.06,14,9800,700,-500,bax
2024-03-07,13,4900,376.92,19,7400,389,-2500,bax
2024-03-06,12,3100,258.33,11,5800,527,-2700,bax
2024-03-05,13,5100,392.31,16,7000,438,-1900,bax
2024-03-04,14,4700,335.71,18,8900,494,-4200,bax
2024-03-01,25,7800,312.0,18,11400,633,-3600,bax
2024-02-29,19,9600,505.26,21,15300,729,-5700,bax
2024-02-28,22,10000,454.55,31,14200,458,-4200,bax
2024-02-27,23,11000,478.26,22,11100,505,-100,bax
2024-02-26,7,1600,228.57,15,6100,407,-4500,bax
2024-02-23,26,7100,273.08,21,16100,767,-9000,bax
2024-02-22,14,2800,200.0,12,4900,408,-2100,bax
2024-02-21,14,2800,200.0,13,5800,446,-3000,bax
2024-02-20,18,3300,183.33,14,4900,350,-1600,bax
2024-02-19,19,3000,157.89,15,4300,287,-1300,bax
2024-02-16,17,5100,300.0,15,5900,393,-800,bax
2024-02-15,19,9100,478.95,16,8600,538,500,bax
2024-02-07,20,3100,155.0,17,5000,294,-1900,bax
2024-02-06,26,4500,173.08,22,6900,314,-2400,bax
2024-02-05,36,7600,211.11,25,8700,348,-1100,bax
2024-02-02,25,3800,152.0,22,5800,264,-2000,bax
2024-02-01,31,4000,129.03,19,5700,300,-1700,bax
2024-01-31,18,5100,283.33,19,6200,326,-1100,bax
2024-01-30,24,6700,279.17,23,6500,283,200,bax
2024-01-29,25,5600,224.0,24,7900,329,-2300,bax
2024-01-26,15,2400,160.0,21,7600,362,-5200,bax
2024-01-25,19,4800,252.63,16,9400,588,-4600,bax
2024-01-24,17,20700,1217.65,23,15900,691,4800,bax
2024-01-23,29,18400,634.48,27,19100,707,-700,bax
2024-01-22,33,13300,403.03,32,15800,494,-2500,bax
2024-01-19,27,8300,307.41,23,7400,322,900,bax
2024-01-18,35,8800,251.43,32,11400,356,-2600,bax
2024-01-17,30,12900,430.0,26,5900,227,7000,bax
2024-01-16,22,4700,213.64,23,7600,330,-2900,bax
2024-01-15,20,7300,365.0,24,6400,267,900,bax
2024-01-12,10,4000,400.0,28,4400,157,-400,bax
2024-01-11,15,9100,606.67,25,6000,240,3100,bax
2024-01-10,22,18600,845.45,44,8700,198,9900,bax
2024-01-09,18,8400,466.67,30,5800,193,2600,bax
2024-01-08,69,9100,131.88,37,7500,203,1600,bax
2024-01-05,25,6900,276.0,32,9300,291,-2400,bax
2024-01-04,28,8000,285.71,30,13300,443,-5300,bax
2024-01-03,23,7100,308.7,32,12000,375,-4900,bax
2024-01-02,16,2400,150.0,25,5900,236,-3500,bax
2024-09-12,9,3200,355.56,9,3100,344,100,bbc
2024-09-11,4,1400,350.0,10,3200,320,-1800,bbc
2024-09-10,7,1800,257.14,6,2800,467,-1000,bbc
2024-09-09,14,2800,200.0,6,1300,217,1500,bbc
2024-09-06,11,11900,1081.82,7,1800,257,10100,bbc
2024-09-05,8,2400,300.0,11,4100,373,-1700,bbc
2024-09-04,8,1400,175.0,9,1900,211,-500,bbc
2024-08-30,9,5400,600.0,9,2400,267,3000,bbc
2024-08-29,9,4700,522.22,10,2300,230,2400,bbc
2024-08-28,8,3400,425.0,6,600,100,2800,bbc
2024-08-27,7,3600,514.29,7,1800,257,1800,bbc
2024-08-26,9,9200,1022.22,10,1900,190,7300,bbc
2024-08-23,12,5600,466.67,7,1400,200,4200,bbc
2024-08-22,14,8400,600.0,8,800,100,7600,bbc
2024-08-21,9,21700,2411.11,8,800,100,20900,bbc
2024-08-20,9,3500,388.89,9,1600,178,1900,bbc
2024-08-19,8,17600,2200.0,7,800,114,16800,bbc
2024-08-16,10,15200,1520.0,8,800,100,14400,bbc
2024-08-15,6,33500,5583.33,7,700,100,32800,bbc
2024-08-14,7,10200,1457.14,9,900,100,9300,bbc
2024-08-13,13,13000,1000.0,19,2500,132,10500,bbc
2024-08-12,6,1200,200.0,11,1400,127,-200,bbc
2024-08-08,11,2800,254.55,14,2300,164,500,bbc
2024-08-07,15,4700,313.33,14,1800,129,2900,bbc
2024-08-06,16,4600,287.5,14,1800,129,2800,bbc
2024-08-05,14,4600,328.57,10,1700,170,2900,bbc
2024-08-02,14,5000,357.14,9,1500,167,3500,bbc
2024-08-01,14,4800,342.86,5,500,100,4300,bbc
2024-07-31,17,4200,247.06,7,700,100,3500,bbc
2024-07-30,19,7400,389.47,8,1100,138,6300,bbc
2024-07-29,21,9400,447.62,19,4000,211,5400,bbc
2024-07-26,13,3800,292.31,10,3000,300,800,bbc
2024-07-25,20,25000,1250.0,12,1800,150,23200,bbc
2024-07-24,11,4300,390.91,11,2900,264,1400,bbc
2024-07-22,15,4300,286.67,10,2500,250,1800,bbc
2024-07-19,13,3800,292.31,9,900,100,2900,bbc
2024-07-18,19,15500,815.79,8,900,112,14600,bbc
2024-07-17,14,3200,228.57,11,2600,236,600,bbc
2024-07-16,20,6700,335.0,10,2500,250,4200,bbc
2024-07-15,22,10700,486.36,18,3800,211,6900,bbc
2024-07-12,19,4400,231.58,24,4200,175,200,bbc
2024-07-11,27,8500,314.81,15,3300,220,5200,bbc
2024-07-10,16,4800,300.0,10,2500,250,2300,bbc
2024-07-09,11,2300,209.09,11,1300,118,1000,bbc
2024-07-08,12,2600,216.67,6,600,100,2000,bbc
2024-07-05,39,15600,400.0,16,3600,225,12000,bbc
2024-07-04,13,6300,484.62,19,4100,216,2200,bbc
2024-07-03,16,8800,550.0,15,3200,213,5600,bbc
2024-07-02,19,10600,557.89,15,4300,287,6300,bbc
2024-07-01,23,7100,308.7,13,2800,215,4300,bbc
2024-06-28,12,4500,375.0,9,2500,278,2000,bbc
2024-06-27,14,4200,300.0,13,3100,238,1100,bbc
2024-06-26,7,3400,485.71,12,3000,250,400,bbc
2024-06-25,12,4000,333.33,9,2500,278,1500,bbc
2024-06-24,10,5100,510.0,13,1900,146,3200,bbc
2024-06-21,12,5200,433.33,8,800,100,4400,bbc
2024-06-20,18,5200,288.89,14,1600,114,3600,bbc
2024-06-19,19,4600,242.11,9,1000,111,3600,bbc
2024-06-18,24,6700,279.17,10,1000,100,5700,bbc
2024-06-17,13,3400,261.54,9,1100,122,2300,bbc
2024-06-14,10,4600,460.0,9,2000,222,2600,bbc
2024-06-13,21,4300,204.76,12,1500,125,2800,bbc
2024-06-12,10,2800,280.0,5,900,180,1900,bbc
2024-06-11,19,5600,294.74,8,1300,162,4300,bbc
2024-06-10,15,5700,380.0,8,800,100,4900,bbc
2024-06-07,59,29300,496.61,18,3500,194,25800,bbc
2024-06-06,21,5400,257.14,23,4700,204,700,bbc
2024-06-05,38,17400,457.89,17,1900,112,15500,bbc
2024-06-04,20,4700,235.0,26,2700,104,2000,bbc
2024-06-03,25,5200,208.0,10,2900,290,2300,bbc
2024-05-31,18,4200,233.33,10,1400,140,2800,bbc
2024-05-30,10,3300,330.0,10,2700,270,600,bbc
2024-05-29,13,4500,346.15,11,3300,300,1200,bbc
2024-05-28,20,5500,275.0,8,1800,225,3700,bbc
2024-05-27,10,2300,230.0,4,700,175,1600,bbc
2024-05-24,20,6600,330.0,7,1200,171,5400,bbc
2024-05-23,68,24100,354.41,12,1600,133,22500,bbc
2024-05-22,41,14400,351.22,6,900,150,13500,bbc
2024-05-21,26,5600,215.38,11,1400,127,4200,bbc
2024-05-20,14,2700,192.86,7,1000,143,1700,bbc
2024-05-17,21,6500,309.52,4,1000,250,5500,bbc
2024-05-16,17,6000,352.94,6,1000,167,5000,bbc
2024-05-15,21,5600,266.67,10,1600,160,4000,bbc
2024-05-14,13,2900,223.08,5,1300,260,1600,bbc
2024-05-13,24,4400,183.33,16,3300,206,1100,bbc
2024-05-10,10,2500,250.0,9,2700,300,-200,bbc
2024-05-09,14,3000,214.29,13,3100,238,-100,bbc
2024-05-08,13,3200,246.15,14,1700,121,1500,bbc
2024-05-07,13,4000,307.69,7,700,100,3300,bbc
2024-05-06,12,4200,350.0,4,400,100,3800,bbc
2024-05-03,22,4000,181.82,9,1100,122,2900,bbc
2024-05-02,21,7800,371.43,5,900,180,6900,bbc
2024-04-26,25,8100,324.0,7,2600,371,5500,bbc
2024-04-25,15,4800,320.0,4,1400,350,3400,bbc
2024-04-24,21,9300,442.86,5,4200,840,5100,bbc
2024-04-23,8,2300,287.5,4,2100,525,200,bbc
2024-04-22,6,1900,316.67,5,500,100,1400,bbc
2024-04-19,8,3400,425.0,6,4300,717,-900,bbc
2024-04-17,18,4800,266.67,9,1900,211,2900,bbc
2024-04-16,8,3200,400.0,13,2300,177,900,bbc
2024-04-15,36,10100,280.56,25,5200,208,4900,bbc
2024-04-12,11,2000,181.82,8,800,100,1200,bbc
2024-04-11,9,1700,188.89,5,500,100,1200,bbc
2024-04-10,14,2700,192.86,5,600,120,2100,bbc
2024-04-09,17,3000,176.47,5,500,100,2500,bbc
2024-04-08,13,2600,200.0,8,800,100,1800,bbc
2024-04-05,15,3000,200.0,6,700,117,2300,bbc
2024-04-04,20,5300,265.0,10,4200,420,1100,bbc
2024-04-03,17,3500,205.88,7,1100,157,2400,bbc
2024-04-02,16,2300,143.75,6,700,117,1600,bbc
2024-04-01,18,2900,161.11,8,1900,238,1000,bbc
2024-03-29,22,3100,140.91,9,900,100,2200,bbc
2024-03-28,19,2800,147.37,8,7200,900,-4400,bbc
2024-03-27,14,4600,328.57,13,3500,269,1100,bbc
2024-03-26,14,3000,214.29,11,4800,436,-1800,bbc
2024-03-25,12,2900,241.67,8,1700,212,1200,bbc
2024-03-22,30,9200,306.67,14,2600,186,6600,bbc
2024-03-21,34,9300,273.53,29,7000,241,2300,bbc
2024-03-20,12,2600,216.67,20,4100,205,-1500,bbc
2024-03-19,13,3700,284.62,23,7400,322,-3700,bbc
2024-03-18,13,4200,323.08,31,13100,423,-8900,bbc
2024-03-15,6,1700,283.33,32,11700,366,-10000,bbc
2024-03-14,14,4800,342.86,21,4300,205,500,bbc
2024-03-13,14,4900,350.0,8,3000,375,1900,bbc
2024-03-12,20,7500,375.0,11,1600,145,5900,bbc
2024-03-11,16,5400,337.5,8,1000,125,4400,bbc
2024-03-08,18,25500,1416.67,9,1000,111,24500,bbc
2024-03-07,24,8800,366.67,10,2800,280,6000,bbc
2024-03-06,32,15000,468.75,16,1800,112,13200,bbc
2024-03-05,51,24000,470.59,18,4400,244,19600,bbc
2024-03-04,10,3200,320.0,10,2100,210,1100,bbc
2024-03-01,57,22900,401.75,8,1800,225,21100,bbc
2024-02-29,19,13300,700.0,10,2200,220,11100,bbc
2024-02-28,11,2900,263.64,8,1500,188,1400,bbc
2024-02-27,14,4500,321.43,13,2000,154,2500,bbc
2024-02-26,17,7600,447.06,15,2600,173,5000,bbc
2024-02-23,20,5900,295.0,16,2900,181,3000,bbc
2024-02-22,15,4400,293.33,14,2500,179,1900,bbc
2024-02-21,14,4800,342.86,11,2200,200,2600,bbc
2024-02-20,23,16600,721.74,16,5100,319,11500,bbc
2024-02-19,17,7300,429.41,7,2200,314,5100,bbc
2024-02-16,20,5700,285.0,12,2900,242,2800,bbc
2024-02-15,27,6100,225.93,16,6200,388,-100,bbc
2024-02-07,0,0,0.0,0,0,0,0,bbc
2024-02-06,20,9100,455.0,7,1800,257,7300,bbc
2024-02-05,23,5000,217.39,10,1900,190,3100,bbc
2024-02-02,19,6000,315.79,12,2200,183,3800,bbc
2024-02-01,20,7300,365.0,14,3500,250,3800,bbc
2024-01-31,18,7400,411.11,9,2200,244,5200,bbc
2024-01-30,16,4200,262.5,12,3500,292,700,bbc
2024-01-29,21,5800,276.19,17,2800,165,3000,bbc
2024-01-26,17,6200,364.71,15,2100,140,4100,bbc
2024-01-25,21,5900,280.95,13,1700,131,4200,bbc
2024-01-24,26,5800,223.08,11,2300,209,3500,bbc
2024-01-23,23,5900,256.52,10,2500,250,3400,bbc
2024-01-22,26,8400,323.08,7,3200,457,5200,bbc
2024-01-19,34,11900,350.0,13,1900,146,10000,bbc
2024-01-18,27,14700,544.44,20,2900,145,11800,bbc
2024-01-17,31,10700,345.16,15,3100,207,7600,bbc
2024-01-16,16,4000,250.0,13,2800,215,1200,bbc
2024-01-15,21,4900,233.33,18,2300,128,2600,bbc
2024-01-12,22,5800,263.64,28,4600,164,1200,bbc
2024-01-11,33,12400,375.76,12,1600,133,10800,bbc
2024-01-10,0,0,0.0,0,0,0,0,bbc
2024-01-09,54,9700,179.63,27,2800,104,6900,bbc
2024-01-08,39,51500,1320.51,29,6200,214,45300,bbc
2024-01-05,33,9800,296.97,30,10400,347,-600,bbc
2024-01-04,42,12800,304.76,29,4300,148,8500,bbc
2024-01-03,36,12100,336.11,36,7000,194,5100,bbc
2024-01-02,37,16800,454.05,44,6800,155,10000,bbc
2024-09-12,2,500,250.0,0,0,0,500,bbs
2024-09-11,1,0,0.0,0,0,0,0,bbs
2024-09-10,2,200,100.0,1,100,100,100,bbs
2024-09-09,3,500,166.67,0,0,0,500,bbs
2024-09-06,1,100,100.0,1,100,100,0,bbs
2024-09-05,2,2100,1050.0,1,4500,4500,-2400,bbs
2024-09-04,4,1500,375.0,2,300,150,1200,bbs
2024-08-30,4,2900,725.0,3,2200,733,700,bbs
2024-08-29,4,1000,250.0,1,100,100,900,bbs
2024-08-28,5,2200,440.0,1,100,100,2100,bbs
2024-08-27,2,800,400.0,1,100,100,700,bbs
2024-08-26,4,1000,250.0,1,400,400,600,bbs
2024-08-23,4,1000,250.0,1,200,200,800,bbs
2024-08-22,3,500,166.67,1,100,100,400,bbs
2024-08-21,9,2600,288.89,5,1700,340,900,bbs
2024-08-20,4,600,150.0,1,100,100,500,bbs
2024-08-19,4,600,150.0,1,300,300,300,bbs
2024-08-16,9,2500,277.78,3,1500,500,1000,bbs
2024-08-15,6,1600,266.67,2,500,250,1100,bbs
2024-08-14,8,2500,312.5,2,500,250,2000,bbs
2024-08-13,16,5700,356.25,8,4400,550,1300,bbs
2024-08-12,10,14900,1490.0,8,3500,438,11400,bbs
2024-08-09,8,2800,350.0,5,2500,500,300,bbs
2024-08-08,8,3500,437.5,5,2700,540,800,bbs
2024-08-07,12,6400,533.33,7,2500,357,3900,bbs
2024-08-06,6,2200,366.67,7,3300,471,-1100,bbs
2024-08-05,6,800,133.33,7,2700,386,-1900,bbs
2024-08-02,6,1900,316.67,5,3600,720,-1700,bbs
2024-08-01,5,900,180.0,6,3200,533,-2300,bbs
2024-07-31,9,4800,533.33,10,6400,640,-1600,bbs
2024-07-30,4,4600,1150.0,1,3400,3400,1200,bbs
2024-07-29,7,4000,571.43,1,3500,3500,500,bbs
2024-07-26,0,0,0.0,1,3500,3500,-3500,bbs
2024-07-25,0,0,0.0,1,3500,3500,-3500,bbs
2024-07-24,0,0,0.0,1,3500,3500,-3500,bbs
2024-07-23,0,0,0.0,1,3500,3500,-3500,bbs
2024-07-22,1,1000,1000.0,1,3500,3500,-2500,bbs
2024-07-19,2,4000,2000.0,1,3500,3500,500,bbs
2024-07-18,5,5500,1100.0,1,3500,3500,2000,bbs
2024-07-17,4,5200,1300.0,3,4600,1533,600,bbs
2024-07-16,6,7200,1200.0,3,4000,1333,3200,bbs
2024-07-15,10,7400,740.0,3,6200,2067,1200,bbs
2024-07-12,4,2800,700.0,2,5200,2600,-2400,bbs
2024-07-11,4,2500,625.0,3,5400,1800,-2900,bbs
2024-07-10,5,2200,440.0,3,5300,1767,-3100,bbs
2024-07-09,6,2700,450.0,2,5100,2550,-2400,bbs
2024-07-08,4,2400,600.0,1,5000,5000,-2600,bbs
2024-07-05,4,2200,550.0,1,5000,5000,-2800,bbs
2024-07-04,4,2100,525.0,1,5000,5000,-2900,bbs
2024-07-03,4,2000,500.0,1,5000,5000,-3000,bbs
2024-07-02,5,2500,500.0,4,6100,1525,-3600,bbs
2024-07-01,4,2000,500.0,3,5300,1767,-3300,bbs
2024-06-28,4,1500,375.0,4,5900,1475,-4400,bbs
2024-06-27,5,1800,360.0,2,5200,2600,-3400,bbs
2024-06-26,8,3000,375.0,2,5200,2600,-2200,bbs
2024-06-25,8,1800,225.0,5,3000,600,-1200,bbs
2024-06-24,4,1500,375.0,4,3000,750,-1500,bbs
2024-06-21,5,1500,300.0,4,3000,750,-1500,bbs
2024-06-20,6,1700,283.33,5,3100,620,-1400,bbs
2024-06-19,4,800,200.0,4,3100,775,-2300,bbs
2024-06-18,2,1000,500.0,5,4600,920,-3600,bbs
2024-06-17,3,1800,600.0,5,3700,740,-1900,bbs
2024-06-14,7,1500,214.29,3,4100,1367,-2600,bbs
2024-06-13,8,7900,987.5,5,9000,1800,-1100,bbs
2024-06-12,2,1100,550.0,1,2900,2900,-1800,bbs
2024-06-11,2,500,250.0,1,2900,2900,-2400,bbs
2024-06-10,1,200,200.0,1,500,500,-300,bbs
2024-06-07,4,1100,275.0,2,700,350,400,bbs
2024-06-06,2,400,200.0,2,700,350,-300,bbs
2024-06-05,1,200,200.0,2,700,350,-500,bbs
2024-06-04,2,700,350.0,2,700,350,0,bbs
2024-06-03,3,1000,333.33,2,700,350,300,bbs
2024-05-31,1,0,0.0,2,600,300,-600,bbs
2024-05-30,3,400,133.33,3,5700,1900,-5300,bbs
2024-05-29,3,800,266.67,1,500,500,300,bbs
2024-05-28,2,400,200.0,1,500,500,-100,bbs
2024-05-27,4,2700,675.0,2,3100,1550,-400,bbs
2024-05-24,2,2200,1100.0,4,2500,625,-300,bbs
2024-05-23,2,700,350.0,7,3600,514,-2900,bbs
2024-05-22,1,200,200.0,2,3600,1800,-3400,bbs
2024-05-21,0,0,0.0,3,4200,1400,-4200,bbs
2024-05-20,1,100,100.0,2,1100,550,-1000,bbs
2024-05-17,2,3200,1600.0,5,3600,720,-400,bbs
2024-05-16,1,200,200.0,3,2900,967,-2700,bbs
2024-05-15,0,0,0.0,2,6900,3450,-6900,bbs
2024-05-14,3,500,166.67,2,5900,2950,-5400,bbs
2024-05-13,9,4700,522.22,4,9400,2350,-4700,bbs
2024-05-10,6,1900,316.67,3,1700,567,200,bbs
2024-05-09,3,1600,533.33,3,3400,1133,-1800,bbs
2024-05-08,1,500,500.0,1,2000,2000,-1500,bbs
2024-05-07,0,0,0.0,1,2000,2000,-2000,bbs
2024-05-06,1,100,100.0,1,2000,2000,-1900,bbs
2024-05-03,2,1100,550.0,2,2700,1350,-1600,bbs
2024-05-02,3,1400,466.67,3,3000,1000,-1600,bbs
2024-04-26,0,0,0.0,2,8000,4000,-8000,bbs
2024-04-25,0,0,0.0,2,8000,4000,-8000,bbs
2024-04-24,0,0,0.0,1,2000,2000,-2000,bbs
2024-04-23,0,0,0.0,2,8000,4000,-8000,bbs
2024-04-22,1,500,500.0,3,8400,2800,-7900,bbs
2024-04-19,1,400,400.0,1,2000,2000,-1600,bbs
2024-04-17,1,200,200.0,1,2000,2000,-1800,bbs
2024-04-16,1,900,900.0,1,2000,2000,-1100,bbs
2024-04-15,1,1000,1000.0,2,7000,3500,-6000,bbs
2024-04-12,0,0,0.0,1,2000,2000,-2000,bbs
2024-04-11,0,0,0.0,1,2000,2000,-2000,bbs
2024-04-10,0,0,0.0,2,7000,3500,-7000,bbs
2024-04-09,0,0,0.0,0,0,0,0,bbs
2024-04-08,1,1000,1000.0,1,2000,2000,-1000,bbs
2024-04-05,2,600,300.0,2,2000,1000,-1400,bbs
2024-04-04,1,500,500.0,2,19700,9850,-19200,bbs
2024-04-03,2,800,400.0,2,600,300,200,bbs
2024-04-02,0,0,0.0,0,0,0,0,bbs
2024-04-01,2,600,300.0,0,0,0,600,bbs
2024-03-29,0,0,0.0,0,0,0,0,bbs
2024-03-28,1,400,400.0,0,0,0,400,bbs
2024-03-27,1,100,100.0,0,0,0,100,bbs
2024-03-26,1,400,400.0,0,0,0,400,bbs
2024-03-25,4,800,200.0,1,18700,18700,-17900,bbs
2024-03-22,2,700,350.0,3,3000,1000,-2300,bbs
2024-03-21,1,200,200.0,4,4000,1000,-3800,bbs
2024-03-20,4,600,150.0,3,3000,1000,-2400,bbs
2024-03-19,2,400,200.0,4,3500,875,-3100,bbs
2024-03-18,2,1000,500.0,3,3000,1000,-2000,bbs
2024-03-15,1,100,100.0,3,3000,1000,-2900,bbs
2024-03-14,2,200,100.0,3,3000,1000,-2800,bbs
2024-03-13,2,400,200.0,2,3300,1650,-2900,bbs
2024-03-12,9,2900,322.22,2,3000,1500,-100,bbs
2024-03-11,4,2700,675.0,1,1000,1000,1700,bbs
2024-03-08,4,2700,675.0,1,1000,1000,1700,bbs
2024-03-07,4,1700,425.0,1,1000,1000,700,bbs
2024-03-06,3,1800,600.0,1,1000,1000,800,bbs
2024-03-05,5,2100,420.0,1,1000,1000,1100,bbs
2024-03-04,4,2100,525.0,1,1000,1000,1100,bbs
2024-03-01,5,2000,400.0,1,1000,1000,1000,bbs
2024-02-29,4,2300,575.0,1,1000,1000,1300,bbs
2024-02-28,4,2500,625.0,1,1000,1000,1500,bbs
2024-02-27,7,3600,514.29,2,1300,650,2300,bbs
2024-02-26,5,2200,440.0,2,1000,500,1200,bbs
2024-02-23,6,7800,1300.0,1,1000,1000,6800,bbs
2024-02-22,7,3100,442.86,1,1000,1000,2100,bbs
2024-02-21,5,2900,580.0,1,1000,1000,1900,bbs
2024-02-20,6,5600,933.33,3,3100,1033,2500,bbs
2024-02-19,7,4700,671.43,2,3000,1500,1700,bbs
2024-02-16,2,1100,550.0,1,1000,1000,100,bbs
2024-02-15,7,3100,442.86,1,500,500,2600,bbs
2024-02-07,3,1300,433.33,0,0,0,1300,bbs
2024-02-06,3,1200,400.0,1,100,100,1100,bbs
2024-02-05,4,1000,250.0,4,5100,1275,-4100,bbs
2024-02-02,3,1200,400.0,4,5400,1350,-4200,bbs
2024-02-01,6,1900,316.67,6,7500,1250,-5600,bbs
2024-01-31,3,1600,533.33,3,6900,2300,-5300,bbs
2024-01-30,4,1600,400.0,3,7200,2400,-5600,bbs
2024-01-29,3,1500,500.0,3,7200,2400,-5700,bbs
2024-01-26,3,1800,600.0,2,8700,4350,-6900,bbs
2024-01-25,4,1300,325.0,3,10000,3333,-8700,bbs
2024-01-24,1,1000,1000.0,0,0,0,1000,bbs
2024-01-23,3,2000,666.67,2,1700,850,300,bbs
2024-01-22,3,1900,633.33,1,2200,2200,-300,bbs
2024-01-19,7,5400,771.43,3,3400,1133,2000,bbs
2024-01-18,4,6900,1725.0,2,5100,2550,1800,bbs
2024-01-17,5,4100,820.0,2,500,250,3600,bbs
2024-01-16,5,2700,540.0,7,2200,314,500,bbs
2024-01-15,2,200,100.0,4,8400,2100,-8200,bbs
2024-01-12,1,100,100.0,1,100,100,0,bbs
2024-01-11,12,17900,1491.67,15,16200,1080,1700,bbs
2024-01-10,4,3800,950.0,2,16000,8000,-12200,bbs
2024-01-09,1,200,200.0,1,500,500,-300,bbs
2024-01-08,2,600,300.0,3,16100,5367,-15500,bbs
2024-01-05,2,2100,1050.0,4,2600,650,-500,bbs
2024-01-04,1,1100,1100.0,4,1800,450,-700,bbs
2024-01-03,3,1400,466.67,2,1200,600,200,bbs
2024-01-02,2,500,250.0,3,17900,5967,-17400,bbs
2024-09-12,12,5900,491.67,5,3800,760,2100,bbt
2024-09-11,11,6100,554.55,7,3100,443,3000,bbt
2024-09-10,10,5300,530.0,4,800,200,4500,bbt
2024-09-09,21,10300,490.48,6,5700,950,4600,bbt
2024-09-06,11,7200,654.55,7,2900,414,4300,bbt
2024-09-05,12,7900,658.33,6,2800,467,5100,bbt
2024-09-04,12,6300,525.0,8,5200,650,1100,bbt
2024-08-30,13,12000,923.08,9,5800,644,6200,bbt
2024-08-29,8,3900,487.5,9,5900,656,-2000,bbt
2024-08-28,4,5300,1325.0,9,6400,711,-1100,bbt
2024-08-27,3,2600,866.67,8,4800,600,-2200,bbt
2024-08-26,3,1600,533.33,9,6500,722,-4900,bbt
2024-08-23,6,3800,633.33,10,5700,570,-1900,bbt
2024-08-22,6,4700,783.33,10,5600,560,-900,bbt
2024-08-21,9,4800,533.33,7,7700,1100,-2900,bbt
2024-08-20,11,7900,718.18,5,2200,440,5700,bbt
2024-08-19,5,1200,240.0,8,4000,500,-2800,bbt
2024-08-16,5,2200,440.0,9,3100,344,-900,bbt
2024-08-15,3,1600,533.33,6,4100,683,-2500,bbt
2024-08-14,9,7400,822.22,7,3000,429,4400,bbt
2024-08-13,5,3700,740.0,4,2000,500,1700,bbt
2024-08-12,5,3200,640.0,5,4100,820,-900,bbt
2024-08-09,12,6600,550.0,6,5000,833,1600,bbt
2024-08-08,1,1000,1000.0,13,8200,631,-7200,bbt
2024-08-07,8,5500,687.5,15,10000,667,-4500,bbt
2024-08-06,6,3900,650.0,6,4900,817,-1000,bbt
2024-08-05,13,6900,530.77,5,2600,520,4300,bbt
2024-08-02,17,13200,776.47,6,5300,883,7900,bbt
2024-08-01,15,13800,920.0,4,1600,400,12200,bbt
2024-07-31,19,15500,815.79,4,1500,375,14000,bbt
2024-07-30,15,13300,886.67,6,4500,750,8800,bbt
2024-07-29,11,9500,863.64,5,2400,480,7100,bbt
2024-07-26,9,7500,833.33,4,2000,500,5500,bbt
2024-07-25,16,13600,850.0,5,1600,320,12000,bbt
2024-07-24,14,11000,785.71,2,1800,900,9200,bbt
2024-07-23,9,11100,1233.33,2,1800,900,9300,bbt
2024-07-22,9,6500,722.22,7,4400,629,2100,bbt
2024-07-19,9,6500,722.22,15,11600,773,-5100,bbt
2024-07-18,8,3400,425.0,15,7600,507,-4200,bbt
2024-07-17,8,4900,612.5,13,7200,554,-2300,bbt
2024-07-16,9,3900,433.33,14,8800,629,-4900,bbt
2024-07-15,13,9700,746.15,8,5500,688,4200,bbt
2024-07-12,17,9200,541.18,17,10300,606,-1100,bbt
2024-07-11,21,10100,480.95,11,6000,545,4100,bbt
2024-07-10,18,3800,211.11,17,7000,412,-3200,bbt
2024-07-09,14,8600,614.29,5,8200,1640,400,bbt
2024-07-08,11,7400,672.73,2,1000,500,6400,bbt
2024-07-05,20,12300,615.0,13,8000,615,4300,bbt
2024-07-04,7,3500,500.0,6,2400,400,1100,bbt
2024-07-03,8,4100,512.5,9,3000,333,1100,bbt
2024-07-02,5,3800,760.0,7,1600,229,2200,bbt
2024-07-01,4,2600,650.0,9,1500,167,1100,bbt
2024-06-28,5,2700,540.0,8,3600,450,-900,bbt
2024-06-27,4,2700,675.0,11,9300,845,-6600,bbt
2024-06-26,7,4800,685.71,8,3100,388,1700,bbt
2024-06-25,5,2700,540.0,10,4300,430,-1600,bbt
2024-06-24,19,21400,1126.32,9,9000,1000,12400,bbt
2024-06-21,17,10400,611.76,3,1500,500,8900,bbt
2024-06-20,13,4800,369.23,18,9100,506,-4300,bbt
2024-06-19,3,800,266.67,15,6800,453,-6000,bbt
2024-06-18,2,2700,1350.0,13,4000,308,-1300,bbt
2024-06-17,7,2900,414.29,14,4300,307,-1400,bbt
2024-06-14,14,12000,857.14,20,20400,1020,-8400,bbt
2024-06-13,11,4500,409.09,16,8600,538,-4100,bbt
2024-06-12,7,3900,557.14,12,4400,367,-500,bbt
2024-06-11,15,10500,700.0,10,3100,310,7400,bbt
2024-06-10,17,13800,811.76,12,7300,608,6500,bbt
2024-06-07,18,22900,1272.22,15,8900,593,14000,bbt
2024-06-06,15,11100,740.0,6,3000,500,8100,bbt
2024-06-05,19,17600,926.32,12,6500,542,11100,bbt
2024-06-04,18,17600,977.78,8,9500,1188,8100,bbt
2024-06-03,7,2300,328.57,5,6300,1260,-4000,bbt
2024-05-31,9,7500,833.33,13,5600,431,1900,bbt
2024-05-30,6,3600,600.0,11,9100,827,-5500,bbt
2024-05-29,11,5500,500.0,10,3100,310,2400,bbt
2024-05-28,13,5300,407.69,8,1800,225,3500,bbt
2024-05-27,9,4600,511.11,8,1700,212,2900,bbt
2024-05-24,8,4300,537.5,5,1800,360,2500,bbt
2024-05-23,12,5900,491.67,8,2700,338,3200,bbt
2024-05-22,11,4200,381.82,9,7100,789,-2900,bbt
2024-05-21,9,5300,588.89,10,3600,360,1700,bbt
2024-05-20,20,7100,355.0,8,5400,675,1700,bbt
2024-05-17,11,5600,509.09,10,2400,240,3200,bbt
2024-05-16,7,2100,300.0,10,600,60,1500,bbt
2024-05-15,6,1600,266.67,9,600,67,1000,bbt
2024-05-14,7,2100,300.0,10,400,40,1700,bbt
2024-05-13,11,5000,454.55,6,400,67,4600,bbt
2024-05-10,12,2800,233.33,9,2100,233,700,bbt
2024-05-09,10,2400,240.0,11,1500,136,900,bbt
2024-05-08,13,3300,253.85,12,2800,233,500,bbt
2024-05-07,8,3400,425.0,12,3900,325,-500,bbt
2024-05-06,10,6800,680.0,17,3700,218,3100,bbt
2024-05-03,6,4100,683.33,5,600,120,3500,bbt
2024-05-02,3,800,266.67,8,6600,825,-5800,bbt
2024-04-26,6,900,150.0,13,10800,831,-9900,bbt
2024-04-25,21,21600,1028.57,25,18300,732,3300,bbt
2024-04-24,6,3000,500.0,12,4000,333,-1000,bbt
2024-04-23,8,3300,412.5,11,7600,691,-4300,bbt
2024-04-22,9,4700,522.22,5,3800,760,900,bbt
2024-04-19,6,3600,600.0,6,6100,1017,-2500,bbt
2024-04-17,9,4300,477.78,17,8600,506,-4300,bbt
2024-04-16,12,4100,341.67,8,5400,675,-1300,bbt
2024-04-15,7,3000,428.57,12,8200,683,-5200,bbt
2024-04-12,3,2200,733.33,8,2700,338,-500,bbt
2024-04-11,5,2300,460.0,10,6900,690,-4600,bbt
2024-04-10,7,5400,771.43,16,10700,669,-5300,bbt
2024-04-09,11,5000,454.55,13,8500,654,-3500,bbt
2024-04-08,18,7900,438.89,10,8500,850,-600,bbt
2024-04-05,14,6500,464.29,7,6000,857,500,bbt
2024-04-04,8,4400,550.0,13,4000,308,400,bbt
2024-04-03,10,4200,420.0,13,8500,654,-4300,bbt
2024-04-02,9,5300,588.89,11,4200,382,1100,bbt
2024-04-01,14,4200,300.0,16,9200,575,-5000,bbt
2024-03-29,23,8200,356.52,14,8000,571,200,bbt
2024-03-28,15,9000,600.0,11,9100,827,-100,bbt
2024-03-27,11,10800,981.82,16,5700,356,5100,bbt
2024-03-26,16,9900,618.75,16,4500,281,5400,bbt
2024-03-25,10,3600,360.0,12,3300,275,300,bbt
2024-03-22,13,5500,423.08,12,8700,725,-3200,bbt
2024-03-21,21,12200,580.95,12,9900,825,2300,bbt
2024-03-20,17,7700,452.94,7,6800,971,900,bbt
2024-03-19,25,10200,408.0,7,7400,1057,2800,bbt
2024-03-18,26,10100,388.46,9,4700,522,5400,bbt
2024-03-15,27,21000,777.78,14,17300,1236,3700,bbt
2024-03-14,8,900,112.5,18,9700,539,-8800,bbt
2024-03-13,7,700,100.0,14,8900,636,-8200,bbt
2024-03-12,9,2500,277.78,16,12000,750,-9500,bbt
2024-03-11,4,1300,325.0,11,6000,545,-4700,bbt
2024-03-08,6,400,66.67,7,3000,429,-2600,bbt
2024-03-07,12,2300,191.67,10,6600,660,-4300,bbt
2024-03-06,9,2800,311.11,6,2200,367,600,bbt
2024-03-05,34,7100,208.82,12,5600,467,1500,bbt
2024-03-04,21,9500,452.38,20,28500,1425,-19000,bbt
2024-03-01,0,0,0.0,13,6300,485,-6300,bbt
2024-02-29,0,0,0.0,11,5500,500,-5500,bbt
2024-02-28,0,0,0.0,15,23400,1560,-23400,bbt
2024-02-27,0,0,0.0,12,11500,958,-11500,bbt
2024-02-26,4,0,0.0,10,21500,2150,-21500,bbt
2024-02-23,2,200,100.0,19,25100,1321,-24900,bbt
2024-02-22,6,2000,333.33,21,21400,1019,-19400,bbt
2024-02-21,7,1500,214.29,19,11000,579,-9500,bbt
2024-02-20,18,13500,750.0,22,18400,836,-4900,bbt
2024-02-19,16,3100,193.75,12,5700,475,-2600,bbt
2024-02-16,6,1300,216.67,3,400,133,900,bbt
2024-02-15,11,1500,136.36,3,200,67,1300,bbt
2024-02-07,5,800,160.0,5,2200,440,-1400,bbt
2024-02-06,5,2900,580.0,6,2800,467,100,bbt
2024-02-05,10,3600,360.0,4,600,150,3000,bbt
2024-02-02,8,3800,475.0,6,2800,467,1000,bbt
2024-02-01,9,4800,533.33,4,2200,550,2600,bbt
2024-01-31,5,6000,1200.0,5,5100,1020,900,bbt
2024-01-30,8,4200,525.0,6,2700,450,1500,bbt
2024-01-29,9,3800,422.22,3,400,133,3400,bbt
2024-01-26,14,6400,457.14,5,4200,840,2200,bbt
2024-01-25,14,9000,642.86,3,1100,367,7900,bbt
2024-01-24,27,27500,1018.52,3,5800,1933,21700,bbt
2024-01-23,6,3300,550.0,3,1900,633,1400,bbt
2024-01-22,6,3200,533.33,2,600,300,2600,bbt
2024-01-19,7,7200,1028.57,2,700,350,6500,bbt
2024-01-18,17,9400,552.94,5,8100,1620,1300,bbt
2024-01-17,10,6200,620.0,2,1500,750,4700,bbt
2024-01-16,8,4200,525.0,5,3900,780,300,bbt
2024-01-15,7,7000,1000.0,3,9500,3167,-2500,bbt
2024-01-12,6,4000,666.67,4,9700,2425,-5700,bbt
2024-01-11,8,3100,387.5,5,8200,1640,-5100,bbt
2024-01-10,9,3900,433.33,5,9800,1960,-5900,bbt
2024-01-09,7,3600,514.29,11,6400,582,-2800,bbt
2024-01-08,10,10100,1010.0,11,2500,227,7600,bbt
2024-01-05,15,12200,813.33,8,3700,462,8500,bbt
2024-01-04,9,5900,655.56,6,1600,267,4300,bbt
2024-01-03,15,14800,986.67,3,2700,900,12100,bbt
2024-01-02,17,12600,741.18,10,2000,200,10600,bbt
2024-09-12,108,202300,1873.15,85,169100,1989,33200,bcc
2024-09-11,123,231800,1884.55,106,221600,2091,10200,bcc
2024-09-10,110,107300,975.45,108,198500,1838,-91200,bcc
2024-09-09,154,205000,1331.17,146,299300,2050,-94300,bcc
2024-09-06,90,194200,2157.78,95,157200,1655,37000,bcc
2024-09-05,132,226900,1718.94,151,281100,1862,-54200,bcc
2024-09-04,144,262500,1822.92,91,182100,2001,80400,bcc
2024-08-30,128,213400,1667.19,135,170900,1266,42500,bcc
2024-08-29,102,208000,2039.22,139,248900,1791,-40900,bcc
2024-08-28,122,370800,3039.34,181,297900,1646,72900,bcc
2024-08-27,122,160800,1318.03,119,230500,1937,-69700,bcc
2024-08-26,161,251000,1559.01,167,275300,1649,-24300,bcc
2024-08-23,152,166500,1095.39,125,209400,1675,-42900,bcc
2024-08-22,126,184800,1466.67,153,279700,1828,-94900,bcc
2024-08-21,136,223900,1646.32,211,427000,2024,-203100,bcc
2024-08-20,152,155500,1023.03,153,239700,1567,-84200,bcc
2024-08-19,141,265000,1879.43,167,297600,1782,-32600,bcc
2024-08-16,182,317200,1742.86,198,317700,1605,-500,bcc
2024-08-15,108,205500,1902.78,100,288300,2883,-82800,bcc
2024-08-14,107,230700,2156.07,148,286100,1933,-55400,bcc
2024-08-13,102,209300,2051.96,146,259600,1778,-50300,bcc
2024-08-12,140,140800,1005.71,123,278600,2265,-137800,bcc
2024-08-09,102,124600,1221.57,126,167100,1326,-42500,bcc
2024-08-08,206,299400,1453.4,146,277500,1901,21900,bcc
2024-08-07,165,195300,1183.64,91,176300,1937,19000,bcc
2024-08-06,204,278200,1363.73,107,229800,2148,48400,bcc
2024-08-05,317,329000,1037.85,178,371500,2087,-42500,bcc
2024-08-02,181,289600,1600.0,106,283700,2676,5900,bcc
2024-08-01,326,561200,1721.47,199,556400,2796,4800,bcc
2024-07-31,198,424400,2143.43,132,328100,2486,96300,bcc
2024-07-30,204,294500,1443.63,109,350500,3216,-56000,bcc
2024-07-29,221,317500,1436.65,95,262400,2762,55100,bcc
2024-07-26,157,269200,1714.65,92,143500,1560,125700,bcc
2024-07-25,266,367500,1381.58,97,320300,3302,47200,bcc
2024-07-24,372,489300,1315.32,142,523100,3684,-33800,bcc
2024-07-23,243,271000,1115.23,125,265600,2125,5400,bcc
2024-07-22,439,446500,1017.08,149,397500,2668,49000,bcc
2024-07-19,545,771500,1415.6,213,927200,4353,-155700,bcc
2024-07-18,383,526400,1374.41,186,517400,2782,9000,bcc
2024-07-17,288,544800,1891.67,278,779300,2803,-234500,bcc
2024-07-16,402,810900,2017.16,556,1322100,2378,-511200,bcc
2024-07-15,171,332200,1942.69,407,768600,1888,-436400,bcc
2024-07-12,418,777400,1859.81,681,1283700,1885,-506300,bcc
2024-07-11,213,270900,1271.83,204,400600,1964,-129700,bcc
2024-07-10,202,253000,1252.48,296,588400,1988,-335400,bcc
2024-07-09,254,269900,1062.6,380,722200,1901,-452300,bcc
2024-07-08,331,1881400,5683.99,677,1029400,1521,852000,bcc
2024-07-05,226,245500,1086.28,225,364400,1620,-118900,bcc
2024-07-04,265,265300,1001.13,244,494400,2026,-229100,bcc
2024-07-03,132,167300,1267.42,284,472500,1664,-305200,bcc
2024-07-02,129,205700,1594.57,343,512300,1494,-306600,bcc
2024-07-01,119,176700,1484.87,160,247500,1547,-70800,bcc
2024-06-28,189,265800,1406.35,253,514000,2032,-248200,bcc
2024-06-27,156,229200,1469.23,347,598800,1726,-369600,bcc
2024-06-26,230,372100,1617.83,333,626200,1880,-254100,bcc
2024-06-25,201,276900,1377.61,229,457600,1998,-180700,bcc
2024-06-24,356,489700,1375.56,410,835200,2037,-345500,bcc
2024-06-21,325,617900,1901.23,596,1179800,1980,-561900,bcc
2024-06-20,278,490200,1763.31,381,770000,2021,-279800,bcc
2024-06-19,253,351200,1388.14,374,753300,2014,-402100,bcc
2024-06-18,476,988900,2077.52,666,1318300,1979,-329400,bcc
2024-06-17,291,361000,1240.55,457,709800,1553,-348800,bcc
2024-06-14,836,1573800,1882.54,701,1324200,1889,249600,bcc
2024-06-13,315,455900,1447.3,218,399300,1832,56600,bcc
2024-06-12,231,282400,1222.51,176,298700,1697,-16300,bcc
2024-06-11,260,365300,1405.0,207,392100,1894,-26800,bcc
2024-06-10,270,353900,1310.74,232,359700,1550,-5800,bcc
2024-06-07,256,371700,1451.95,194,309700,1596,62000,bcc
2024-06-06,279,312400,1119.71,229,372900,1628,-60500,bcc
2024-06-05,295,463800,1572.2,281,493600,1757,-29800,bcc
2024-06-04,327,382500,1169.72,241,463100,1922,-80600,bcc
2024-06-03,287,367100,1279.09,237,399800,1687,-32700,bcc
2024-05-31,188,268900,1430.32,184,362100,1968,-93200,bcc
2024-05-30,217,332000,1529.95,241,456500,1894,-124500,bcc
2024-05-29,308,448000,1454.55,291,492400,1692,-44400,bcc
2024-05-28,210,284400,1354.29,211,331700,1572,-47300,bcc
2024-05-27,217,316800,1459.91,137,233900,1707,82900,bcc
2024-05-24,322,386300,1199.69,244,458000,1877,-71700,bcc
2024-05-23,210,310300,1477.62,211,288500,1367,21800,bcc
2024-05-22,254,397200,1563.78,254,438800,1728,-41600,bcc
2024-05-21,241,455000,1887.97,260,367000,1412,88000,bcc
2024-05-20,285,351700,1234.04,284,376200,1325,-24500,bcc
2024-05-17,252,275300,1092.46,196,233500,1191,41800,bcc
2024-05-16,278,324300,1166.55,211,308300,1461,16000,bcc
2024-05-15,284,300400,1057.75,208,323100,1553,-22700,bcc
2024-05-14,182,231200,1270.33,201,331900,1651,-100700,bcc
2024-05-13,221,245000,1108.6,173,235100,1359,9900,bcc
2024-05-10,251,184600,735.46,132,203300,1540,-18700,bcc
2024-05-09,276,248600,900.72,204,350000,1716,-101400,bcc
2024-05-08,161,191600,1190.06,172,259600,1509,-68000,bcc
2024-05-07,247,326000,1319.84,185,321100,1736,4900,bcc
2024-05-06,201,231900,1153.73,144,214500,1490,17400,bcc
2024-05-03,191,214100,1120.94,108,240800,2230,-26700,bcc
2024-05-02,160,202400,1265.0,127,197100,1552,5300,bcc
2024-04-26,152,179000,1177.63,119,218700,1838,-39700,bcc
2024-04-25,178,280500,1575.84,146,352000,2411,-71500,bcc
2024-04-24,254,266600,1049.61,162,281000,1735,-14400,bcc
2024-04-23,158,176800,1118.99,122,293700,2407,-116900,bcc
2024-04-22,191,262000,1371.73,109,221400,2031,40600,bcc
2024-04-19,315,317800,1008.89,182,435800,2395,-118000,bcc
2024-04-17,281,254200,904.63,172,292500,1701,-38300,bcc
2024-04-16,550,601700,1094.0,244,664100,2722,-62400,bcc
2024-04-15,436,436100,1000.23,245,566000,2310,-129900,bcc
2024-04-12,400,394000,985.0,219,370200,1690,23800,bcc
2024-04-11,255,221700,869.41,207,331800,1603,-110100,bcc
2024-04-10,237,246900,1041.77,217,345600,1593,-98700,bcc
2024-04-09,381,362900,952.49,170,552500,3250,-189600,bcc
2024-04-08,604,721500,1194.54,248,818900,3302,-97400,bcc
2024-04-05,347,308000,887.61,227,523300,2305,-215300,bcc
2024-04-04,340,363700,1069.71,246,465700,1893,-102000,bcc
2024-04-03,393,400300,1018.58,298,597200,2004,-196900,bcc
2024-04-02,445,745900,1676.18,283,976000,3449,-230100,bcc
2024-04-01,442,650900,1472.62,309,966000,3126,-315100,bcc
2024-03-29,346,317000,916.18,252,528400,2097,-211400,bcc
2024-03-28,362,561900,1552.21,327,786500,2405,-224600,bcc
2024-03-27,381,407500,1069.55,298,710600,2385,-303100,bcc
2024-03-26,325,376800,1159.38,242,604300,2497,-227500,bcc
2024-03-25,545,518500,951.38,329,807500,2454,-289000,bcc
2024-03-22,499,554000,1110.22,351,741500,2113,-187500,bcc
2024-03-21,674,836100,1240.5,256,840300,3282,-4200,bcc
2024-03-20,325,300300,924.0,220,453400,2061,-153100,bcc
2024-03-19,270,289400,1071.85,184,468100,2544,-178700,bcc
2024-03-18,583,620900,1065.01,371,892900,2407,-272000,bcc
2024-03-15,348,298500,857.76,378,618900,1637,-320400,bcc
2024-03-14,401,712900,1777.81,615,1079900,1756,-367000,bcc
2024-03-13,438,595300,1359.13,205,534500,2607,60800,bcc
2024-03-12,391,344900,882.1,217,453900,2092,-109000,bcc
2024-03-11,412,318500,773.06,189,812200,4297,-493700,bcc
2024-03-08,526,484400,920.91,276,1158400,4197,-674000,bcc
2024-03-07,417,460700,1104.8,260,558400,2148,-97700,bcc
2024-03-06,460,529400,1150.87,275,709400,2580,-180000,bcc
2024-03-05,361,388100,1075.07,248,558800,2253,-170700,bcc
2024-03-04,369,496300,1344.99,314,708900,2258,-212600,bcc
2024-03-01,385,519700,1349.87,286,653900,2286,-134200,bcc
2024-02-29,356,531900,1494.1,337,827400,2455,-295500,bcc
2024-02-28,320,403500,1260.94,349,624700,1790,-221200,bcc
2024-02-27,356,671400,1885.96,253,628900,2486,42500,bcc
2024-02-26,256,372000,1453.12,240,511700,2132,-139700,bcc
2024-02-23,401,893200,2227.43,399,1062500,2663,-169300,bcc
2024-02-22,423,848700,2006.38,333,678700,2038,170000,bcc
2024-02-21,372,587200,1578.49,346,632200,1827,-45000,bcc
2024-02-20,485,889000,1832.99,611,1093400,1790,-204400,bcc
2024-02-19,482,1100800,2283.82,392,814900,2079,285900,bcc
2024-02-16,435,857300,1970.8,267,703000,2633,154300,bcc
2024-02-15,231,451700,1955.41,256,570600,2229,-118900,bcc
2024-02-07,227,567400,2499.56,278,647600,2329,-80200,bcc
2024-02-06,150,326900,2179.33,152,253700,1669,73200,bcc
2024-02-05,180,240800,1337.78,178,329200,1849,-88400,bcc
2024-02-02,224,503500,2247.77,260,455200,1751,48300,bcc
2024-02-01,276,396100,1435.14,181,312600,1727,83500,bcc
2024-01-31,191,213900,1119.9,212,429200,2025,-215300,bcc
2024-01-30,215,221300,1029.3,190,413800,2178,-192500,bcc
2024-01-29,179,337700,1886.59,228,484900,2127,-147200,bcc
2024-01-26,169,345500,2044.38,187,308200,1648,37300,bcc
2024-01-25,205,249600,1217.56,148,311400,2104,-61800,bcc
2024-01-24,203,234100,1153.2,217,392900,1811,-158800,bcc
2024-01-23,197,213500,1083.76,226,440400,1949,-226900,bcc
2024-01-22,211,408500,1936.02,237,492100,2076,-83600,bcc
2024-01-19,219,371900,1698.17,240,503400,2098,-131500,bcc
2024-01-18,229,336800,1470.74,218,469500,2154,-132700,bcc
2024-01-17,205,292100,1424.88,252,525600,2086,-233500,bcc
2024-01-16,319,438100,1373.35,186,422700,2273,15400,bcc
2024-01-15,155,258300,1666.45,165,460500,2791,-202200,bcc
2024-01-12,470,601300,1279.36,242,591800,2445,9500,bcc
2024-01-11,280,541400,1933.57,210,443200,2110,98200,bcc
2024-01-10,452,779300,1724.12,306,863500,2822,-84200,bcc
2024-01-09,326,432300,1326.07,345,616900,1788,-184600,bcc
2024-01-08,389,1239900,3187.4,642,1285500,2002,-45600,bcc
2024-01-05,309,377700,1222.33,235,559000,2379,-181300,bcc
2024-01-04,407,660200,1622.11,359,902600,2514,-242400,bcc
2024-01-03,405,1061800,2621.73,715,1160900,1624,-99100,bcc
2024-01-02,200,269300,1346.5,205,347500,1695,-78200,bcc
2024-09-12,45,36700,815.56,41,44900,1095,-8200,bce
2024-09-11,34,41700,1226.47,40,45900,1148,-4200,bce
2024-09-10,38,42600,1121.05,32,28700,897,13900,bce
2024-09-09,38,82000,2157.89,26,86900,3342,-4900,bce
2024-09-06,35,53800,1537.14,36,33300,925,20500,bce
2024-09-05,31,53100,1712.9,36,35500,986,17600,bce
2024-09-04,64,113900,1779.69,64,101400,1584,12500,bce
2024-08-30,29,26700,920.69,47,40300,857,-13600,bce
2024-08-29,47,1069400,22753.19,45,1052600,23391,16800,bce
2024-08-28,32,60500,1890.62,50,35500,710,25000,bce
2024-08-27,34,78900,2320.59,33,69000,2091,9900,bce
2024-08-26,47,120800,2570.21,51,128600,2522,-7800,bce
2024-08-23,40,113200,2830.0,44,102700,2334,10500,bce
2024-08-22,43,126300,2937.21,52,117000,2250,9300,bce
2024-08-21,38,134900,3550.0,90,166300,1848,-31400,bce
2024-08-20,112,240800,2150.0,73,127200,1742,113600,bce
2024-08-19,45,79900,1775.56,50,98400,1968,-18500,bce
2024-08-16,66,66000,1000.0,77,67100,871,-1100,bce
2024-08-15,60,109500,1825.0,44,55100,1252,54400,bce
2024-08-14,43,154500,3593.02,74,116400,1573,38100,bce
2024-08-13,35,133700,3820.0,62,57500,927,76200,bce
2024-08-12,64,108000,1687.5,38,74800,1968,33200,bce
2024-08-08,29,43400,1496.55,58,129700,2236,-86300,bce
2024-08-07,54,90800,1681.48,73,140000,1918,-49200,bce
2024-08-06,59,58100,984.75,110,223300,2030,-165200,bce
2024-08-05,71,121100,1705.63,61,142900,2343,-21800,bce
2024-08-02,93,88000,946.24,58,104500,1802,-16500,bce
2024-08-01,123,109800,892.68,114,211300,1854,-101500,bce
2024-07-31,70,115800,1654.29,71,209700,2954,-93900,bce
2024-07-30,83,88000,1060.24,59,102700,1741,-14700,bce
2024-07-29,108,102700,950.93,109,219200,2011,-116500,bce
2024-07-26,118,181500,1538.14,165,194100,1176,-12600,bce
2024-07-25,74,69300,936.49,46,77600,1687,-8300,bce
2024-07-24,134,115300,860.45,55,106100,1929,9200,bce
2024-07-22,98,145900,1488.78,64,83900,1311,62000,bce
2024-07-19,154,184500,1198.05,127,290700,2289,-106200,bce
2024-07-18,181,251000,1386.74,119,258500,2172,-7500,bce
2024-07-17,174,334900,1924.71,146,367500,2517,-32600,bce
2024-07-16,158,221800,1403.8,181,313300,1731,-91500,bce
2024-07-15,277,707800,2555.23,230,492100,2140,215700,bce
2024-07-12,137,187500,1368.61,66,173300,2626,14200,bce
2024-07-11,111,126200,1136.94,54,115600,2141,10600,bce
2024-07-10,130,219200,1686.15,77,147000,1909,72200,bce
2024-07-09,112,205100,1831.25,58,189100,3260,16000,bce
2024-07-08,41,119000,2902.44,81,149300,1843,-30300,bce
2024-07-05,54,74100,1372.22,37,82200,2222,-8100,bce
2024-07-04,65,78300,1204.62,46,59100,1285,19200,bce
2024-07-03,71,82000,1154.93,58,45000,776,37000,bce
2024-07-02,51,64300,1260.78,90,117400,1304,-53100,bce
2024-07-01,73,118000,1616.44,56,68300,1220,49700,bce
2024-06-28,85,111800,1315.29,83,110700,1334,1100,bce
2024-06-27,105,106200,1011.43,101,109300,1082,-3100,bce
2024-06-26,101,106600,1055.45,76,83000,1092,23600,bce
2024-06-25,108,136400,1262.96,49,63600,1298,72800,bce
2024-06-24,114,196400,1722.81,109,243800,2237,-47400,bce
2024-06-21,177,456500,2579.1,92,148700,1616,307800,bce
2024-06-20,95,153500,1615.79,71,80200,1130,73300,bce
2024-06-19,173,315500,1823.7,109,237900,2183,77600,bce
2024-06-18,100,110000,1100.0,72,148700,2065,-38700,bce
2024-06-17,103,144400,1401.94,68,138500,2037,5900,bce
2024-06-14,58,116800,2013.79,128,251500,1965,-134700,bce
2024-06-13,60,110700,1845.0,106,245800,2319,-135100,bce
2024-06-12,103,256100,2486.41,85,125100,1472,131000,bce
2024-06-11,65,86900,1336.92,76,143500,1888,-56600,bce
2024-06-10,70,161200,2302.86,98,121500,1240,39700,bce
2024-06-07,114,213800,1875.44,91,152800,1679,61000,bce
2024-06-06,140,326400,2331.43,72,311400,4325,15000,bce
2024-06-05,104,184700,1775.96,86,165300,1922,19400,bce
2024-06-04,160,280900,1755.62,101,237200,2349,43700,bce
2024-06-03,79,136800,1731.65,109,212600,1950,-75800,bce
2024-05-31,55,58700,1067.27,74,117400,1586,-58700,bce
2024-05-30,73,111200,1523.29,75,155500,2073,-44300,bce
2024-05-29,114,166700,1462.28,92,152400,1657,14300,bce
2024-05-28,51,64200,1258.82,81,84800,1047,-20600,bce
2024-05-27,38,45200,1189.47,39,31300,803,13900,bce
2024-05-24,145,164200,1132.41,76,156700,2062,7500,bce
2024-05-23,88,107800,1225.0,86,108500,1262,-700,bce
2024-05-22,106,131600,1241.51,91,156800,1723,-25200,bce
2024-05-21,123,179600,1460.16,151,206900,1370,-27300,bce
2024-05-20,102,269200,2639.22,175,336700,1924,-67500,bce
2024-05-17,86,95700,1112.79,110,257400,2340,-161700,bce
2024-05-16,52,67100,1290.38,133,122400,920,-55300,bce
2024-05-15,50,63800,1276.0,107,100500,939,-36700,bce
2024-05-14,63,106700,1693.65,140,133700,955,-27000,bce
2024-05-13,151,572000,3788.08,204,222900,1093,349100,bce
2024-05-10,71,161800,2278.87,60,72000,1200,89800,bce
2024-05-09,90,140400,1560.0,104,88300,849,52100,bce
2024-05-08,103,187300,1818.45,105,162500,1548,24800,bce
2024-05-07,88,123800,1406.82,100,121100,1211,2700,bce
2024-05-06,39,40600,1041.03,31,63100,2035,-22500,bce
2024-05-03,82,55500,676.83,56,112600,2011,-57100,bce
2024-05-02,80,69400,867.5,44,82000,1864,-12600,bce
2024-04-26,37,20800,562.16,72,139600,1939,-118800,bce
2024-04-25,50,53700,1074.0,76,120600,1587,-66900,bce
2024-04-24,82,80800,985.37,62,77900,1256,2900,bce
2024-04-23,45,33300,740.0,54,58200,1078,-24900,bce
2024-04-22,103,86700,841.75,66,82700,1253,4000,bce
2024-04-19,77,507900,6596.1,71,543200,7651,-35300,bce
2024-04-17,52,89400,1719.23,53,66500,1255,22900,bce
2024-04-16,167,668300,4001.8,92,791200,8600,-122900,bce
2024-04-15,64,129900,2029.69,80,156600,1958,-26700,bce
2024-04-12,70,93700,1338.57,77,94400,1226,-700,bce
2024-04-11,88,159500,1812.5,77,111700,1451,47800,bce
2024-04-10,75,205400,2738.67,63,207100,3287,-1700,bce
2024-04-09,61,103500,1696.72,68,78600,1156,24900,bce
2024-04-08,57,170300,2987.72,68,87500,1287,82800,bce
2024-04-05,76,199700,2627.63,136,202600,1490,-2900,bce
2024-04-04,66,82900,1256.06,94,75100,799,7800,bce
2024-04-03,93,254800,2739.78,118,240600,2039,14200,bce
2024-04-02,134,276300,2061.94,94,319200,3396,-42900,bce
2024-04-01,111,141700,1276.58,102,160700,1575,-19000,bce
2024-03-29,94,312100,3320.21,165,377900,2290,-65800,bce
2024-03-28,118,283200,2400.0,190,427700,2251,-144500,bce
2024-03-27,74,255600,3454.05,102,294400,2886,-38800,bce
2024-03-26,61,128000,2098.36,88,144600,1643,-16600,bce
2024-03-25,70,153600,2194.29,102,198500,1946,-44900,bce
2024-03-22,108,170500,1578.7,87,146500,1684,24000,bce
2024-03-21,184,189700,1030.98,70,106500,1521,83200,bce
2024-03-20,124,142700,1150.81,42,64100,1526,78600,bce
2024-03-19,112,98300,877.68,91,134600,1479,-36300,bce
2024-03-18,112,173100,1545.54,120,208300,1736,-35200,bce
2024-03-15,71,84800,1194.37,84,145000,1726,-60200,bce
2024-03-14,58,184000,3172.41,191,231000,1209,-47000,bce
2024-03-13,81,115700,1428.4,97,175900,1813,-60200,bce
2024-03-12,62,101800,1641.94,100,154000,1540,-52200,bce
2024-03-11,141,164000,1163.12,156,266500,1708,-102500,bce
2024-03-08,91,64400,707.69,109,97100,891,-32700,bce
2024-03-07,234,401100,1714.1,139,320400,2305,80700,bce
2024-03-06,50,59000,1180.0,119,126600,1064,-67600,bce
2024-03-05,133,151300,1137.59,179,245600,1372,-94300,bce
2024-03-04,69,77600,1124.64,205,250100,1220,-172500,bce
2024-03-01,85,108600,1277.65,145,233600,1611,-125000,bce
2024-02-29,83,81900,986.75,116,166200,1433,-84300,bce
2024-02-28,88,91300,1037.5,174,266600,1532,-175300,bce
2024-02-27,104,126400,1215.38,119,140000,1176,-13600,bce
2024-02-26,73,61900,847.95,54,103100,1909,-41200,bce
2024-02-23,89,78000,876.4,114,214300,1880,-136300,bce
2024-02-22,111,120800,1088.29,167,214600,1285,-93800,bce
2024-02-21,82,62900,767.07,126,157600,1251,-94700,bce
2024-02-20,86,63000,732.56,154,252900,1642,-189900,bce
2024-02-19,186,301200,1619.35,303,386400,1275,-85200,bce
2024-02-16,78,59500,762.82,65,85100,1309,-25600,bce
2024-02-15,68,52200,767.65,72,63300,879,-11100,bce
2024-02-07,0,0,0.0,0,0,0,0,bce
2024-02-06,67,50000,746.27,83,119200,1436,-69200,bce
2024-02-05,66,64800,981.82,81,133300,1646,-68500,bce
2024-02-02,56,56800,1014.29,92,157900,1716,-101100,bce
2024-02-01,48,66300,1381.25,67,93600,1397,-27300,bce
2024-01-31,52,42400,815.38,48,69400,1446,-27000,bce
2024-01-30,127,203200,1600.0,97,217500,2242,-14300,bce
2024-01-29,54,89000,1648.15,79,187200,2370,-98200,bce
2024-01-26,115,124200,1080.0,137,172300,1258,-48100,bce
2024-01-25,115,215200,1871.3,119,170900,1436,44300,bce
2024-01-24,74,83200,1124.32,124,131000,1056,-47800,bce
2024-01-23,74,71000,959.46,113,99600,881,-28600,bce
2024-01-22,74,96200,1300.0,117,100600,860,-4400,bce
2024-01-19,76,97800,1286.84,122,189600,1554,-91800,bce
2024-01-18,83,86700,1044.58,104,252400,2427,-165700,bce
2024-01-17,69,83900,1215.94,186,181000,973,-97100,bce
2024-01-16,157,163100,1038.85,138,152000,1101,11100,bce
2024-01-15,176,170100,966.48,90,131900,1466,38200,bce
2024-01-12,68,65100,957.35,98,86500,883,-21400,bce
2024-01-11,77,77300,1003.9,108,107300,994,-30000,bce
2024-01-10,0,0,0.0,0,0,0,0,bce
2024-01-09,93,99000,1064.52,145,140800,971,-41800,bce
2024-01-08,58,49400,851.72,89,107300,1206,-57900,bce
2024-01-05,57,40800,715.79,149,122600,823,-81800,bce
2024-01-04,76,68900,906.58,129,136800,1060,-67900,bce
2024-01-03,82,72500,884.15,64,82000,1281,-9500,bce
2024-01-02,81,222700,2749.38,120,179400,1495,43300,bce
2024-09-12,2361,8111900,3435.79,1182,8009800,6776,102100,bcg
2024-09-11,2964,9102700,3071.09,1444,7965600,5516,1137100,bcg
2024-09-10,2462,7412600,3010.8,1624,8704200,5360,-1291600,bcg
2024-09-09,2895,6224200,2149.98,1362,7695400,5650,-1471200,bcg
2024-09-06,2609,6695000,2566.12,1394,10120300,7260,-3425300,bcg
2024-09-05,2688,8383800,3118.97,2027,8907000,4394,-523200,bcg
2024-09-04,3134,8722400,2783.15,1228,7318600,5960,1403800,bcg
2024-08-30,2041,5644000,2765.31,1442,8239800,5714,-2595800,bcg
2024-08-29,2645,7032600,2658.83,1438,10168400,7071,-3135800,bcg
2024-08-28,2987,9075500,3038.33,1858,10379500,5586,-1304000,bcg
2024-08-27,2867,9179200,3201.67,1913,10280700,5374,-1101500,bcg
2024-08-26,3162,15713800,4969.58,4346,19155500,4408,-3441700,bcg
2024-08-23,3224,11229900,3483.22,2099,11566900,5511,-337000,bcg
2024-08-22,3214,10390600,3232.92,1705,10764500,6313,-373900,bcg
2024-08-21,3032,10870700,3585.32,1870,11354400,6072,-483700,bcg
2024-08-20,5134,24742400,4819.32,3565,19633700,5507,5108700,bcg
2024-08-19,2948,16545400,5612.42,3057,15053600,4924,1491800,bcg
2024-08-16,3838,26052000,6787.91,5204,23533600,4522,2518400,bcg
2024-08-15,4242,12984800,3061.01,1832,11510800,6283,1474000,bcg
2024-08-14,2728,8073100,2959.35,1744,9765500,5599,-1692400,bcg
2024-08-13,3352,11682100,3485.11,1733,11139100,6428,543000,bcg
2024-08-12,3694,10029700,2715.13,1689,10874000,6438,-844300,bcg
2024-08-08,4308,24740200,5742.85,3057,21426500,7009,3313700,bcg
2024-08-07,3052,14279000,4678.57,1519,10805800,7114,3473200,bcg
2024-08-06,3944,16688100,4231.26,2299,13672700,5947,3015400,bcg
2024-08-05,5374,16720800,3111.43,2598,22858600,8799,-6137800,bcg
2024-08-02,4239,13601800,3208.73,2104,13592900,6461,8900,bcg
2024-08-01,3826,11215300,2931.34,2364,12297100,5202,-1081800,bcg
2024-07-31,6719,28364200,4221.49,3534,28859500,8166,-495300,bcg
2024-07-30,3360,13160900,3916.93,2138,10548900,4934,2612000,bcg
2024-07-29,5522,16948500,3069.27,2363,18059000,7642,-1110500,bcg
2024-07-26,2114,7021600,3321.48,1546,5311200,3435,1710400,bcg
2024-07-25,3214,8729300,2716.02,1305,7579500,5808,1149800,bcg
2024-07-24,3497,12170600,3480.3,2205,11045800,5009,1124800,bcg
2024-07-22,5455,21366200,3916.81,2506,18230000,7275,3136200,bcg
2024-07-19,3378,10651800,3153.29,1822,9124900,5008,1526900,bcg
2024-07-18,3285,10697400,3256.44,1802,8659700,4806,2037700,bcg
2024-07-17,7276,20563400,2826.2,2696,21789300,8082,-1225900,bcg
2024-07-16,5263,16255100,3088.56,2159,17997800,8336,-1742700,bcg
2024-07-15,3724,18425500,4947.77,2676,17866700,6677,558800,bcg
2024-07-12,2696,6861100,2544.92,1733,9725900,5612,-2864800,bcg
2024-07-11,2158,5891300,2729.98,2131,9309700,4369,-3418400,bcg
2024-07-10,2386,6100400,2556.75,2203,10201400,4631,-4101000,bcg
2024-07-09,2933,11308500,3855.61,3589,13994200,3899,-2685700,bcg
2024-07-08,2272,5687900,2503.48,1969,7180500,3647,-1492600,bcg
2024-07-05,2239,5250900,2345.2,1648,8649000,5248,-3398100,bcg
2024-07-04,2815,7794500,2768.92,2768,10509300,3797,-2714800,bcg
2024-07-03,1883,5033400,2673.07,1430,7058600,4936,-2025200,bcg
2024-07-02,2021,5529600,2736.07,1397,6039900,4323,-510300,bcg
2024-07-01,2411,6790600,2816.51,1352,6987200,5168,-196600,bcg
2024-06-28,3072,8871800,2887.96,1764,10515000,5961,-1643200,bcg
2024-06-27,2262,5845500,2584.22,1240,7080400,5710,-1234900,bcg
2024-06-26,2777,8487900,3056.5,2084,9269600,4448,-781700,bcg
2024-06-25,2763,7392700,2675.61,1647,8010100,4863,-617400,bcg
2024-06-24,5885,17427200,2961.29,2928,18384900,6279,-957700,bcg
2024-06-21,3585,10296400,2872.08,2193,11571100,5276,-1274700,bcg
2024-06-20,4373,11539300,2638.76,2669,16239900,6085,-4700600,bcg
2024-06-19,3464,21268000,6139.72,4245,24682600,5815,-3414600,bcg
2024-06-18,2901,11579800,3991.66,2998,12235900,4081,-656100,bcg
2024-06-17,4892,19621300,4010.9,3528,17841300,5057,1780000,bcg
2024-06-14,6367,20232100,3177.65,4570,28179400,6166,-7947300,bcg
2024-06-13,3114,10160300,3262.78,3120,17574500,5633,-7414200,bcg
2024-06-12,4998,16975100,3396.38,2794,17352700,6211,-377600,bcg
2024-06-11,7649,22434600,2933.01,3624,28261900,7799,-5827300,bcg
2024-06-10,5736,18555700,3234.95,4386,27582600,6289,-9026900,bcg
2024-06-07,5806,20501500,3531.09,3566,25154400,7054,-4652900,bcg
2024-06-06,5867,18356100,3128.7,4806,26705900,5557,-8349800,bcg
2024-06-05,8946,60516800,6764.68,11400,57554000,5049,2962800,bcg
2024-06-04,6701,25392400,3789.34,5517,33118500,6003,-7726100,bcg
2024-06-03,7426,32045600,4315.32,7080,41905700,5919,-9860100,bcg
2024-05-31,6662,28884100,4335.65,6770,34165300,5047,-5281200,bcg
2024-05-30,8235,36126800,4386.98,9947,46287800,4653,-10161000,bcg
2024-05-29,7216,57434600,7959.34,7024,36003000,5126,21431600,bcg
2024-05-28,1959,6765800,3453.7,2175,10442800,4801,-3677000,bcg
2024-05-27,2389,6945800,2907.41,1898,8671800,4569,-1726000,bcg
2024-05-24,6758,18144400,2684.88,3074,25016600,8138,-6872200,bcg
2024-05-23,5574,17894600,3210.37,3025,23401600,7736,-5507000,bcg
2024-05-22,4098,17383000,4241.83,4686,22437900,4788,-5054900,bcg
2024-05-21,3924,12803300,3262.82,3718,17848700,4801,-5045400,bcg
2024-05-20,5932,27793100,4685.28,6468,29940700,4629,-2147600,bcg
2024-05-17,2740,12412500,4530.11,3386,13483600,3982,-1071100,bcg
2024-05-16,2111,7067000,3347.7,2677,11188800,4180,-4121800,bcg
2024-05-15,2099,9845900,4690.76,2537,11672100,4601,-1826200,bcg
2024-05-14,2119,5962500,2813.83,1474,7783900,5281,-1821400,bcg
2024-05-13,1926,9067900,4708.15,2302,11146900,4842,-2079000,bcg
2024-05-10,3132,10811800,3452.04,1676,10257100,6120,554700,bcg
2024-05-09,3444,11693200,3395.24,2669,15453100,5790,-3759900,bcg
2024-05-08,3587,16617700,4632.76,3609,16287100,4513,330600,bcg
2024-05-07,2436,7709800,3164.94,2041,9128400,4473,-1418600,bcg
2024-05-06,2439,10121500,4149.86,2189,9904300,4525,217200,bcg
2024-05-03,2381,7174000,3013.02,2294,10477900,4568,-3303900,bcg
2024-05-02,1718,8450500,4918.8,2858,8474600,2965,-24100,bcg
2024-04-26,1864,8450100,4533.32,1613,7488500,4643,961600,bcg
2024-04-25,2172,6870600,3163.26,1416,9577200,6764,-2706600,bcg
2024-04-24,1604,8072400,5032.67,2108,8798400,4174,-726000,bcg
2024-04-23,2053,6362400,3099.07,2014,7533800,3741,-1171400,bcg
2024-04-22,1989,6450300,3242.99,1569,9137500,5824,-2687200,bcg
2024-04-19,3921,13804800,3520.73,2918,12990800,4452,814000,bcg
2024-04-17,3176,8682500,2733.78,1297,9113500,7027,-431000,bcg
2024-04-16,6123,18737300,3060.15,2630,17769700,6757,967600,bcg
2024-04-15,4258,12793700,3004.63,2187,18885100,8635,-6091400,bcg
2024-04-12,1823,5989900,3285.74,1601,8879100,5546,-2889200,bcg
2024-04-11,3669,8270100,2254.05,1329,8015100,6031,255000,bcg
2024-04-10,2048,5437200,2654.88,2374,9573100,4032,-4135900,bcg
2024-04-09,2007,7811300,3892.03,1990,10009500,5030,-2198200,bcg
2024-04-08,2588,12044400,4653.94,2612,12080600,4625,-36200,bcg
2024-04-05,5289,15230700,2879.69,2385,13999600,5870,1231100,bcg
2024-04-04,4220,13655700,3235.95,2698,16991400,6298,-3335700,bcg
2024-04-03,3380,14809500,4381.51,4696,20819000,4433,-6009500,bcg
2024-04-02,7113,33603800,4724.28,9039,40276900,4456,-6673100,bcg
2024-04-01,3557,8999100,2529.97,2276,10809100,4749,-1810000,bcg
2024-03-29,3946,9856900,2497.95,1922,12663700,6589,-2806800,bcg
2024-03-28,3272,8620300,2634.57,2751,13544300,4923,-4924000,bcg
2024-03-27,3358,11947000,3557.77,3954,15312800,3873,-3365800,bcg
2024-03-26,3712,13768800,3709.27,2481,15897700,6408,-2128900,bcg
2024-03-25,5026,22319400,4440.79,6151,27144500,4413,-4825100,bcg
2024-03-22,5926,20023100,3378.86,6464,31923700,4939,-11900600,bcg
2024-03-21,4947,22184400,4484.41,6366,28588900,4491,-6404500,bcg
2024-03-20,3863,11499800,2976.91,2857,13470600,4715,-1970800,bcg
2024-03-19,8505,38438000,4519.46,10511,44786600,4261,-6348600,bcg
2024-03-18,6251,26436900,4229.23,6070,30454500,5017,-4017600,bcg
2024-03-15,3289,10055700,3057.37,2908,14063400,4836,-4007700,bcg
2024-03-14,3745,9357000,2498.53,3108,14806000,4764,-5449000,bcg
2024-03-13,3328,9570000,2875.6,2261,10075100,4456,-505100,bcg
2024-03-12,4486,11031000,2458.98,1950,11660900,5980,-629900,bcg
2024-03-11,3052,9074000,2973.13,3091,14556300,4709,-5482300,bcg
2024-03-08,4831,18522300,3834.05,5138,22334200,4347,-3811900,bcg
2024-03-07,4463,11991500,2686.87,2358,14716900,6241,-2725400,bcg
2024-03-06,5807,14489900,2495.25,3233,19132200,5918,-4642300,bcg
2024-03-05,3937,12161200,3088.95,3630,16758600,4617,-4597400,bcg
2024-03-04,6973,34886900,5003.14,9392,38401200,4089,-3514300,bcg
2024-03-01,4305,16329700,3793.19,3896,18076400,4640,-1746700,bcg
2024-02-29,2982,9782200,3280.42,2580,13511500,5237,-3729300,bcg
2024-02-28,3075,8896900,2893.3,3113,13957200,4484,-5060300,bcg
2024-02-27,2959,9851300,3329.27,2247,10445500,4649,-594200,bcg
2024-02-26,3068,9109900,2969.33,1675,7829300,4674,1280600,bcg
2024-02-23,4722,11563500,2448.86,3236,16414000,5072,-4850500,bcg
2024-02-22,4497,19484900,4332.87,6634,28829600,4346,-9344700,bcg
2024-02-21,3300,10873900,3295.12,3278,17307400,5280,-6433500,bcg
2024-02-20,3305,9184400,2778.94,2762,14597500,5285,-5413100,bcg
2024-02-19,3600,10179600,2827.67,2738,12244300,4472,-2064700,bcg
2024-02-16,5664,30790800,5436.23,7720,25758100,3337,5032700,bcg
2024-02-15,2100,5465300,2602.52,1497,6648900,4441,-1183600,bcg
2024-02-07,0,0,0.0,0,0,0,0,bcg
2024-02-06,2420,6283400,2596.45,1331,6760100,5079,-476700,bcg
2024-02-05,4540,9717600,2140.44,2142,11719000,5471,-2001400,bcg
2024-02-02,2249,6046600,2688.57,2015,9464100,4697,-3417500,bcg
2024-02-01,1779,4843000,2722.32,1544,7332100,4749,-2489100,bcg
2024-01-31,2643,7172800,2713.89,2422,10532000,4348,-3359200,bcg
2024-01-30,2327,5559200,2389.0,1497,7053800,4712,-1494600,bcg
2024-01-29,2249,5554900,2469.94,1812,8814300,4864,-3259400,bcg
2024-01-26,1960,4730800,2413.67,2143,8742900,4080,-4012100,bcg
2024-01-25,3529,13850400,3924.74,5083,16905500,3326,-3055100,bcg
2024-01-24,1679,8322400,4956.76,2756,10012000,3633,-1689600,bcg
2024-01-23,2311,9163200,3965.04,3208,11248800,3506,-2085600,bcg
2024-01-22,2567,6904900,2689.87,1580,7797700,4935,-892800,bcg
2024-01-19,1927,5498700,2853.5,2401,10352000,4312,-4853300,bcg
2024-01-18,2559,7494300,2928.6,2077,10952500,5273,-3458200,bcg
2024-01-17,2873,6420700,2234.84,1851,10307300,5569,-3886600,bcg
2024-01-16,3123,7198900,2305.12,1619,8034600,4963,-835700,bcg
2024-01-15,2440,5926500,2428.89,2843,12957600,4558,-7031100,bcg
2024-01-12,6956,17279100,2484.06,2049,12856800,6275,4422300,bcg
2024-01-11,2861,6000500,2097.34,1916,7504100,3917,-1503600,bcg
2024-01-10,0,0,0.0,0,0,0,0,bcg
2024-01-09,3308,10441600,3156.47,3705,13131300,3544,-2689700,bcg
2024-01-08,2590,8549700,3301.04,2676,10332000,3861,-1782300,bcg
2024-01-05,5496,12589500,2290.67,2295,11282900,4916,1306600,bcg
2024-01-04,4120,10217500,2479.98,2746,12341300,4494,-2123800,bcg
2024-01-03,4531,11572300,2554.03,2194,9091300,4144,2481000,bcg
2024-01-02,16297,40931800,2511.62,5433,40872900,7523,58900,bcg
2024-09-12,0,0,0.0,4,8100,2025,-8100,bcp
2024-09-11,1,1000,1000.0,5,37200,7440,-36200,bcp
2024-09-10,0,0,0.0,4,8100,2025,-8100,bcp
2024-09-09,0,0,0.0,6,9200,1533,-9200,bcp
2024-09-06,0,0,0.0,6,37300,6217,-37300,bcp
2024-09-05,0,0,0.0,9,11700,1300,-11700,bcp
2024-09-04,1,0,0.0,7,8200,1171,-8200,bcp
2024-08-30,0,0,0.0,8,8800,1100,-8800,bcp
2024-08-29,0,0,0.0,8,8400,1050,-8400,bcp
2024-08-28,0,0,0.0,4,33800,8450,-33800,bcp
2024-08-27,2,700,350.0,6,8500,1417,-7800,bcp
2024-08-26,0,0,0.0,8,8700,1088,-8700,bcp
2024-08-23,2,200,100.0,7,8700,1243,-8500,bcp
2024-08-22,1,600,600.0,10,10100,1010,-9500,bcp
2024-08-21,0,0,0.0,5,8500,1700,-8500,bcp
2024-08-20,0,0,0.0,6,8600,1433,-8600,bcp
2024-08-19,2,2000,1000.0,8,9700,1212,-7700,bcp
2024-08-16,0,0,0.0,7,8700,1243,-8700,bcp
2024-08-15,1,1000,1000.0,9,10300,1144,-9300,bcp
2024-08-14,1,600,600.0,8,9300,1162,-8700,bcp
2024-08-13,2,1500,750.0,11,10300,936,-8800,bcp
2024-08-12,0,0,0.0,8,9700,1212,-9700,bcp
2024-08-09,0,0,0.0,5,5300,1060,-5300,bcp
2024-08-08,0,0,0.0,5,5300,1060,-5300,bcp
2024-08-07,1,5100,5100.0,7,10600,1514,-5500,bcp
2024-08-06,1,100,100.0,9,13400,1489,-13300,bcp
2024-08-05,0,0,0.0,6,9300,1550,-9300,bcp
2024-08-02,0,0,0.0,5,9200,1840,-9200,bcp
2024-08-01,0,0,0.0,6,10200,1700,-10200,bcp
2024-07-31,2,1300,650.0,7,10900,1557,-9600,bcp
2024-07-30,0,0,0.0,6,8700,1450,-8700,bcp
2024-07-29,0,0,0.0,8,15800,1975,-15800,bcp
2024-07-26,0,0,0.0,8,9300,1162,-9300,bcp
2024-07-25,0,0,0.0,5,8700,1740,-8700,bcp
2024-07-24,0,0,0.0,6,9700,1617,-9700,bcp
2024-07-23,0,0,0.0,7,9700,1386,-9700,bcp
2024-07-22,0,0,0.0,6,10200,1700,-10200,bcp
2024-07-19,0,0,0.0,5,8400,1680,-8400,bcp
2024-07-18,0,0,0.0,6,9400,1567,-9400,bcp
2024-07-17,0,0,0.0,7,13300,1900,-13300,bcp
2024-07-16,0,0,0.0,6,12300,2050,-12300,bcp
2024-07-15,1,3000,3000.0,7,10400,1486,-7400,bcp
2024-07-12,0,0,0.0,6,9400,1567,-9400,bcp
2024-07-11,0,0,0.0,7,38800,5543,-38800,bcp
2024-07-10,1,2000,2000.0,6,9500,1583,-7500,bcp
2024-07-09,0,0,0.0,5,9400,1880,-9400,bcp
2024-07-08,0,0,0.0,6,11200,1867,-11200,bcp
2024-07-05,1,2000,2000.0,5,6200,1240,-4200,bcp
2024-07-04,0,0,0.0,6,10200,1700,-10200,bcp
2024-07-03,0,0,0.0,7,12900,1843,-12900,bcp
2024-07-02,1,1000,1000.0,9,14300,1589,-13300,bcp
2024-07-01,1,100,100.0,7,10600,1514,-10500,bcp
2024-06-28,0,0,0.0,8,13000,1625,-13000,bcp
2024-06-27,0,0,0.0,6,12500,2083,-12500,bcp
2024-06-26,0,0,0.0,8,10300,1288,-10300,bcp
2024-06-25,3,1200,400.0,6,5000,833,-3800,bcp
2024-06-24,3,3700,1233.33,9,14000,1556,-10300,bcp
2024-06-21,2,1600,800.0,7,10400,1486,-8800,bcp
2024-06-20,3,1400,466.67,9,17100,1900,-15700,bcp
2024-06-19,1,1100,1100.0,8,14400,1800,-13300,bcp
2024-06-18,0,0,0.0,6,11200,1867,-11200,bcp
2024-06-17,0,0,0.0,7,9300,1329,-9300,bcp
2024-06-14,3,2000,666.67,9,13200,1467,-11200,bcp
2024-06-13,1,500,500.0,7,7200,1029,-6700,bcp
2024-06-12,0,0,0.0,8,12400,1550,-12400,bcp
2024-06-11,3,1200,400.0,11,6800,618,-5600,bcp
2024-06-10,2,1000,500.0,6,3800,633,-2800,bcp
2024-06-07,5,2300,460.0,5,6100,1220,-3800,bcp
2024-06-06,2,1100,550.0,8,16800,2100,-15700,bcp
2024-06-05,8,5200,650.0,20,21100,1055,-15900,bcp
2024-06-04,5,1500,300.0,10,8100,810,-6600,bcp
2024-06-03,6,1200,200.0,13,13000,1000,-11800,bcp
2024-05-31,1,100,100.0,11,17100,1555,-17000,bcp
2024-05-30,1,100,100.0,9,12000,1333,-11900,bcp
2024-05-29,0,0,0.0,9,11900,1322,-11900,bcp
2024-05-28,0,0,0.0,10,11900,1190,-11900,bcp
2024-05-27,0,0,0.0,9,12500,1389,-12500,bcp
2024-05-24,0,0,0.0,10,12700,1270,-12700,bcp
2024-05-23,0,0,0.0,10,13400,1340,-13400,bcp
2024-05-22,1,100,100.0,13,14900,1146,-14800,bcp
2024-05-21,3,3100,1033.33,12,13300,1108,-10200,bcp
2024-05-20,4,1200,300.0,11,13100,1191,-11900,bcp
2024-05-17,2,2100,1050.0,9,15300,1700,-13200,bcp
2024-05-16,1,100,100.0,9,14600,1622,-14500,bcp
2024-05-15,1,100,100.0,10,17900,1790,-17800,bcp
2024-05-14,3,1200,400.0,7,8500,1214,-7300,bcp
2024-05-13,1,100,100.0,6,8000,1333,-7900,bcp
2024-05-10,3,100,33.33,7,7500,1071,-7400,bcp
2024-05-09,3,3100,1033.33,6,13700,2283,-10600,bcp
2024-05-08,2,4100,2050.0,8,10200,1275,-6100,bcp
2024-05-07,1,100,100.0,7,10400,1486,-10300,bcp
2024-05-06,3,4600,1533.33,9,11600,1289,-7000,bcp
2024-05-03,1,5000,5000.0,7,13300,1900,-8300,bcp
2024-05-02,0,0,0.0,6,8300,1383,-8300,bcp
2024-04-26,1,300,300.0,4,4800,1200,-4500,bcp
2024-04-25,0,0,0.0,5,6500,1300,-6500,bcp
2024-04-24,2,700,350.0,5,6500,1300,-5800,bcp
2024-04-23,0,0,0.0,5,6500,1300,-6500,bcp
2024-04-22,1,400,400.0,4,6300,1575,-5900,bcp
2024-04-19,0,0,0.0,6,6900,1150,-6900,bcp
2024-04-17,2,400,200.0,6,6900,1150,-6500,bcp
2024-04-16,1,200,200.0,6,6900,1150,-6700,bcp
2024-04-15,2,200,100.0,7,7900,1129,-7700,bcp
2024-04-12,4,1200,300.0,8,10900,1362,-9700,bcp
2024-04-11,2,700,350.0,7,5000,714,-4300,bcp
2024-04-10,7,4000,571.43,8,5800,725,-1800,bcp
2024-04-09,3,600,200.0,8,9700,1212,-9100,bcp
2024-04-08,1,2000,2000.0,8,10900,1362,-8900,bcp
2024-04-05,0,0,0.0,7,9200,1314,-9200,bcp
2024-04-04,1,0,0.0,6,9100,1517,-9100,bcp
2024-04-03,0,0,0.0,5,2900,580,-2900,bcp
2024-04-02,1,2000,2000.0,5,3600,720,-1600,bcp
2024-04-01,0,0,0.0,5,3600,720,-3600,bcp
2024-03-29,0,0,0.0,4,7600,1900,-7600,bcp
2024-03-28,0,0,0.0,5,13300,2660,-13300,bcp
2024-03-27,2,300,150.0,7,8500,1214,-8200,bcp
2024-03-26,1,600,600.0,9,15000,1667,-14400,bcp
2024-03-25,1,0,0.0,7,8200,1171,-8200,bcp
2024-03-22,8,2900,362.5,5,3600,720,-700,bcp
2024-03-21,11,7600,690.91,12,13800,1150,-6200,bcp
2024-03-20,1,100,100.0,13,17500,1346,-17400,bcp
2024-03-19,0,0,0.0,9,13600,1511,-13600,bcp
2024-03-18,1,100,100.0,16,13900,869,-13800,bcp
2024-03-15,0,0,0.0,13,10900,838,-10900,bcp
2024-03-14,0,0,0.0,14,15200,1086,-15200,bcp
2024-03-13,0,0,0.0,17,20500,1206,-20500,bcp
2024-03-12,0,0,0.0,17,22200,1306,-22200,bcp
2024-03-11,6,3500,583.33,12,21800,1817,-18300,bcp
2024-03-08,1,100,100.0,5,9500,1900,-9400,bcp
2024-03-07,2,200,100.0,3,2500,833,-2300,bcp
2024-03-06,3,2300,766.67,6,11600,1933,-9300,bcp
2024-03-05,2,500,250.0,8,16200,2025,-15700,bcp
2024-03-04,7,2700,385.71,4,4500,1125,-1800,bcp
2024-03-01,5,500,100.0,9,8100,900,-7600,bcp
2024-02-29,1,2000,2000.0,6,8900,1483,-6900,bcp
2024-02-28,1,3000,3000.0,8,10400,1300,-7400,bcp
2024-02-27,3,2200,733.33,2,4000,2000,-1800,bcp
2024-02-26,3,2000,666.67,1,1000,1000,1000,bcp
2024-02-23,3,2200,733.33,4,3900,975,-1700,bcp
2024-02-22,2,3100,1550.0,3,3800,1267,-700,bcp
2024-02-21,2,3200,1600.0,4,3900,975,-700,bcp
2024-02-20,1,2000,2000.0,3,6800,2267,-4800,bcp
2024-02-19,2,3100,1550.0,3,2900,967,200,bcp
2024-02-16,2,2100,1050.0,4,5700,1425,-3600,bcp
2024-02-15,1,2000,2000.0,4,5700,1425,-3700,bcp
2024-02-07,2,3100,1550.0,4,5700,1425,-2600,bcp
2024-02-06,0,0,0.0,3,3900,1300,-3900,bcp
2024-02-05,0,0,0.0,6,14800,2467,-14800,bcp
2024-02-02,0,0,0.0,4,5700,1425,-5700,bcp
2024-02-01,0,0,0.0,4,5700,1425,-5700,bcp
2024-01-31,1,2000,2000.0,6,6700,1117,-4700,bcp
2024-01-30,0,0,0.0,4,4900,1225,-4900,bcp
2024-01-29,1,2000,2000.0,6,6700,1117,-4700,bcp
2024-01-26,1,2000,2000.0,6,11300,1883,-9300,bcp
2024-01-25,2,4000,2000.0,5,10800,2160,-6800,bcp
2024-01-24,5,7500,1500.0,6,8900,1483,-1400,bcp
2024-01-23,4,4000,1000.0,16,16500,1031,-12500,bcp
2024-01-22,0,0,0.0,13,13100,1008,-13100,bcp
2024-01-19,2,4000,2000.0,11,13800,1255,-9800,bcp
2024-01-18,0,0,0.0,14,14400,1029,-14400,bcp
2024-01-17,2,2500,1250.0,14,19500,1393,-17000,bcp
2024-01-16,0,0,0.0,13,20600,1585,-20600,bcp
2024-01-15,1,500,500.0,14,20000,1429,-19500,bcp
2024-01-12,0,0,0.0,8,16000,2000,-16000,bcp
2024-01-11,2,2500,1250.0,15,22800,1520,-20300,bcp
2024-01-10,5,11000,2200.0,16,20200,1262,-9200,bcp
2024-01-09,1,2000,2000.0,14,13700,979,-11700,bcp
2024-01-08,1,2000,2000.0,9,10400,1156,-8400,bcp
2024-01-05,0,0,0.0,16,48300,3019,-48300,bcp
2024-01-04,3,500,166.67,14,21200,1514,-20700,bcp
2024-01-03,1,200,200.0,6,3200,533,-3000,bcp
2024-01-02,6,3600,600.0,5,3400,680,200,bcp
2024-09-12,1,100,100.0,0,0,0,100,bdb
2024-09-11,1,500,500.0,0,0,0,500,bdb
2024-09-10,1,100,100.0,0,0,0,100,bdb
2024-09-09,2,700,350.0,0,0,0,700,bdb
2024-09-06,1,100,100.0,0,0,0,100,bdb
2024-09-05,2,600,300.0,0,0,0,600,bdb
2024-09-04,2,200,100.0,0,0,0,200,bdb
2024-08-30,3,700,233.33,0,0,0,700,bdb
2024-08-29,1,100,100.0,0,0,0,100,bdb
2024-08-28,2,200,100.0,0,0,0,200,bdb
2024-08-27,1,500,500.0,0,0,0,500,bdb
2024-08-26,3,200,66.67,0,0,0,200,bdb
2024-08-23,5,500,100.0,0,0,0,500,bdb
2024-08-22,2,600,300.0,0,0,0,600,bdb
2024-08-21,2,200,100.0,0,0,0,200,bdb
2024-08-20,3,800,266.67,0,0,0,800,bdb
2024-08-19,3,100,33.33,0,0,0,100,bdb
2024-08-16,2,700,350.0,0,0,0,700,bdb
2024-08-15,1,100,100.0,0,0,0,100,bdb
2024-08-14,3,700,233.33,0,0,0,700,bdb
2024-08-13,2,600,300.0,0,0,0,600,bdb
2024-08-12,1,100,100.0,0,0,0,100,bdb
2024-08-09,1,100,100.0,0,0,0,100,bdb
2024-08-08,2,600,300.0,0,0,0,600,bdb
2024-08-07,2,600,300.0,0,0,0,600,bdb
2024-08-06,2,200,100.0,0,0,0,200,bdb
2024-08-05,3,800,266.67,0,0,0,800,bdb
2024-08-02,1,100,100.0,0,0,0,100,bdb
2024-08-01,2,600,300.0,0,0,0,600,bdb
2024-07-31,3,300,100.0,0,0,0,300,bdb
2024-07-30,3,1100,366.67,0,0,0,1100,bdb
2024-07-29,8,1600,200.0,0,0,0,1600,bdb
2024-07-26,1,100,100.0,0,0,0,100,bdb
2024-07-25,3,2300,766.67,0,0,0,2300,bdb
2024-07-24,3,1100,366.67,0,0,0,1100,bdb
2024-07-23,2,600,300.0,0,0,0,600,bdb
2024-07-22,2,1100,550.0,0,0,0,1100,bdb
2024-07-19,4,1300,325.0,1,100,100,1200,bdb
2024-07-18,2,600,300.0,0,0,0,600,bdb
2024-07-17,2,700,350.0,0,0,0,700,bdb
2024-07-16,2,700,350.0,1,100,100,600,bdb
2024-07-15,1,100,100.0,0,0,0,100,bdb
2024-07-12,3,1100,366.67,0,0,0,1100,bdb
2024-07-11,2,600,300.0,0,0,0,600,bdb
2024-07-10,3,1100,366.67,0,0,0,1100,bdb
2024-07-09,2,400,200.0,0,0,0,400,bdb
2024-07-08,4,1700,425.0,0,0,0,1700,bdb
2024-07-05,2,700,350.0,0,0,0,700,bdb
2024-07-04,3,700,233.33,0,0,0,700,bdb
2024-07-03,3,1100,366.67,0,0,0,1100,bdb
2024-07-02,5,1400,280.0,1,100,100,1300,bdb
2024-07-01,2,300,150.0,0,0,0,300,bdb
2024-06-28,3,700,233.33,1,200,200,500,bdb
2024-06-27,3,700,233.33,1,200,200,500,bdb
2024-06-26,3,700,233.33,0,0,0,700,bdb
2024-06-25,3,700,233.33,0,0,0,700,bdb
2024-06-24,10,2400,240.0,4,800,200,1600,bdb
2024-06-21,5,1300,260.0,2,300,150,1000,bdb
2024-06-20,4,1300,325.0,0,0,0,1300,bdb
2024-06-19,7,1600,228.57,0,0,0,1600,bdb
2024-06-18,8,4800,600.0,4,3500,875,1300,bdb
2024-06-17,5,1500,300.0,2,400,200,1100,bdb
2024-06-14,2,600,300.0,0,0,0,600,bdb
2024-06-13,4,900,225.0,0,0,0,900,bdb
2024-06-12,4,900,225.0,0,0,0,900,bdb
2024-06-11,5,1000,200.0,1,100,100,900,bdb
2024-06-10,4,3500,875.0,1,100,100,3400,bdb
2024-06-07,3,5500,1833.33,1,100,100,5400,bdb
2024-06-06,4,2500,625.0,4,1100,275,1400,bdb
2024-06-05,1,200,200.0,1,200,200,0,bdb
2024-06-04,5,6100,1220.0,3,5900,1967,200,bdb
2024-06-03,1,100,100.0,0,0,0,100,bdb
2024-05-31,2,200,100.0,0,0,0,200,bdb
2024-05-30,3,2700,900.0,2,400,200,2300,bdb
2024-05-29,3,2700,900.0,2,400,200,2300,bdb
2024-05-28,2,600,300.0,0,0,0,600,bdb
2024-05-27,2,600,300.0,0,0,0,600,bdb
2024-05-24,2,600,300.0,1,200,200,400,bdb
2024-05-23,2,1000,500.0,1,200,200,800,bdb
2024-05-22,2,600,300.0,0,0,0,600,bdb
2024-05-21,2,600,300.0,0,0,0,600,bdb
2024-05-20,2,1000,500.0,1,200,200,800,bdb
2024-05-17,2,400,200.0,0,0,0,400,bdb
2024-05-16,2,600,300.0,0,0,0,600,bdb
2024-05-15,2,600,300.0,0,0,0,600,bdb
2024-05-14,1,100,100.0,0,0,0,100,bdb
2024-05-13,2,600,300.0,0,0,0,600,bdb
2024-05-10,3,700,233.33,0,0,0,700,bdb
2024-05-09,0,0,0.0,0,0,0,0,bdb
2024-05-08,5,800,160.0,0,0,0,800,bdb
2024-05-07,0,0,0.0,0,0,0,0,bdb
2024-05-06,2,500,250.0,1,0,0,500,bdb
2024-05-03,1,200,200.0,0,0,0,200,bdb
2024-05-02,2,600,300.0,1,200,200,400,bdb
2024-04-26,1,200,200.0,1,2000,2000,-1800,bdb
2024-04-25,2,400,200.0,1,2000,2000,-1600,bdb
2024-04-24,1,100,100.0,5,3900,780,-3800,bdb
2024-04-23,3,400,133.33,6,3100,517,-2700,bdb
2024-04-22,1,100,100.0,5,3800,760,-3700,bdb
2024-04-19,1,100,100.0,5,3800,760,-3700,bdb
2024-04-17,2,600,300.0,6,3800,633,-3200,bdb
2024-04-16,3,700,233.33,6,3400,567,-2700,bdb
2024-04-15,3,2600,866.67,5,2900,580,-300,bdb
2024-04-12,5,5600,1120.0,7,4400,629,1200,bdb
2024-04-11,3,5600,1866.67,8,4600,575,1000,bdb
2024-04-10,3,7100,2366.67,9,5400,600,1700,bdb
2024-04-09,4,5400,1350.0,10,3500,350,1900,bdb
2024-04-08,4,4000,1000.0,6,2500,417,1500,bdb
2024-04-05,2,200,100.0,2,400,200,-200,bdb
2024-04-04,1,100,100.0,2,400,200,-300,bdb
2024-04-03,2,2100,1050.0,1,100,100,2000,bdb
2024-04-02,2,2100,1050.0,3,900,300,1200,bdb
2024-04-01,2,5100,2550.0,4,1200,300,3900,bdb
2024-03-29,4,5200,1300.0,3,900,300,4300,bdb
2024-03-28,1,100,100.0,1,100,100,0,bdb
2024-03-27,1,100,100.0,1,100,100,0,bdb
2024-03-26,2,5100,2550.0,2,300,150,4800,bdb
2024-03-25,2,200,100.0,2,300,150,-100,bdb
2024-03-22,3,5200,1733.33,1,100,100,5100,bdb
2024-03-21,3,5300,1766.67,1,100,100,5200,bdb
2024-03-20,2,300,150.0,1,100,100,200,bdb
2024-03-19,3,5200,1733.33,1,100,100,5100,bdb
2024-03-18,3,5300,1766.67,5,4700,940,600,bdb
2024-03-15,3,3300,1100.0,2,400,200,2900,bdb
2024-03-14,2,300,150.0,2,400,200,-100,bdb
2024-03-13,1,100,100.0,1,100,100,0,bdb
2024-03-12,1,200,200.0,2,400,200,-200,bdb
2024-03-11,1,200,200.0,0,0,0,200,bdb
2024-03-08,1,200,200.0,1,300,300,-100,bdb
2024-03-07,3,2400,800.0,2,2200,1100,200,bdb
2024-03-06,2,300,150.0,0,0,0,300,bdb
2024-03-05,2,300,150.0,0,0,0,300,bdb
2024-03-04,5,1400,280.0,0,0,0,1400,bdb
2024-03-01,1,200,200.0,1,200,200,0,bdb
2024-02-29,2,200,100.0,0,0,0,200,bdb
2024-02-28,2,300,150.0,1,100,100,200,bdb
2024-02-27,2,200,100.0,2,300,150,-100,bdb
2024-02-26,4,1100,275.0,1,100,100,1000,bdb
2024-02-23,2,300,150.0,1,100,100,200,bdb
2024-02-22,2,300,150.0,1,100,100,200,bdb
2024-02-21,3,500,166.67,1,100,100,400,bdb
2024-02-20,2,300,150.0,4,400,100,-100,bdb
2024-02-19,4,500,125.0,1,100,100,400,bdb
2024-02-16,2,400,200.0,0,0,0,400,bdb
2024-02-15,4,400,100.0,3,500,167,-100,bdb
2024-02-07,5,700,140.0,1,100,100,600,bdb
2024-02-06,3,5300,1766.67,1,100,100,5200,bdb
2024-02-05,3,500,166.67,2,200,100,300,bdb
2024-02-02,4,500,125.0,1,100,100,400,bdb
2024-02-01,7,1500,214.29,3,500,167,1000,bdb
2024-01-31,2,400,200.0,1,100,100,300,bdb
2024-01-30,1,200,200.0,2,200,100,0,bdb
2024-01-29,5,700,140.0,1,100,100,600,bdb
2024-01-26,5,300,60.0,1,100,100,200,bdb
2024-01-25,6,1200,200.0,2,200,100,1000,bdb
2024-01-24,4,700,175.0,1,100,100,600,bdb
2024-01-23,3,900,300.0,1,100,100,800,bdb
2024-01-22,3,700,233.33,0,0,0,700,bdb
2024-01-19,1,500,500.0,0,0,0,500,bdb
2024-01-18,5,800,160.0,0,0,0,800,bdb
2024-01-17,2,1100,550.0,0,0,0,1100,bdb
2024-01-16,1,100,100.0,0,0,0,100,bdb
2024-01-15,1,100,100.0,0,0,0,100,bdb
2024-01-12,2,600,300.0,0,0,0,600,bdb
2024-01-11,1,100,100.0,0,0,0,100,bdb
2024-01-10,2,600,300.0,0,0,0,600,bdb
2024-01-09,1,100,100.0,0,0,0,100,bdb
2024-01-08,3,600,200.0,0,0,0,600,bdb
2024-01-05,3,700,233.33,0,0,0,700,bdb
2024-01-04,5,900,180.0,0,0,0,900,bdb
2024-01-03,2,500,250.0,0,0,0,500,bdb
2024-01-02,1,100,100.0,0,0,0,100,bdb
2024-09-12,32,12300,384.38,13,16700,1285,-4400,bdg
2024-09-11,20,9100,455.0,7,9000,1286,100,bdg
2024-09-10,24,11700,487.5,16,21000,1312,-9300,bdg
2024-09-09,31,17400,561.29,13,18400,1415,-1000,bdg
2024-09-06,27,15700,581.48,16,6800,425,8900,bdg
2024-09-05,32,20300,634.38,26,9300,358,11000,bdg
2024-09-04,30,15200,506.67,20,9100,455,6100,bdg
2024-08-30,40,20800,520.0,12,1800,150,19000,bdg
2024-08-29,40,16100,402.5,22,11900,541,4200,bdg
2024-08-28,22,14800,672.73,8,19700,2462,-4900,bdg
2024-08-27,20,7000,350.0,17,11900,700,-4900,bdg
2024-08-26,26,10600,407.69,20,27900,1395,-17300,bdg
2024-08-23,24,22300,929.17,19,28500,1500,-6200,bdg
2024-08-22,41,28700,700.0,29,42100,1452,-13400,bdg
2024-08-21,25,18600,744.0,25,21200,848,-2600,bdg
2024-08-20,55,27300,496.36,38,29700,782,-2400,bdg
2024-08-19,34,15000,441.18,32,23500,734,-8500,bdg
2024-08-16,32,13100,409.38,36,20300,564,-7200,bdg
2024-08-15,62,38100,614.52,53,19200,362,18900,bdg
2024-08-14,29,19500,672.41,30,11300,377,8200,bdg
2024-08-13,56,24400,435.71,56,24900,445,-500,bdg
2024-08-12,65,23100,355.38,82,49700,606,-26600,bdg
2024-08-09,33,9800,296.97,52,19300,371,-9500,bdg
2024-08-08,45,18600,413.33,39,19700,505,-1100,bdg
2024-08-07,25,20800,832.0,15,10000,667,10800,bdg
2024-08-06,21,11600,552.38,30,7800,260,3800,bdg
2024-08-05,25,21000,840.0,27,20200,748,800,bdg
2024-08-02,32,16900,528.12,37,18700,505,-1800,bdg
2024-08-01,26,15700,603.85,38,16400,432,-700,bdg
2024-07-31,15,14000,933.33,39,18900,485,-4900,bdg
2024-07-30,17,12800,752.94,18,9200,511,3600,bdg
2024-07-29,39,26800,687.18,53,28600,540,-1800,bdg
2024-07-26,19,6000,315.79,17,13300,782,-7300,bdg
2024-07-25,16,8900,556.25,15,9100,607,-200,bdg
2024-07-24,30,12000,400.0,28,16000,571,-4000,bdg
2024-07-23,28,23200,828.57,24,25200,1050,-2000,bdg
2024-07-22,32,30400,950.0,34,23200,682,7200,bdg
2024-07-19,25,16100,644.0,44,19400,441,-3300,bdg
2024-07-18,27,15700,581.48,26,10500,404,5200,bdg
2024-07-17,27,10600,392.59,24,10700,446,-100,bdg
2024-07-16,63,28500,452.38,35,18500,529,10000,bdg
2024-07-15,22,14400,654.55,25,15700,628,-1300,bdg
2024-07-12,41,19900,485.37,24,17100,712,2800,bdg
2024-07-11,32,19700,615.62,38,21200,558,-1500,bdg
2024-07-10,25,11600,464.0,17,12700,747,-1100,bdg
2024-07-09,32,23700,740.62,28,31000,1107,-7300,bdg
2024-07-08,42,24000,571.43,20,16900,845,7100,bdg
2024-07-05,40,25500,637.5,10,10600,1060,14900,bdg
2024-07-04,49,32300,659.18,25,29400,1176,2900,bdg
2024-07-03,35,31700,905.71,16,26600,1662,5100,bdg
2024-07-02,33,22100,669.7,20,26700,1335,-4600,bdg
2024-07-01,8,8800,1100.0,10,15700,1570,-6900,bdg
2024-06-28,14,12200,871.43,15,12800,853,-600,bdg
2024-06-27,25,19200,768.0,12,13500,1125,5700,bdg
2024-06-26,30,27000,900.0,13,14800,1138,12200,bdg
2024-06-25,22,19200,872.73,22,15400,700,3800,bdg
2024-06-24,45,19300,428.89,19,16700,879,2600,bdg
2024-06-21,23,19600,852.17,21,11700,557,7900,bdg
2024-06-20,23,21000,913.04,12,11000,917,10000,bdg
2024-06-19,26,11500,442.31,16,7900,494,3600,bdg
2024-06-18,17,10400,611.76,12,5300,442,5100,bdg
2024-06-17,29,22500,775.86,14,7100,507,15400,bdg
2024-06-14,25,18100,724.0,20,9200,460,8900,bdg
2024-06-13,23,25300,1100.0,20,9700,485,15600,bdg
2024-06-12,36,22100,613.89,33,16700,506,5400,bdg
2024-06-11,37,49000,1324.32,21,22500,1071,26500,bdg
2024-06-10,55,40100,729.09,22,17100,777,23000,bdg
2024-06-07,22,24300,1104.55,27,17500,648,6800,bdg
2024-06-06,27,30900,1144.44,28,21800,779,9100,bdg
2024-06-05,29,30200,1041.38,27,23600,874,6600,bdg
2024-06-04,22,21300,968.18,23,16400,713,4900,bdg
2024-06-03,28,25300,903.57,19,13900,732,11400,bdg
2024-05-31,24,22200,925.0,25,17800,712,4400,bdg
2024-05-30,25,15100,604.0,24,23700,988,-8600,bdg
2024-05-29,29,23200,800.0,40,30000,750,-6800,bdg
2024-05-28,32,33500,1046.88,52,52500,1010,-19000,bdg
2024-05-27,29,20700,713.79,37,22300,603,-1600,bdg
2024-05-24,14,11500,821.43,14,3300,236,8200,bdg
2024-05-23,20,15500,775.0,18,2700,150,12800,bdg
2024-05-22,22,21000,954.55,25,10900,436,10100,bdg
2024-05-21,28,18000,642.86,28,8400,300,9600,bdg
2024-05-20,33,16000,484.85,34,9800,288,6200,bdg
2024-05-17,29,16700,575.86,29,8600,297,8100,bdg
2024-05-16,26,13100,503.85,17,5900,347,7200,bdg
2024-05-15,20,13000,650.0,17,5400,318,7600,bdg
2024-05-14,21,17000,809.52,22,6400,291,10600,bdg
2024-05-13,23,25900,1126.09,12,5500,458,20400,bdg
2024-05-10,22,11400,518.18,18,4700,261,6700,bdg
2024-05-09,24,14000,583.33,22,17500,795,-3500,bdg
2024-05-08,35,28200,805.71,33,12300,373,15900,bdg
2024-05-07,20,12900,645.0,19,9700,511,3200,bdg
2024-05-06,16,11100,693.75,22,17100,777,-6000,bdg
2024-05-03,22,15400,700.0,29,19400,669,-4000,bdg
2024-05-02,19,13800,726.32,26,7200,277,6600,bdg
2024-04-26,13,17200,1323.08,18,5400,300,11800,bdg
2024-04-25,21,15000,714.29,21,5300,252,9700,bdg
2024-04-24,21,11900,566.67,33,9400,285,2500,bdg
2024-04-23,20,12900,645.0,19,6400,337,6500,bdg
2024-04-22,35,18000,514.29,18,6900,383,11100,bdg
2024-04-19,33,13700,415.15,24,12200,508,1500,bdg
2024-04-17,57,21700,380.7,34,19000,559,2700,bdg
2024-04-16,34,15300,450.0,23,9700,422,5600,bdg
2024-04-15,24,6300,262.5,20,9900,495,-3600,bdg
2024-04-12,29,17200,593.1,20,9100,455,8100,bdg
2024-04-11,23,6200,269.57,19,6400,337,-200,bdg
2024-04-10,26,18500,711.54,17,5500,324,13000,bdg
2024-04-09,17,21400,1258.82,18,6400,356,15000,bdg
2024-04-08,18,5100,283.33,18,6200,344,-1100,bdg
2024-04-05,26,8800,338.46,21,9500,452,-700,bdg
2024-04-04,23,20400,886.96,25,13100,524,7300,bdg
2024-04-03,20,19200,960.0,33,19700,597,-500,bdg
2024-04-02,29,16000,551.72,42,13100,312,2900,bdg
2024-04-01,17,7900,464.71,31,12400,400,-4500,bdg
2024-03-29,40,17500,437.5,27,8500,315,9000,bdg
2024-03-28,22,11500,522.73,36,27400,761,-15900,bdg
2024-03-27,30,13400,446.67,19,14100,742,-700,bdg
2024-03-26,29,14900,513.79,18,13800,767,1100,bdg
2024-03-25,30,17700,590.0,14,16000,1143,1700,bdg
2024-03-22,25,15700,628.0,19,10400,547,5300,bdg
2024-03-21,27,9900,366.67,19,8800,463,1100,bdg
2024-03-20,35,16100,460.0,24,9800,408,6300,bdg
2024-03-19,33,25200,763.64,27,14200,526,11000,bdg
2024-03-18,45,25400,564.44,33,19600,594,5800,bdg
2024-03-15,22,11900,540.91,16,7700,481,4200,bdg
2024-03-14,29,17300,596.55,31,10400,335,6900,bdg
2024-03-13,29,20700,713.79,26,12300,473,8400,bdg
2024-03-12,23,15700,682.61,18,9700,539,6000,bdg
2024-03-11,16,9700,606.25,13,9500,731,200,bdg
2024-03-08,28,15700,560.71,34,17700,521,-2000,bdg
2024-03-07,26,15700,603.85,18,15200,844,500,bdg
2024-03-06,26,20500,788.46,15,8900,593,11600,bdg
2024-03-05,24,15600,650.0,16,12800,800,2800,bdg
2024-03-04,26,21900,842.31,21,16100,767,5800,bdg
2024-03-01,22,14900,677.27,19,10400,547,4500,bdg
2024-02-29,32,22900,715.62,22,16900,768,6000,bdg
2024-02-28,26,21700,834.62,18,10700,594,11000,bdg
2024-02-27,33,30200,915.15,25,28200,1128,2000,bdg
2024-02-26,39,19800,507.69,37,20700,559,-900,bdg
2024-02-23,32,17700,553.12,49,21000,429,-3300,bdg
2024-02-22,21,14800,704.76,34,16800,494,-2000,bdg
2024-02-21,21,13100,623.81,24,12600,525,500,bdg
2024-02-20,45,40700,904.44,34,29200,859,11500,bdg
2024-02-19,27,19400,718.52,29,24300,838,-4900,bdg
2024-02-16,31,18200,587.1,28,18600,664,-400,bdg
2024-02-15,51,37400,733.33,41,38300,934,-900,bdg
2024-02-07,17,19000,1117.65,17,10000,588,9000,bdg
2024-02-06,38,21500,565.79,31,18400,594,3100,bdg
2024-02-05,55,32100,583.64,68,39600,582,-7500,bdg
2024-02-02,35,28900,825.71,24,37900,1579,-9000,bdg
2024-02-01,28,31700,1132.14,29,41500,1431,-9800,bdg
2024-01-31,29,18900,651.72,18,22600,1256,-3700,bdg
2024-01-30,49,47200,963.27,38,49600,1305,-2400,bdg
2024-01-29,17,12000,705.88,13,22800,1754,-10800,bdg
2024-01-26,10,8800,880.0,20,14200,710,-5400,bdg
2024-01-25,13,10600,815.38,14,9900,707,700,bdg
2024-01-24,17,12400,729.41,14,9900,707,2500,bdg
2024-01-23,13,11000,846.15,25,17600,704,-6600,bdg
2024-01-22,26,17300,665.38,28,23100,825,-5800,bdg
2024-01-19,24,14500,604.17,26,17300,665,-2800,bdg
2024-01-18,31,15500,500.0,22,14600,664,900,bdg
2024-01-17,34,24800,729.41,21,19800,943,5000,bdg
2024-01-16,21,10500,500.0,39,21300,546,-10800,bdg
2024-01-15,20,10700,535.0,17,13800,812,-3100,bdg
2024-01-12,20,18200,910.0,21,16800,800,1400,bdg
2024-01-11,24,16700,695.83,21,18600,886,-1900,bdg
2024-01-10,18,13500,750.0,18,18300,1017,-4800,bdg
2024-01-09,14,9800,700.0,19,11700,616,-1900,bdg
2024-01-08,25,19400,776.0,25,16500,660,2900,bdg
2024-01-05,21,14100,671.43,14,12100,864,2000,bdg
2024-01-04,18,11100,616.67,20,12900,645,-1800,bdg
2024-01-03,18,8700,483.33,18,8500,472,200,bdg
2024-01-02,27,11800,437.04,15,13700,913,-1900,bdg
2024-09-12,5,1500,300.0,2,400,200,1100,bdw
2024-09-11,3,600,200.0,1,300,300,300,bdw
2024-09-10,5,1300,260.0,2,800,400,500,bdw
2024-09-09,8,2200,275.0,8,2700,338,-500,bdw
2024-09-06,4,1300,325.0,4,1600,400,-300,bdw
2024-09-05,8,1100,137.5,6,1600,267,-500,bdw
2024-09-04,12,2700,225.0,7,3500,500,-800,bdw
2024-08-30,6,1700,283.33,4,1500,375,200,bdw
2024-08-29,4,700,175.0,5,4000,800,-3300,bdw
2024-08-28,6,2600,433.33,3,2200,733,400,bdw
2024-08-27,13,4800,369.23,6,4000,667,800,bdw
2024-08-26,10,2200,220.0,5,3000,600,-800,bdw
2024-08-23,3,300,100.0,1,1000,1000,-700,bdw
2024-08-22,5,4700,940.0,4,6500,1625,-1800,bdw
2024-08-21,4,600,150.0,2,2000,1000,-1400,bdw
2024-08-20,5,900,180.0,1,1000,1000,-100,bdw
2024-08-19,6,2000,333.33,1,1000,1000,1000,bdw
2024-08-16,5,1100,220.0,2,1100,550,0,bdw
2024-08-15,5,600,120.0,3,1200,400,-600,bdw
2024-08-14,8,800,100.0,3,1200,400,-400,bdw
2024-08-13,5,2200,440.0,1,100,100,2100,bdw
2024-08-12,5,1200,240.0,2,200,100,1000,bdw
2024-08-09,10,2100,210.0,2,500,250,1600,bdw
2024-08-08,8,4100,512.5,0,0,0,4100,bdw
2024-08-07,8,1300,162.5,0,0,0,1300,bdw
2024-08-06,10,4000,400.0,5,1900,380,2100,bdw
2024-08-05,7,4800,685.71,4,1300,325,3500,bdw
2024-08-02,7,5800,828.57,2,1200,600,4600,bdw
2024-08-01,6,3900,650.0,2,1200,600,2700,bdw
2024-07-31,7,6600,942.86,2,1500,750,5100,bdw
2024-07-30,15,14300,953.33,4,3500,875,10800,bdw
2024-07-29,10,1500,150.0,2,1300,650,200,bdw
2024-07-26,6,2000,333.33,1,1000,1000,1000,bdw
2024-07-25,8,2700,337.5,1,0,0,2700,bdw
2024-07-24,8,4600,575.0,1,1000,1000,3600,bdw
2024-07-23,9,1800,200.0,2,1200,600,600,bdw
2024-07-22,6,1300,216.67,2,1200,600,100,bdw
2024-07-19,7,4500,642.86,1,1000,1000,3500,bdw
2024-07-18,6,1800,300.0,3,3200,1067,-1400,bdw
2024-07-17,6,2500,416.67,2,3000,1500,-500,bdw
2024-07-16,9,5000,555.56,4,1800,450,3200,bdw
2024-07-15,7,1600,228.57,1,1000,1000,600,bdw
2024-07-12,10,4400,440.0,2,1200,600,3200,bdw
2024-07-11,13,5700,438.46,7,2200,314,3500,bdw
2024-07-10,9,5600,622.22,6,2400,400,3200,bdw
2024-07-09,9,6200,688.89,5,2200,440,4000,bdw
2024-07-08,10,7500,750.0,4,1800,450,5700,bdw
2024-07-05,6,2500,416.67,5,1700,340,800,bdw
2024-07-04,7,2500,357.14,2,1300,650,1200,bdw
2024-07-03,6,2500,416.67,3,500,167,2000,bdw
2024-07-02,9,4200,466.67,7,4400,629,-200,bdw
2024-07-01,8,3500,437.5,4,2100,525,1400,bdw
2024-06-28,10,4900,490.0,3,1500,500,3400,bdw
2024-06-27,13,4200,323.08,5,3400,680,800,bdw
2024-06-26,8,4500,562.5,4,1700,425,2800,bdw
2024-06-25,12,7800,650.0,6,3100,517,4700,bdw
2024-06-24,9,3700,411.11,5,800,160,2900,bdw
2024-06-21,8,3800,475.0,8,1300,162,2500,bdw
2024-06-20,15,4100,273.33,8,2200,275,1900,bdw
2024-06-19,20,5000,250.0,14,4800,343,200,bdw
2024-06-18,4,3400,850.0,6,1300,217,2100,bdw
2024-06-17,5,200,40.0,8,4800,600,-4600,bdw
2024-06-14,18,6700,372.22,9,10600,1178,-3900,bdw
2024-06-13,22,7500,340.91,4,3300,825,4200,bdw
2024-06-12,7,1200,171.43,2,4500,2250,-3300,bdw
2024-06-11,6,2500,416.67,8,7200,900,-4700,bdw
2024-06-10,14,5000,357.14,3,500,167,4500,bdw
2024-06-07,9,5600,622.22,0,0,0,5600,bdw
2024-06-06,25,13000,520.0,6,7400,1233,5600,bdw
2024-06-05,12,7000,583.33,2,5300,2650,1700,bdw
2024-06-04,9,8400,933.33,2,200,100,8200,bdw
2024-06-03,10,8600,860.0,1,100,100,8500,bdw
2024-05-31,10,8100,810.0,2,300,150,7800,bdw
2024-05-30,15,9000,600.0,3,400,133,8600,bdw
2024-05-29,7,1800,257.14,0,0,0,1800,bdw
2024-05-28,7,3000,428.57,3,500,167,2500,bdw
2024-05-27,7,2800,400.0,1,100,100,2700,bdw
2024-05-24,9,3900,433.33,2,600,300,3300,bdw
2024-05-23,10,4900,490.0,1,600,600,4300,bdw
2024-05-22,7,2400,342.86,1,6800,6800,-4400,bdw
2024-05-21,11,7600,690.91,4,3300,825,4300,bdw
2024-05-20,11,9100,827.27,3,2700,900,6400,bdw
2024-05-17,15,6900,460.0,3,2300,767,4600,bdw
2024-05-16,6,2400,400.0,2,2100,1050,300,bdw
2024-05-15,9,5400,600.0,3,2200,733,3200,bdw
2024-05-14,13,14200,1092.31,28,11500,411,2700,bdw
2024-05-13,9,6700,744.44,12,7500,625,-800,bdw
2024-05-10,7,9700,1385.71,4,2800,700,6900,bdw
2024-05-09,7,3000,428.57,7,1000,143,2000,bdw
2024-05-08,10,5700,570.0,4,2600,650,3100,bdw
2024-05-07,11,6700,609.09,6,4800,800,1900,bdw
2024-05-06,8,4700,587.5,4,2700,675,2000,bdw
2024-05-03,9,6000,666.67,5,4900,980,1100,bdw
2024-05-02,7,2800,400.0,13,8600,662,-5800,bdw
2024-04-26,8,4400,550.0,12,4500,375,-100,bdw
2024-04-25,7,6900,985.71,3,300,100,6600,bdw
2024-04-24,12,7000,583.33,8,6800,850,200,bdw
2024-04-23,8,4100,512.5,4,2400,600,1700,bdw
2024-04-22,15,8800,586.67,4,2200,550,6600,bdw
2024-04-19,16,8200,512.5,9,2100,233,6100,bdw
2024-04-17,14,9800,700.0,6,5300,883,4500,bdw
2024-04-16,9,5000,555.56,5,5200,1040,-200,bdw
2024-04-15,10,5800,580.0,5,6000,1200,-200,bdw
2024-04-12,14,4400,314.29,10,5800,580,-1400,bdw
2024-04-11,9,6300,700.0,15,5700,380,600,bdw
2024-04-10,21,16200,771.43,14,5600,400,10600,bdw
2024-04-09,28,11200,400.0,13,6000,462,5200,bdw
2024-04-08,9,5000,555.56,8,7000,875,-2000,bdw
2024-04-05,10,5700,570.0,5,6500,1300,-800,bdw
2024-04-04,12,5900,491.67,4,4700,1175,1200,bdw
2024-04-03,10,4900,490.0,7,7400,1057,-2500,bdw
2024-04-02,12,7300,608.33,6,5600,933,1700,bdw
2024-04-01,10,5300,530.0,7,7800,1114,-2500,bdw
2024-03-29,9,15200,1688.89,5,4100,820,11100,bdw
2024-03-28,14,7600,542.86,9,6900,767,700,bdw
2024-03-27,15,6700,446.67,7,6700,957,0,bdw
2024-03-26,7,4900,700.0,7,8500,1214,-3600,bdw
2024-03-25,7,5500,785.71,1,2000,2000,3500,bdw
2024-03-22,30,15200,506.67,14,13700,979,1500,bdw
2024-03-21,4,4700,1175.0,6,14300,2383,-9600,bdw
2024-03-20,4,3700,925.0,5,12100,2420,-8400,bdw
2024-03-19,5,1400,280.0,7,9000,1286,-7600,bdw
2024-03-18,0,0,0.0,5,8600,1720,-8600,bdw
2024-03-15,6,2400,400.0,5,8500,1700,-6100,bdw
2024-03-14,8,6000,750.0,5,2300,460,3700,bdw
2024-03-13,6,5000,833.33,3,3700,1233,1300,bdw
2024-03-12,9,6000,666.67,7,13700,1957,-7700,bdw
2024-03-11,5,3000,600.0,4,12400,3100,-9400,bdw
2024-03-08,9,2900,322.22,6,14700,2450,-11800,bdw
2024-03-07,10,12500,1250.0,3,11400,3800,1100,bdw
2024-03-06,6,2800,466.67,4,13400,3350,-10600,bdw
2024-03-05,7,2300,328.57,4,3600,900,-1300,bdw
2024-03-04,6,3800,633.33,4,3500,875,300,bdw
2024-03-01,7,4300,614.29,7,5600,800,-1300,bdw
2024-02-29,6,3300,550.0,4,13500,3375,-10200,bdw
2024-02-28,5,3300,660.0,5,13500,2700,-10200,bdw
2024-02-27,7,4400,628.57,4,13400,3350,-9000,bdw
2024-02-26,9,6500,722.22,7,3700,529,2800,bdw
2024-02-23,11,11900,1081.82,6,5800,967,6100,bdw
2024-02-22,14,10300,735.71,8,6500,812,3800,bdw
2024-02-21,9,5100,566.67,5,3700,740,1400,bdw
2024-02-20,12,8200,683.33,10,18000,1800,-9800,bdw
2024-02-19,8,6900,862.5,5,15100,3020,-8200,bdw
2024-02-16,10,6100,610.0,12,10500,875,-4400,bdw
2024-02-15,6,2200,366.67,4,2600,650,-400,bdw
2024-02-07,5,1900,380.0,5,4000,800,-2100,bdw
2024-02-06,7,4300,614.29,6,6500,1083,-2200,bdw
2024-02-05,12,6400,533.33,13,7200,554,-800,bdw
2024-02-02,9,5000,555.56,5,4400,880,600,bdw
2024-02-01,6,2500,416.67,12,7300,608,-4800,bdw
2024-01-31,5,7200,1440.0,5,4600,920,2600,bdw
2024-01-30,6,5900,983.33,10,8500,850,-2600,bdw
2024-01-29,6,5800,966.67,7,8400,1200,-2600,bdw
2024-01-26,10,7900,790.0,10,10000,1000,-2100,bdw
2024-01-25,6,4300,716.67,7,5700,814,-1400,bdw
2024-01-24,11,6700,609.09,6,2100,350,4600,bdw
2024-01-23,9,5900,655.56,7,8000,1143,-2100,bdw
2024-01-22,8,7000,875.0,9,5700,633,1300,bdw
2024-01-19,7,7900,1128.57,1,100,100,7800,bdw
2024-01-18,7,7900,1128.57,2,1100,550,6800,bdw
2024-01-17,8,8600,1075.0,2,200,100,8400,bdw
2024-01-16,7,6600,942.86,2,300,150,6300,bdw
2024-01-15,13,71500,5500.0,5,3400,680,68100,bdw
2024-01-12,9,5700,633.33,2,400,200,5300,bdw
2024-01-11,9,8800,977.78,3,3100,1033,5700,bdw
2024-01-10,6,4800,800.0,1,100,100,4700,bdw
2024-01-09,11,5000,454.55,3,1200,400,3800,bdw
2024-01-08,6,7200,1200.0,2,1800,900,5400,bdw
2024-01-05,5,4200,840.0,2,2900,1450,1300,bdw
2024-01-04,13,10500,807.69,4,6100,1525,4400,bdw
2024-01-03,6,4300,716.67,3,2900,967,1400,bdw
2024-01-02,9,1400,155.56,2,100,50,1300,bdw
2024-09-12,0,0,0.0,0,0,0,0,bed
2024-09-11,0,0,0.0,0,0,0,0,bed
2024-09-10,0,0,0.0,0,0,0,0,bed
2024-09-09,0,0,0.0,0,0,0,0,bed
2024-09-06,0,0,0.0,0,0,0,0,bed
2024-09-05,0,0,0.0,0,0,0,0,bed
2024-09-04,0,0,0.0,0,0,0,0,bed
2024-08-30,0,0,0.0,0,0,0,0,bed
2024-08-29,0,0,0.0,0,0,0,0,bed
2024-08-28,0,0,0.0,0,0,0,0,bed
2024-08-27,0,0,0.0,0,0,0,0,bed
2024-08-26,0,0,0.0,0,0,0,0,bed
2024-08-23,0,0,0.0,0,0,0,0,bed
2024-08-22,0,0,0.0,0,0,0,0,bed
2024-08-21,0,0,0.0,0,0,0,0,bed
2024-08-20,0,0,0.0,0,0,0,0,bed
2024-08-19,0,0,0.0,0,0,0,0,bed
2024-08-16,0,0,0.0,0,0,0,0,bed
2024-08-15,0,0,0.0,0,0,0,0,bed
2024-08-14,0,0,0.0,0,0,0,0,bed
2024-08-13,0,0,0.0,0,0,0,0,bed
2024-08-12,0,0,0.0,0,0,0,0,bed
2024-08-09,0,0,0.0,0,0,0,0,bed
2024-08-08,0,0,0.0,0,0,0,0,bed
2024-08-07,0,0,0.0,0,0,0,0,bed
2024-08-06,0,0,0.0,0,0,0,0,bed
2024-08-05,0,0,0.0,0,0,0,0,bed
2024-08-02,0,0,0.0,0,0,0,0,bed
2024-08-01,0,0,0.0,0,0,0,0,bed
2024-07-31,0,0,0.0,0,0,0,0,bed
2024-07-30,0,0,0.0,0,0,0,0,bed
2024-07-29,0,0,0.0,0,0,0,0,bed
2024-07-26,0,0,0.0,0,0,0,0,bed
2024-07-25,0,0,0.0,0,0,0,0,bed
2024-07-24,0,0,0.0,0,0,0,0,bed
2024-07-23,0,0,0.0,0,0,0,0,bed
2024-07-22,0,0,0.0,0,0,0,0,bed
2024-07-19,0,0,0.0,0,0,0,0,bed
2024-07-18,0,0,0.0,0,0,0,0,bed
2024-07-17,0,0,0.0,0,0,0,0,bed
2024-07-16,0,0,0.0,0,0,0,0,bed
2024-07-15,0,0,0.0,0,0,0,0,bed
2024-07-12,0,0,0.0,0,0,0,0,bed
2024-07-11,0,0,0.0,0,0,0,0,bed
2024-07-10,0,0,0.0,0,0,0,0,bed
2024-07-09,0,0,0.0,0,0,0,0,bed
2024-07-08,0,0,0.0,0,0,0,0,bed
2024-07-05,0,0,0.0,0,0,0,0,bed
2024-07-04,0,0,0.0,0,0,0,0,bed
2024-07-03,0,0,0.0,0,0,0,0,bed
2024-07-02,0,0,0.0,0,0,0,0,bed
2024-07-01,0,0,0.0,0,0,0,0,bed
2024-06-28,0,0,0.0,0,0,0,0,bed
2024-06-27,0,0,0.0,0,0,0,0,bed
2024-06-26,0,0,0.0,0,0,0,0,bed
2024-06-25,0,0,0.0,0,0,0,0,bed
2024-06-24,0,0,0.0,0,0,0,0,bed
2024-06-21,0,0,0.0,0,0,0,0,bed
2024-06-20,0,0,0.0,0,0,0,0,bed
2024-06-19,0,0,0.0,0,0,0,0,bed
2024-06-18,0,0,0.0,0,0,0,0,bed
2024-06-17,0,0,0.0,0,0,0,0,bed
2024-06-14,0,0,0.0,0,0,0,0,bed
2024-06-13,0,0,0.0,0,0,0,0,bed
2024-06-12,0,0,0.0,0,0,0,0,bed
2024-06-11,0,0,0.0,0,0,0,0,bed
2024-06-10,0,0,0.0,0,0,0,0,bed
2024-06-07,0,0,0.0,0,0,0,0,bed
2024-06-06,0,0,0.0,0,0,0,0,bed
2024-06-05,0,0,0.0,0,0,0,0,bed
2024-06-04,0,0,0.0,0,0,0,0,bed
2024-06-03,0,0,0.0,0,0,0,0,bed
2024-05-31,0,0,0.0,0,0,0,0,bed
2024-05-30,0,0,0.0,0,0,0,0,bed
2024-05-29,0,0,0.0,0,0,0,0,bed
2024-05-28,0,0,0.0,0,0,0,0,bed
2024-05-27,0,0,0.0,0,0,0,0,bed
2024-05-24,0,0,0.0,0,0,0,0,bed
2024-05-23,0,0,0.0,0,0,0,0,bed
2024-05-22,0,0,0.0,0,0,0,0,bed
2024-05-21,0,0,0.0,0,0,0,0,bed
2024-05-20,0,0,0.0,0,0,0,0,bed
2024-05-17,0,0,0.0,0,0,0,0,bed
2024-05-16,0,0,0.0,0,0,0,0,bed
2024-05-15,0,0,0.0,0,0,0,0,bed
2024-05-14,1,0,0.0,0,0,0,0,bed
2024-05-13,0,0,0.0,0,0,0,0,bed
2024-05-10,0,0,0.0,0,0,0,0,bed
2024-05-09,0,0,0.0,0,0,0,0,bed
2024-05-08,0,0,0.0,0,0,0,0,bed
2024-05-07,0,0,0.0,0,0,0,0,bed
2024-05-06,0,0,0.0,0,0,0,0,bed
2024-05-03,0,0,0.0,0,0,0,0,bed
2024-05-02,0,0,0.0,0,0,0,0,bed
2024-04-26,0,0,0.0,0,0,0,0,bed
2024-04-25,0,0,0.0,0,0,0,0,bed
2024-04-24,0,0,0.0,0,0,0,0,bed
2024-04-23,0,0,0.0,0,0,0,0,bed
2024-04-22,0,0,0.0,0,0,0,0,bed
2024-04-19,0,0,0.0,0,0,0,0,bed
2024-04-17,0,0,0.0,0,0,0,0,bed
2024-04-16,0,0,0.0,0,0,0,0,bed
2024-04-15,0,0,0.0,0,0,0,0,bed
2024-04-12,0,0,0.0,0,0,0,0,bed
2024-04-11,0,0,0.0,0,0,0,0,bed
2024-04-10,0,0,0.0,0,0,0,0,bed
2024-04-09,0,0,0.0,0,0,0,0,bed
2024-04-08,0,0,0.0,0,0,0,0,bed
2024-04-05,0,0,0.0,0,0,0,0,bed
2024-04-04,0,0,0.0,0,0,0,0,bed
2024-04-03,0,0,0.0,0,0,0,0,bed
2024-04-02,0,0,0.0,0,0,0,0,bed
2024-04-01,0,0,0.0,0,0,0,0,bed
2024-03-29,0,0,0.0,0,0,0,0,bed
2024-03-28,0,0,0.0,0,0,0,0,bed
2024-03-27,0,0,0.0,0,0,0,0,bed
2024-03-26,0,0,0.0,0,0,0,0,bed
2024-03-25,0,0,0.0,0,0,0,0,bed
2024-03-22,0,0,0.0,0,0,0,0,bed
2024-03-21,0,0,0.0,0,0,0,0,bed
2024-03-20,0,0,0.0,0,0,0,0,bed
2024-03-19,0,0,0.0,0,0,0,0,bed
2024-03-18,0,0,0.0,0,0,0,0,bed
2024-03-15,1,200,200.0,0,0,0,200,bed
2024-03-14,1,200,200.0,0,0,0,200,bed
2024-03-13,1,200,200.0,0,0,0,200,bed
2024-03-12,0,0,0.0,0,0,0,0,bed
2024-03-11,0,0,0.0,0,0,0,0,bed
2024-03-08,0,0,0.0,0,0,0,0,bed
2024-03-07,0,0,0.0,0,0,0,0,bed
2024-03-06,0,0,0.0,0,0,0,0,bed
2024-03-05,0,0,0.0,0,0,0,0,bed
2024-03-04,0,0,0.0,0,0,0,0,bed
2024-03-01,0,0,0.0,0,0,0,0,bed
2024-02-29,0,0,0.0,0,0,0,0,bed
2024-02-28,0,0,0.0,0,0,0,0,bed
2024-02-27,0,0,0.0,0,0,0,0,bed
2024-02-26,0,0,0.0,0,0,0,0,bed
2024-02-23,0,0,0.0,0,0,0,0,bed
2024-02-22,0,0,0.0,0,0,0,0,bed
2024-02-21,0,0,0.0,0,0,0,0,bed
2024-02-20,0,0,0.0,0,0,0,0,bed
2024-02-19,0,0,0.0,0,0,0,0,bed
2024-02-16,0,0,0.0,0,0,0,0,bed
2024-02-15,0,0,0.0,0,0,0,0,bed
2024-02-07,0,0,0.0,0,0,0,0,bed
2024-02-06,0,0,0.0,0,0,0,0,bed
2024-02-05,0,0,0.0,0,0,0,0,bed
2024-02-02,0,0,0.0,0,0,0,0,bed
2024-02-01,0,0,0.0,0,0,0,0,bed
2024-01-31,0,0,0.0,0,0,0,0,bed
2024-01-30,0,0,0.0,0,0,0,0,bed
2024-01-29,0,0,0.0,0,0,0,0,bed
2024-01-26,0,0,0.0,0,0,0,0,bed
2024-01-25,0,0,0.0,0,0,0,0,bed
2024-01-24,0,0,0.0,0,0,0,0,bed
2024-01-23,0,0,0.0,0,0,0,0,bed
2024-01-22,0,0,0.0,0,0,0,0,bed
2024-01-19,1,100,100.0,1,100,100,0,bed
2024-01-18,0,0,0.0,0,0,0,0,bed
2024-01-17,1,100,100.0,1,100,100,0,bed
2024-01-16,0,0,0.0,0,0,0,0,bed
2024-01-15,2,200,100.0,1,100,100,100,bed
2024-01-12,2,200,100.0,1,100,100,100,bed
2024-01-11,1,100,100.0,1,100,100,0,bed
2024-01-10,2,300,150.0,1,100,100,200,bed
2024-01-09,2,300,150.0,0,0,0,300,bed
2024-01-08,2,300,150.0,0,0,0,300,bed
2024-01-05,2,1100,550.0,1,100,100,1000,bed
2024-01-04,4,3300,825.0,0,0,0,3300,bed
2024-01-03,5,4500,900.0,0,0,0,4500,bed
2024-01-02,5,1800,360.0,1,100,100,1700,bed
2024-09-12,0,0,0.0,0,0,0,0,bel
2024-09-11,0,0,0.0,0,0,0,0,bel
2024-09-10,0,0,0.0,0,0,0,0,bel
2024-09-09,0,0,0.0,0,0,0,0,bel
2024-09-06,0,0,0.0,0,0,0,0,bel
2024-09-05,0,0,0.0,0,0,0,0,bel
2024-09-04,0,0,0.0,0,0,0,0,bel
2024-08-30,0,0,0.0,0,0,0,0,bel
2024-08-29,0,0,0.0,0,0,0,0,bel
2024-08-28,0,0,0.0,2,6100,3050,-6100,bel
2024-08-27,0,0,0.0,0,0,0,0,bel
2024-08-26,0,0,0.0,1,6100,6100,-6100,bel
2024-08-23,0,0,0.0,0,0,0,0,bel
2024-08-22,0,0,0.0,0,0,0,0,bel
2024-08-21,0,0,0.0,0,0,0,0,bel
2024-08-20,0,0,0.0,0,0,0,0,bel
2024-08-19,0,0,0.0,0,0,0,0,bel
2024-08-16,0,0,0.0,1,6100,6100,-6100,bel
2024-08-15,0,0,0.0,0,0,0,0,bel
2024-08-14,0,0,0.0,0,0,0,0,bel
2024-08-13,0,0,0.0,1,11800,11800,-11800,bel
2024-08-12,0,0,0.0,0,0,0,0,bel
2024-08-09,0,0,0.0,0,0,0,0,bel
2024-08-08,0,0,0.0,0,0,0,0,bel
2024-08-07,0,0,0.0,1,11800,11800,-11800,bel
2024-08-06,0,0,0.0,0,0,0,0,bel
2024-08-05,0,0,0.0,0,0,0,0,bel
2024-08-02,0,0,0.0,0,0,0,0,bel
2024-08-01,0,0,0.0,2,7900,3950,-7900,bel
2024-07-31,0,0,0.0,2,7900,3950,-7900,bel
2024-07-30,0,0,0.0,1,6100,6100,-6100,bel
2024-07-29,0,0,0.0,2,7900,3950,-7900,bel
2024-07-26,0,0,0.0,1,6100,6100,-6100,bel
2024-07-25,0,0,0.0,1,6100,6100,-6100,bel
2024-07-24,0,0,0.0,3,7900,2633,-7900,bel
2024-07-23,0,0,0.0,2,6100,3050,-6100,bel
2024-07-22,0,0,0.0,4,37900,9475,-37900,bel
2024-07-19,1,200,200.0,1,30000,30000,-29800,bel
2024-07-18,0,0,0.0,2,31800,15900,-31800,bel
2024-07-17,0,0,0.0,4,37900,9475,-37900,bel
2024-07-16,0,0,0.0,2,31800,15900,-31800,bel
2024-07-15,0,0,0.0,4,37900,9475,-37900,bel
2024-07-12,0,0,0.0,3,37900,12633,-37900,bel
2024-07-11,0,0,0.0,3,36100,12033,-36100,bel
2024-07-10,0,0,0.0,3,36100,12033,-36100,bel
2024-07-09,0,0,0.0,4,37900,9475,-37900,bel
2024-07-08,0,0,0.0,3,36100,12033,-36100,bel
2024-07-05,0,0,0.0,2,36100,18050,-36100,bel
2024-07-04,0,0,0.0,1,30000,30000,-30000,bel
2024-07-03,0,0,0.0,2,31800,15900,-31800,bel
2024-07-02,0,0,0.0,1,30000,30000,-30000,bel
2024-07-01,0,0,0.0,2,31800,15900,-31800,bel
2024-06-28,0,0,0.0,2,31800,15900,-31800,bel
2024-06-27,0,0,0.0,1,30000,30000,-30000,bel
2024-06-26,0,0,0.0,2,31800,15900,-31800,bel
2024-06-25,0,0,0.0,2,31800,15900,-31800,bel
2024-06-24,0,0,0.0,2,32800,16400,-32800,bel
2024-06-21,0,0,0.0,2,31800,15900,-31800,bel
2024-06-20,0,0,0.0,2,31800,15900,-31800,bel
2024-06-19,0,0,0.0,2,31800,15900,-31800,bel
2024-06-18,0,0,0.0,2,32800,16400,-32800,bel
2024-06-17,0,0,0.0,2,5300,2650,-5300,bel
2024-06-14,1,100,100.0,2,16900,8450,-16800,bel
2024-06-13,0,0,0.0,2,16900,8450,-16900,bel
2024-06-12,0,0,0.0,2,10900,5450,-10900,bel
2024-06-11,0,0,0.0,1,1900,1900,-1900,bel
2024-06-10,1,0,0.0,3,2200,733,-2200,bel
2024-06-07,1,100,100.0,1,2000,2000,-1900,bel
2024-06-06,0,0,0.0,1,2000,2000,-2000,bel
2024-06-05,0,0,0.0,1,2100,2100,-2100,bel
2024-06-04,0,0,0.0,1,2000,2000,-2000,bel
2024-06-03,1,100,100.0,1,2100,2100,-2000,bel
2024-05-31,0,0,0.0,1,2100,2100,-2100,bel
2024-05-30,0,0,0.0,1,2100,2100,-2100,bel
2024-05-29,0,0,0.0,1,2100,2100,-2100,bel
2024-05-28,0,0,0.0,1,2100,2100,-2100,bel
2024-05-27,0,0,0.0,1,2100,2100,-2100,bel
2024-05-24,1,100,100.0,1,100,100,0,bel
2024-05-23,1,100,100.0,1,100,100,0,bel
2024-05-22,0,0,0.0,0,0,0,0,bel
2024-05-21,0,0,0.0,0,0,0,0,bel
2024-05-20,0,0,0.0,0,0,0,0,bel
2024-05-17,1,100,100.0,1,100,100,0,bel
2024-05-16,1,5000,5000.0,0,0,0,5000,bel
2024-05-15,1,0,0.0,0,0,0,0,bel
2024-05-14,1,0,0.0,1,100,100,-100,bel
2024-05-13,1,100,100.0,0,0,0,100,bel
2024-05-10,0,0,0.0,1,100,100,-100,bel
2024-05-09,0,0,0.0,0,0,0,0,bel
2024-05-08,0,0,0.0,0,0,0,0,bel
2024-05-07,0,0,0.0,0,0,0,0,bel
2024-05-06,0,0,0.0,0,0,0,0,bel
2024-05-03,0,0,0.0,0,0,0,0,bel
2024-05-02,0,0,0.0,0,0,0,0,bel
2024-04-26,0,0,0.0,0,0,0,0,bel
2024-04-25,1,4000,4000.0,1,100,100,3900,bel
2024-04-24,0,0,0.0,0,0,0,0,bel
2024-04-23,2,1100,550.0,1,100,100,1000,bel
2024-04-22,0,0,0.0,0,0,0,0,bel
2024-04-19,2,1100,550.0,1,100,100,1000,bel
2024-04-17,1,100,100.0,0,0,0,100,bel
2024-04-16,0,0,0.0,0,0,0,0,bel
2024-04-15,2,1000,500.0,0,0,0,1000,bel
2024-04-12,1,100,100.0,0,0,0,100,bel
2024-04-11,0,0,0.0,0,0,0,0,bel
2024-04-10,0,0,0.0,0,0,0,0,bel
2024-04-09,2,1100,550.0,0,0,0,1100,bel
2024-04-08,1,100,100.0,0,0,0,100,bel
2024-04-05,1,1000,1000.0,0,0,0,1000,bel
2024-04-04,1,100,100.0,0,0,0,100,bel
2024-04-03,1,100,100.0,0,0,0,100,bel
2024-04-02,0,0,0.0,0,0,0,0,bel
2024-04-01,4,2800,700.0,1,100,100,2700,bel
2024-03-29,3,1200,400.0,1,100,100,1100,bel
2024-03-28,1,1500,1500.0,1,100,100,1400,bel
2024-03-27,2,1000,500.0,1,100,100,900,bel
2024-03-26,1,2000,2000.0,0,0,0,2000,bel
2024-03-25,3,2300,766.67,0,0,0,2300,bel
2024-03-22,2,2100,1050.0,0,0,0,2100,bel
2024-03-21,2,2100,1050.0,0,0,0,2100,bel
2024-03-20,2,2200,1100.0,0,0,0,2200,bel
2024-03-19,2,2100,1050.0,0,0,0,2100,bel
2024-03-18,3,600,200.0,0,0,0,600,bel
2024-03-15,0,0,0.0,0,0,0,0,bel
2024-03-14,1,100,100.0,0,0,0,100,bel
2024-03-13,0,0,0.0,0,0,0,0,bel
2024-03-12,2,200,100.0,0,0,0,200,bel
2024-03-11,3,200,66.67,0,0,0,200,bel
2024-03-08,0,0,0.0,0,0,0,0,bel
2024-03-07,1,100,100.0,0,0,0,100,bel
2024-03-06,2,200,100.0,0,0,0,200,bel
2024-03-05,1,100,100.0,0,0,0,100,bel
2024-03-04,2,300,150.0,0,0,0,300,bel
2024-03-01,1,100,100.0,0,0,0,100,bel
2024-02-29,0,0,0.0,0,0,0,0,bel
2024-02-28,1,0,0.0,0,0,0,0,bel
2024-02-27,1,100,100.0,0,0,0,100,bel
2024-02-26,2,200,100.0,0,0,0,200,bel
2024-02-23,2,200,100.0,0,0,0,200,bel
2024-02-22,0,0,0.0,0,0,0,0,bel
2024-02-21,1,100,100.0,0,0,0,100,bel
2024-02-20,2,200,100.0,0,0,0,200,bel
2024-02-19,0,0,0.0,0,0,0,0,bel
2024-02-16,3,300,100.0,0,0,0,300,bel
2024-02-15,0,0,0.0,0,0,0,0,bel
2024-02-07,2,100,50.0,0,0,0,100,bel
2024-02-06,1,100,100.0,0,0,0,100,bel
2024-02-05,1,100,100.0,0,0,0,100,bel
2024-02-02,0,0,0.0,0,0,0,0,bel
2024-02-01,0,0,0.0,0,0,0,0,bel
2024-01-31,0,0,0.0,0,0,0,0,bel
2024-01-30,0,0,0.0,0,0,0,0,bel
2024-01-29,0,0,0.0,0,0,0,0,bel
2024-01-26,0,0,0.0,0,0,0,0,bel
2024-01-25,0,0,0.0,0,0,0,0,bel
2024-01-24,0,0,0.0,0,0,0,0,bel
2024-01-23,1,100,100.0,1,100,100,0,bel
2024-01-22,0,0,0.0,0,0,0,0,bel
2024-01-19,0,0,0.0,0,0,0,0,bel
2024-01-18,0,0,0.0,0,0,0,0,bel
2024-01-17,0,0,0.0,0,0,0,0,bel
2024-01-16,0,0,0.0,0,0,0,0,bel
2024-01-15,0,0,0.0,0,0,0,0,bel
2024-01-12,0,0,0.0,0,0,0,0,bel
2024-01-11,0,0,0.0,0,0,0,0,bel
2024-01-10,0,0,0.0,0,0,0,0,bel
2024-01-09,0,0,0.0,0,0,0,0,bel
2024-01-08,1,400,400.0,0,0,0,400,bel
2024-01-05,0,0,0.0,0,0,0,0,bel
2024-01-04,0,0,0.0,0,0,0,0,bel
2024-01-03,0,0,0.0,0,0,0,0,bel
2024-01-02,0,0,0.0,0,0,0,0,bel
2024-09-12,1161,2424000,2087.86,1267,3652700,2883,-1228700,bfc
2024-09-11,663,989300,1492.16,462,870900,1885,118400,bfc
2024-09-10,526,673900,1281.18,566,1216700,2150,-542800,bfc
2024-09-09,377,736500,1953.58,455,1021600,2245,-285100,bfc
2024-09-06,530,876400,1653.58,509,1241400,2439,-365000,bfc
2024-09-05,411,1184600,2882.24,737,1440300,1954,-255700,bfc
2024-09-04,586,546200,932.08,379,843300,2225,-297100,bfc
2024-08-30,529,766100,1448.2,746,1181600,1584,-415500,bfc
2024-08-29,627,840100,1339.87,364,938800,2579,-98700,bfc
2024-08-28,912,994600,1090.57,508,1136900,2238,-142300,bfc
2024-08-27,1082,2016400,1863.59,714,1015800,1423,1000600,bfc
2024-08-26,1800,2366900,1314.94,1095,2202500,2011,164400,bfc
2024-08-23,1651,2142000,1297.4,870,3067900,3526,-925900,bfc
2024-08-22,645,842800,1306.67,596,1610600,2702,-767800,bfc
2024-08-21,1357,2757900,2032.35,979,2558700,2614,199200,bfc
2024-08-20,807,1304100,1615.99,758,2026600,2674,-722500,bfc
2024-08-19,818,1936500,2367.36,1136,2590000,2280,-653500,bfc
2024-08-16,1150,1985500,1726.52,1022,2073300,2029,-87800,bfc
2024-08-15,1581,2273200,1437.82,934,2353900,2520,-80700,bfc
2024-08-14,1943,3457800,1779.62,1513,3984000,2633,-526200,bfc
2024-08-13,1096,1982000,1808.39,1079,2486500,2304,-504500,bfc
2024-08-12,1004,1482600,1476.69,870,1903000,2187,-420400,bfc
2024-08-08,1066,1098000,1030.02,861,1671200,1941,-573200,bfc
2024-08-07,987,1187600,1203.24,594,1479300,2490,-291700,bfc
2024-08-06,864,1290500,1493.63,715,1800800,2519,-510300,bfc
2024-08-05,1078,1737900,1612.15,937,3105400,3314,-1367500,bfc
2024-08-02,1281,2988100,2332.63,818,4601700,5626,-1613600,bfc
2024-08-01,1347,2061100,1530.14,1097,3743100,3412,-1682000,bfc
2024-07-31,647,1364100,2108.35,575,1382500,2404,-18400,bfc
2024-07-30,1112,2491100,2240.2,1184,2848800,2406,-357700,bfc
2024-07-29,1082,4889600,4519.04,501,2351400,4693,2538200,bfc
2024-07-26,489,656200,1341.92,534,1252100,2345,-595900,bfc
2024-07-25,688,1872700,2721.95,507,1658500,3271,214200,bfc
2024-07-24,1047,1821000,1739.26,814,1711200,2102,109800,bfc
2024-07-22,570,1087200,1907.37,536,1585400,2958,-498200,bfc
2024-07-19,450,1075400,2389.78,609,3271300,5372,-2195900,bfc
2024-07-18,1046,3166800,3027.53,743,2475000,3331,691800,bfc
2024-07-17,966,3151000,3261.9,1382,4334100,3136,-1183100,bfc
2024-07-16,488,1471100,3014.55,889,2168400,2439,-697300,bfc
2024-07-15,628,994700,1583.92,701,1471300,2099,-476600,bfc
2024-07-12,854,1538200,1801.17,753,1544100,2051,-5900,bfc
2024-07-11,1247,2046100,1640.82,1155,2469000,2138,-422900,bfc
2024-07-10,2296,4619100,2011.8,2255,4600100,2040,19000,bfc
2024-07-09,621,2627300,4230.76,214,885200,4136,1742100,bfc
2024-07-08,898,4098800,4564.37,617,1089700,1766,3009100,bfc
2024-07-05,966,1851400,1916.56,1009,1625100,1611,226300,bfc
2024-07-04,692,1143700,1652.75,912,1607500,1763,-463800,bfc
2024-07-03,890,1523900,1712.25,916,1764000,1926,-240100,bfc
2024-07-02,631,1126100,1784.63,483,907000,1878,219100,bfc
2024-07-01,761,991000,1302.23,505,945400,1872,45600,bfc
2024-06-28,660,1006300,1524.7,738,1267200,1717,-260900,bfc
2024-06-27,894,1344900,1504.36,841,1840600,2189,-495700,bfc
2024-06-26,803,2053700,2557.53,680,1867200,2746,186500,bfc
2024-06-25,761,1866000,2452.04,526,1193300,2269,672700,bfc
2024-06-24,1302,1836400,1410.45,996,1968500,1976,-132100,bfc
2024-06-21,897,1537700,1714.27,981,1802400,1837,-264700,bfc
2024-06-20,1095,2137600,1952.15,1059,1600900,1512,536700,bfc
2024-06-19,1515,5431500,3585.15,1081,2309100,2136,3122400,bfc
2024-06-18,683,1852600,2712.45,666,937300,1407,915300,bfc
2024-06-17,753,969300,1287.25,514,904100,1759,65200,bfc
2024-06-14,1152,1154000,1001.74,629,1338500,2128,-184500,bfc
2024-06-13,592,851000,1437.5,625,1061600,1699,-210600,bfc
2024-06-12,975,1381700,1417.13,652,1170100,1795,211600,bfc
2024-06-11,1323,1728500,1306.5,876,2149400,2454,-420900,bfc
2024-06-10,748,928700,1241.58,610,1324000,2170,-395300,bfc
2024-06-07,951,1704500,1792.32,878,1867100,2127,-162600,bfc
2024-06-06,817,1420800,1739.05,477,1077500,2259,343300,bfc
2024-06-05,821,923300,1124.6,524,1327300,2533,-404000,bfc
2024-06-04,450,751800,1670.67,433,973500,2248,-221700,bfc
2024-06-03,677,1068200,1577.84,529,1062000,2008,6200,bfc
2024-05-31,641,888900,1386.74,488,891700,1827,-2800,bfc
2024-05-30,751,759600,1011.45,568,944000,1662,-184400,bfc
2024-05-29,557,1393400,2501.62,470,1161000,2470,232400,bfc
2024-05-28,429,733000,1708.62,295,841600,2853,-108600,bfc
2024-05-27,415,853700,2057.11,447,994700,2225,-141000,bfc
2024-05-24,584,922000,1578.77,444,793100,1786,128900,bfc
2024-05-23,402,910600,2265.17,421,921900,2190,-11300,bfc
2024-05-22,419,1369900,3269.45,798,1814600,2274,-444700,bfc
2024-05-21,634,2347200,3702.21,643,1438700,2237,908500,bfc
2024-05-20,706,2082900,2950.28,477,1727400,3621,355500,bfc
2024-05-17,722,997400,1381.44,327,778800,2382,218600,bfc
2024-05-16,393,1048400,2667.68,506,1454100,2874,-405700,bfc
2024-05-15,405,1347700,3327.65,476,1151400,2419,196300,bfc
2024-05-14,312,679100,2176.6,376,1048200,2788,-369100,bfc
2024-05-13,578,1532300,2651.04,451,1224200,2714,308100,bfc
2024-05-10,593,2027600,3419.22,606,1956600,3229,71000,bfc
2024-05-09,466,1829600,3926.18,631,2107700,3340,-278100,bfc
2024-05-08,960,3576900,3725.94,785,1961400,2499,1615500,bfc
2024-05-07,476,863700,1814.5,630,1289400,2047,-425700,bfc
2024-05-06,531,2099900,3954.61,786,1368900,1742,731000,bfc
2024-05-03,462,1065500,2306.28,424,800300,1888,265200,bfc
2024-05-02,367,495000,1348.77,323,653100,2022,-158100,bfc
2024-04-26,227,279300,1230.4,220,475600,2162,-196300,bfc
2024-04-25,189,411400,2176.72,293,559400,1909,-148000,bfc
2024-04-24,219,403200,1841.1,304,551300,1813,-148100,bfc
2024-04-23,135,170700,1264.44,139,220200,1584,-49500,bfc
2024-04-22,246,350700,1425.61,203,291800,1437,58900,bfc
2024-04-19,318,419400,1318.87,281,711600,2532,-292200,bfc
2024-04-17,241,503700,2090.04,223,679100,3045,-175400,bfc
2024-04-16,521,785100,1506.91,602,1040700,1729,-255600,bfc
2024-04-15,373,626500,1679.62,673,1499600,2228,-873100,bfc
2024-04-12,363,417500,1150.14,383,566400,1479,-148900,bfc
2024-04-11,399,769100,1927.57,220,399200,1815,369900,bfc
2024-04-10,370,433700,1172.16,375,755900,2016,-322200,bfc
2024-04-09,410,585900,1429.02,338,615400,1821,-29500,bfc
2024-04-08,485,778000,1604.12,414,968400,2339,-190400,bfc
2024-04-05,925,1644800,1778.16,932,2320900,2490,-676100,bfc
2024-04-04,452,714300,1580.31,526,1253200,2383,-538900,bfc
2024-04-03,858,1888500,2201.05,1064,1848400,1737,40100,bfc
2024-04-02,657,1183900,1801.98,444,993100,2237,190800,bfc
2024-04-01,411,439700,1069.83,404,766500,1897,-326800,bfc
2024-03-29,561,1029300,1834.76,699,1438200,2058,-408900,bfc
2024-03-28,406,729100,1795.81,527,901800,1711,-172700,bfc
2024-03-27,638,951700,1491.69,329,624900,1899,326800,bfc
2024-03-26,404,621600,1538.61,475,728700,1534,-107100,bfc
2024-03-25,570,991800,1740.0,590,1217100,2063,-225300,bfc
2024-03-22,779,1188500,1525.67,707,1421400,2010,-232900,bfc
2024-03-21,423,1272700,3008.75,481,973500,2024,299200,bfc
2024-03-20,419,750900,1792.12,351,521200,1485,229700,bfc
2024-03-19,729,1312100,1799.86,278,458800,1650,853300,bfc
2024-03-18,1048,1683600,1606.49,825,2278600,2762,-595000,bfc
2024-03-15,674,818000,1213.65,390,827300,2121,-9300,bfc
2024-03-14,523,720000,1376.67,749,1292700,1726,-572700,bfc
2024-03-13,795,2088000,2626.42,517,1269700,2456,818300,bfc
2024-03-12,468,1249300,2669.44,715,1618400,2263,-369100,bfc
2024-03-11,620,2180200,3516.45,599,1520100,2538,660100,bfc
2024-03-08,703,1483500,2110.24,658,1333600,2027,149900,bfc
2024-03-07,1430,4187700,2928.46,819,2351200,2871,1836500,bfc
2024-03-06,269,497000,1847.58,320,628700,1965,-131700,bfc
2024-03-05,521,1177500,2260.08,446,800400,1795,377100,bfc
2024-03-04,641,897200,1399.69,389,1189200,3057,-292000,bfc
2024-03-01,466,710600,1524.89,394,810900,2058,-100300,bfc
2024-02-29,312,395100,1266.35,343,594200,1732,-199100,bfc
2024-02-28,761,1195400,1570.83,730,1251700,1715,-56300,bfc
2024-02-27,290,513900,1772.07,434,680000,1567,-166100,bfc
2024-02-26,287,516800,1800.7,315,445800,1415,71000,bfc
2024-02-23,375,560500,1494.67,599,922100,1539,-361600,bfc
2024-02-22,330,453700,1374.85,376,539500,1435,-85800,bfc
2024-02-21,584,821100,1405.99,498,966000,1940,-144900,bfc
2024-02-20,333,979300,2940.84,549,1125600,2050,-146300,bfc
2024-02-19,386,879500,2278.5,387,760100,1964,119400,bfc
2024-02-16,673,1099700,1634.03,356,471600,1325,628100,bfc
2024-02-15,336,340600,1013.69,137,288200,2104,52400,bfc
2024-02-07,0,0,0.0,0,0,0,0,bfc
2024-02-06,293,302600,1032.76,242,425800,1760,-123200,bfc
2024-02-05,291,276800,951.2,297,365500,1231,-88700,bfc
2024-02-02,501,707200,1411.58,243,677500,2788,29700,bfc
2024-02-01,246,522100,2122.36,221,416100,1883,106000,bfc
2024-01-31,717,877200,1223.43,482,1107500,2298,-230300,bfc
2024-01-30,412,462100,1121.6,316,479200,1516,-17100,bfc
2024-01-29,377,514600,1364.99,321,669900,2087,-155300,bfc
2024-01-26,227,312000,1374.45,311,399200,1284,-87200,bfc
2024-01-25,180,426400,2368.89,232,417300,1799,9100,bfc
2024-01-24,212,448900,2117.45,286,485500,1698,-36600,bfc
2024-01-23,317,320200,1010.09,293,310900,1061,9300,bfc
2024-01-22,229,410800,1793.89,243,367900,1514,42900,bfc
2024-01-19,218,276100,1266.51,292,273200,936,2900,bfc
2024-01-18,255,395900,1552.55,254,244300,962,151600,bfc
2024-01-17,261,302000,1157.09,278,389200,1400,-87200,bfc
2024-01-16,355,394400,1110.99,162,403100,2488,-8700,bfc
2024-01-15,204,276000,1352.94,184,289500,1573,-13500,bfc
2024-01-12,298,334700,1123.15,221,390500,1767,-55800,bfc
2024-01-11,267,343900,1288.01,268,417500,1558,-73600,bfc
2024-01-10,0,0,0.0,0,0,0,0,bfc
2024-01-09,317,830100,2618.61,420,753500,1794,76600,bfc
2024-01-08,316,550100,1740.82,378,587900,1555,-37800,bfc
2024-01-05,417,757000,1815.35,314,769300,2450,-12300,bfc
2024-01-04,526,1069800,2033.84,540,1431500,2651,-361700,bfc
2024-01-03,340,505700,1487.35,294,343500,1168,162200,bfc
2024-01-02,365,625600,1713.97,460,772100,1678,-146500,bfc
2024-09-12,0,0,0.0,0,0,0,0,bhc
2024-09-11,0,0,0.0,0,0,0,0,bhc
2024-09-10,0,0,0.0,0,0,0,0,bhc
2024-09-09,0,0,0.0,0,0,0,0,bhc
2024-09-06,10,11500,1150.0,4,3300,825,8200,bhc
2024-09-05,0,0,0.0,0,0,0,0,bhc
2024-09-04,0,0,0.0,0,0,0,0,bhc
2024-08-30,11,11000,1000.0,11,4600,418,6400,bhc
2024-08-29,0,0,0.0,0,0,0,0,bhc
2024-08-28,0,0,0.0,0,0,0,0,bhc
2024-08-27,0,0,0.0,0,0,0,0,bhc
2024-08-26,0,0,0.0,0,0,0,0,bhc
2024-08-23,11,18600,1690.91,6,7900,1317,10700,bhc
2024-08-22,0,0,0.0,0,0,0,0,bhc
2024-08-21,0,0,0.0,0,0,0,0,bhc
2024-08-20,0,0,0.0,0,0,0,0,bhc
2024-08-19,0,0,0.0,0,0,0,0,bhc
2024-08-16,8,11600,1450.0,6,9200,1533,2400,bhc
2024-08-15,0,0,0.0,0,0,0,0,bhc
2024-08-14,0,0,0.0,0,0,0,0,bhc
2024-08-13,0,0,0.0,0,0,0,0,bhc
2024-08-12,0,0,0.0,0,0,0,0,bhc
2024-08-09,6,9300,1550.0,4,12700,3175,-3400,bhc
2024-08-08,0,0,0.0,0,0,0,0,bhc
2024-08-07,0,0,0.0,0,0,0,0,bhc
2024-08-06,0,0,0.0,0,0,0,0,bhc
2024-08-05,0,0,0.0,0,0,0,0,bhc
2024-08-02,3,5200,1733.33,7,9600,1371,-4400,bhc
2024-08-01,0,0,0.0,0,0,0,0,bhc
2024-07-31,0,0,0.0,0,0,0,0,bhc
2024-07-30,0,0,0.0,0,0,0,0,bhc
2024-07-29,0,0,0.0,0,0,0,0,bhc
2024-07-26,14,24600,1757.14,9,9500,1056,15100,bhc
2024-07-25,0,0,0.0,0,0,0,0,bhc
2024-07-24,0,0,0.0,0,0,0,0,bhc
2024-07-23,0,0,0.0,0,0,0,0,bhc
2024-07-22,0,0,0.0,0,0,0,0,bhc
2024-07-19,6,900,150.0,2,6400,3200,-5500,bhc
2024-07-18,0,0,0.0,0,0,0,0,bhc
2024-07-17,0,0,0.0,0,0,0,0,bhc
2024-07-16,0,0,0.0,0,0,0,0,bhc
2024-07-15,0,0,0.0,0,0,0,0,bhc
2024-07-12,4,900,225.0,2,1900,950,-1000,bhc
2024-07-11,0,0,0.0,0,0,0,0,bhc
2024-07-10,0,0,0.0,0,0,0,0,bhc
2024-07-09,0,0,0.0,0,0,0,0,bhc
2024-07-08,0,0,0.0,0,0,0,0,bhc
2024-07-05,11,1700,154.55,10,2600,260,-900,bhc
2024-07-04,0,0,0.0,0,0,0,0,bhc
2024-07-03,0,0,0.0,0,0,0,0,bhc
2024-07-02,0,0,0.0,0,0,0,0,bhc
2024-07-01,0,0,0.0,0,0,0,0,bhc
2024-06-28,4,1000,250.0,5,2200,440,-1200,bhc
2024-06-27,0,0,0.0,0,0,0,0,bhc
2024-06-26,0,0,0.0,0,0,0,0,bhc
2024-06-25,0,0,0.0,0,0,0,0,bhc
2024-06-24,0,0,0.0,0,0,0,0,bhc
2024-06-21,13,8000,615.38,12,14000,1167,-6000,bhc
2024-06-20,0,0,0.0,0,0,0,0,bhc
2024-06-19,0,0,0.0,0,0,0,0,bhc
2024-06-18,0,0,0.0,0,0,0,0,bhc
2024-06-17,0,0,0.0,0,0,0,0,bhc
2024-06-14,13,26500,2038.46,9,7500,833,19000,bhc
2024-06-13,0,0,0.0,0,0,0,0,bhc
2024-06-12,0,0,0.0,0,0,0,0,bhc
2024-06-11,0,0,0.0,0,0,0,0,bhc
2024-06-10,0,0,0.0,0,0,0,0,bhc
2024-06-07,26,24500,942.31,13,14100,1085,10400,bhc
2024-06-06,0,0,0.0,0,0,0,0,bhc
2024-06-05,0,0,0.0,0,0,0,0,bhc
2024-06-04,0,0,0.0,0,0,0,0,bhc
2024-06-03,0,0,0.0,0,0,0,0,bhc
2024-05-31,12,8200,683.33,8,8400,1050,-200,bhc
2024-05-30,0,0,0.0,0,0,0,0,bhc
2024-05-29,0,0,0.0,0,0,0,0,bhc
2024-05-28,0,0,0.0,0,0,0,0,bhc
2024-05-27,0,0,0.0,0,0,0,0,bhc
2024-05-24,10,3300,330.0,8,6700,838,-3400,bhc
2024-05-23,0,0,0.0,0,0,0,0,bhc
2024-05-22,0,0,0.0,0,0,0,0,bhc
2024-05-21,0,0,0.0,0,0,0,0,bhc
2024-05-20,0,0,0.0,0,0,0,0,bhc
2024-05-17,2,300,150.0,2,2200,1100,-1900,bhc
2024-05-16,0,0,0.0,0,0,0,0,bhc
2024-05-15,0,0,0.0,0,0,0,0,bhc
2024-05-14,0,0,0.0,0,0,0,0,bhc
2024-05-13,0,0,0.0,0,0,0,0,bhc
2024-05-10,3,1200,400.0,5,1700,340,-500,bhc
2024-05-09,0,0,0.0,0,0,0,0,bhc
2024-05-08,0,0,0.0,0,0,0,0,bhc
2024-05-07,0,0,0.0,0,0,0,0,bhc
2024-05-06,0,0,0.0,0,0,0,0,bhc
2024-05-03,2,200,100.0,2,900,450,-700,bhc
2024-05-02,0,0,0.0,0,0,0,0,bhc
2024-04-26,0,0,0.0,1,800,800,-800,bhc
2024-04-25,0,0,0.0,0,0,0,0,bhc
2024-04-24,0,0,0.0,0,0,0,0,bhc
2024-04-23,0,0,0.0,0,0,0,0,bhc
2024-04-22,0,0,0.0,0,0,0,0,bhc
2024-04-19,0,0,0.0,2,900,450,-900,bhc
2024-04-17,0,0,0.0,0,0,0,0,bhc
2024-04-16,0,0,0.0,0,0,0,0,bhc
2024-04-15,0,0,0.0,0,0,0,0,bhc
2024-04-12,0,0,0.0,5,5700,1140,-5700,bhc
2024-04-11,0,0,0.0,0,0,0,0,bhc
2024-04-10,0,0,0.0,0,0,0,0,bhc
2024-04-09,0,0,0.0,0,0,0,0,bhc
2024-04-08,0,0,0.0,0,0,0,0,bhc
2024-04-05,4,3500,875.0,4,4800,1200,-1300,bhc
2024-04-04,0,0,0.0,0,0,0,0,bhc
2024-04-03,0,0,0.0,0,0,0,0,bhc
2024-04-02,0,0,0.0,0,0,0,0,bhc
2024-04-01,0,0,0.0,0,0,0,0,bhc
2024-03-29,2,200,100.0,2,900,450,-700,bhc
2024-03-28,0,0,0.0,0,0,0,0,bhc
2024-03-27,0,0,0.0,0,0,0,0,bhc
2024-03-26,0,0,0.0,0,0,0,0,bhc
2024-03-25,0,0,0.0,0,0,0,0,bhc
2024-03-22,3,600,200.0,5,5100,1020,-4500,bhc
2024-03-21,0,0,0.0,0,0,0,0,bhc
2024-03-20,0,0,0.0,0,0,0,0,bhc
2024-03-19,0,0,0.0,0,0,0,0,bhc
2024-03-18,0,0,0.0,0,0,0,0,bhc
2024-03-15,2,400,200.0,5,5500,1100,-5100,bhc
2024-03-14,0,0,0.0,0,0,0,0,bhc
2024-03-13,0,0,0.0,0,0,0,0,bhc
2024-03-12,0,0,0.0,0,0,0,0,bhc
2024-03-11,0,0,0.0,0,0,0,0,bhc
2024-03-08,1,100,100.0,4,1100,275,-1000,bhc
2024-03-07,0,0,0.0,0,0,0,0,bhc
2024-03-06,0,0,0.0,0,0,0,0,bhc
2024-03-05,0,0,0.0,0,0,0,0,bhc
2024-03-04,0,0,0.0,0,0,0,0,bhc
2024-03-01,3,300,100.0,4,1100,275,-800,bhc
2024-02-29,0,0,0.0,0,0,0,0,bhc
2024-02-28,0,0,0.0,0,0,0,0,bhc
2024-02-27,0,0,0.0,0,0,0,0,bhc
2024-02-26,0,0,0.0,0,0,0,0,bhc
2024-02-23,5,600,120.0,2,200,100,400,bhc
2024-02-22,0,0,0.0,0,0,0,0,bhc
2024-02-21,0,0,0.0,0,0,0,0,bhc
2024-02-20,0,0,0.0,0,0,0,0,bhc
2024-02-19,0,0,0.0,0,0,0,0,bhc
2024-02-16,4,500,125.0,3,1400,467,-900,bhc
2024-02-15,0,0,0.0,0,0,0,0,bhc
2024-02-07,0,0,0.0,0,0,0,0,bhc
2024-02-06,0,0,0.0,0,0,0,0,bhc
2024-02-05,0,0,0.0,0,0,0,0,bhc
2024-02-02,6,500,83.33,0,0,0,500,bhc
2024-02-01,0,0,0.0,0,0,0,0,bhc
2024-01-31,0,0,0.0,0,0,0,0,bhc
2024-01-30,0,0,0.0,0,0,0,0,bhc
2024-01-29,0,0,0.0,0,0,0,0,bhc
2024-01-26,4,500,125.0,1,200,200,300,bhc
2024-01-25,0,0,0.0,0,0,0,0,bhc
2024-01-24,0,0,0.0,0,0,0,0,bhc
2024-01-23,0,0,0.0,0,0,0,0,bhc
2024-01-22,0,0,0.0,0,0,0,0,bhc
2024-01-19,3,3400,1133.33,1,1200,1200,2200,bhc
2024-01-18,0,0,0.0,0,0,0,0,bhc
2024-01-17,0,0,0.0,0,0,0,0,bhc
2024-01-16,0,0,0.0,0,0,0,0,bhc
2024-01-15,0,0,0.0,0,0,0,0,bhc
2024-01-12,8,1600,200.0,3,1400,467,200,bhc
2024-01-11,0,0,0.0,0,0,0,0,bhc
2024-01-10,0,0,0.0,0,0,0,0,bhc
2024-01-09,0,0,0.0,0,0,0,0,bhc
2024-01-08,0,0,0.0,0,0,0,0,bhc
2024-01-05,9,2400,266.67,4,2300,575,100,bhc
2024-01-04,0,0,0.0,0,0,0,0,bhc
2024-01-03,0,0,0.0,0,0,0,0,bhc
2024-01-02,0,0,0.0,0,0,0,0,bhc
2024-09-12,23,8700,378.26,12,12000,1000,-3300,bhn
2024-09-11,10,3900,390.0,9,10400,1156,-6500,bhn
2024-09-10,12,5300,441.67,9,6300,700,-1000,bhn
2024-09-09,11,5200,472.73,10,8500,850,-3300,bhn
2024-09-06,18,7400,411.11,9,5700,633,1700,bhn
2024-09-05,14,6800,485.71,14,6400,457,400,bhn
2024-09-04,9,5400,600.0,15,9800,653,-4400,bhn
2024-08-30,22,9600,436.36,19,17900,942,-8300,bhn
2024-08-29,19,10600,557.89,17,14400,847,-3800,bhn
2024-08-28,12,6900,575.0,14,16300,1164,-9400,bhn
2024-08-27,32,12200,381.25,22,21000,955,-8800,bhn
2024-08-26,15,7100,473.33,17,18900,1112,-11800,bhn
2024-08-23,10,4700,470.0,17,18700,1100,-14000,bhn
2024-08-22,19,15900,836.84,27,25700,952,-9800,bhn
2024-08-21,14,12900,921.43,28,22000,786,-9100,bhn
2024-08-20,8,5200,650.0,18,18100,1006,-12900,bhn
2024-08-19,10,5100,510.0,28,18500,661,-13400,bhn
2024-08-16,8,5000,625.0,23,15400,670,-10400,bhn
2024-08-15,21,11100,528.57,24,14300,596,-3200,bhn
2024-08-14,22,9400,427.27,28,18100,646,-8700,bhn
2024-08-13,51,24300,476.47,32,23200,725,1100,bhn
2024-08-12,9,4900,544.44,17,17600,1035,-12700,bhn
2024-08-08,11,6300,572.73,12,13800,1150,-7500,bhn
2024-08-07,8,5000,625.0,11,14100,1282,-9100,bhn
2024-08-06,14,10200,728.57,17,13600,800,-3400,bhn
2024-08-05,27,10100,374.07,17,7500,441,2600,bhn
2024-08-02,23,10400,452.17,15,6100,407,4300,bhn
2024-08-01,19,10600,557.89,15,6200,413,4400,bhn
2024-07-31,16,4900,306.25,14,7300,521,-2400,bhn
2024-07-30,13,4800,369.23,13,9000,692,-4200,bhn
2024-07-29,11,2600,236.36,8,6700,838,-4100,bhn
2024-07-26,13,5100,392.31,14,7000,500,-1900,bhn
2024-07-25,12,4200,350.0,6,4600,767,-400,bhn
2024-07-24,16,8100,506.25,10,9000,900,-900,bhn
2024-07-22,13,7900,607.69,12,16100,1342,-8200,bhn
2024-07-19,16,5500,343.75,10,12800,1280,-7300,bhn
2024-07-18,15,5900,393.33,11,11700,1064,-5800,bhn
2024-07-17,15,5400,360.0,11,13400,1218,-8000,bhn
2024-07-16,16,6400,400.0,20,20800,1040,-14400,bhn
2024-07-15,15,5800,386.67,10,9800,980,-4000,bhn
2024-07-12,21,8400,400.0,16,19600,1225,-11200,bhn
2024-07-11,18,7400,411.11,15,14900,993,-7500,bhn
2024-07-10,16,5700,356.25,27,18400,681,-12700,bhn
2024-07-09,19,5600,294.74,29,27100,934,-21500,bhn
2024-07-08,20,7000,350.0,29,17900,617,-10900,bhn
2024-07-05,18,8000,444.44,26,6600,254,1400,bhn
2024-07-04,19,9600,505.26,25,13900,556,-4300,bhn
2024-07-03,16,12300,768.75,17,10000,588,2300,bhn
2024-07-02,19,13800,726.32,17,14800,871,-1000,bhn
2024-07-01,23,28300,1230.43,23,27300,1187,1000,bhn
2024-06-28,21,5400,257.14,44,21600,491,-16200,bhn
2024-06-27,16,10500,656.25,41,19900,485,-9400,bhn
2024-06-26,17,15400,905.88,30,21000,700,-5600,bhn
2024-06-25,23,12000,521.74,22,12900,586,-900,bhn
2024-06-24,22,8500,386.36,20,13800,690,-5300,bhn
2024-06-21,27,12100,448.15,26,17300,665,-5200,bhn
2024-06-20,36,11400,316.67,33,20400,618,-9000,bhn
2024-06-19,24,11600,483.33,37,26000,703,-14400,bhn
2024-06-18,35,9600,274.29,32,22100,691,-12500,bhn
2024-06-17,20,5800,290.0,24,17600,733,-11800,bhn
2024-06-14,56,20400,364.29,27,27800,1030,-7400,bhn
2024-06-13,26,23800,915.38,33,29600,897,-5800,bhn
2024-06-12,46,24300,528.26,41,26700,651,-2400,bhn
2024-06-11,38,17200,452.63,28,16600,593,600,bhn
2024-06-10,37,14500,391.89,26,19000,731,-4500,bhn
2024-06-07,43,40400,939.53,32,14300,447,26100,bhn
2024-06-06,87,73700,847.13,58,23400,403,50300,bhn
2024-06-05,110,108800,989.09,74,40000,541,68800,bhn
2024-06-04,18,8800,488.89,21,7400,352,1400,bhn
2024-06-03,38,16400,431.58,28,14000,500,2400,bhn
2024-05-31,10,3400,340.0,23,9300,404,-5900,bhn
2024-05-30,38,12100,318.42,43,18000,419,-5900,bhn
2024-05-29,47,16700,355.32,57,13300,233,3400,bhn
2024-05-28,39,14500,371.79,17,6100,359,8400,bhn
2024-05-27,28,9500,339.29,40,15400,385,-5900,bhn
2024-05-24,33,16700,506.06,49,15900,324,800,bhn
2024-05-23,45,17700,393.33,24,9400,392,8300,bhn
2024-05-22,53,20400,384.91,30,18900,630,1500,bhn
2024-05-21,23,5400,234.78,40,16500,412,-11100,bhn
2024-05-20,30,8700,290.0,33,10800,327,-2100,bhn
2024-05-17,23,7500,326.09,54,16300,302,-8800,bhn
2024-05-16,14,5300,378.57,24,12800,533,-7500,bhn
2024-05-15,24,7400,308.33,32,10300,322,-2900,bhn
2024-05-14,27,8800,325.93,43,15500,360,-6700,bhn
2024-05-13,24,8800,366.67,16,10500,656,-1700,bhn
2024-05-10,32,12500,390.62,28,5200,186,7300,bhn
2024-05-09,52,12800,246.15,40,11700,292,1100,bhn
2024-05-08,37,12100,327.03,6,2500,417,9600,bhn
2024-05-07,42,15900,378.57,29,11400,393,4500,bhn
2024-05-06,36,15400,427.78,25,14900,596,500,bhn
2024-05-03,17,8500,500.0,26,8300,319,200,bhn
2024-05-02,25,16500,660.0,23,13000,565,3500,bhn
2024-04-26,14,8500,607.14,17,8500,500,0,bhn
2024-04-25,11,6500,590.91,9,9600,1067,-3100,bhn
2024-04-24,13,9000,692.31,16,13900,869,-4900,bhn
2024-04-23,14,7800,557.14,17,16300,959,-8500,bhn
2024-04-22,12,6900,575.0,25,22900,916,-16000,bhn
2024-04-19,21,10500,500.0,28,21700,775,-11200,bhn
2024-04-17,15,5300,353.33,16,10900,681,-5600,bhn
2024-04-16,15,5700,380.0,27,16900,626,-11200,bhn
2024-04-15,22,6900,313.64,24,13300,554,-6400,bhn
2024-04-12,17,6500,382.35,14,7200,514,-700,bhn
2024-04-11,26,10600,407.69,19,8700,458,1900,bhn
2024-04-10,23,13200,573.91,81,27100,335,-13900,bhn
2024-04-09,22,8000,363.64,13,4500,346,3500,bhn
2024-04-08,24,13100,545.83,31,7500,242,5600,bhn
2024-04-05,19,11000,578.95,8,2900,362,8100,bhn
2024-04-04,26,11300,434.62,10,4900,490,6400,bhn
2024-04-03,26,8900,342.31,16,5300,331,3600,bhn
2024-04-02,27,14500,537.04,9,3200,356,11300,bhn
2024-04-01,24,8900,370.83,12,4300,358,4600,bhn
2024-03-29,24,10500,437.5,15,5000,333,5500,bhn
2024-03-28,28,15700,560.71,18,8400,467,7300,bhn
2024-03-27,30,14500,483.33,11,11000,1000,3500,bhn
2024-03-26,20,11300,565.0,25,6800,272,4500,bhn
2024-03-25,18,11000,611.11,12,6200,517,4800,bhn
2024-03-22,25,11000,440.0,13,4900,377,6100,bhn
2024-03-21,29,13200,455.17,20,10700,535,2500,bhn
2024-03-20,16,10600,662.5,12,8600,717,2000,bhn
2024-03-19,14,8100,578.57,12,6600,550,1500,bhn
2024-03-18,33,19300,584.85,31,42000,1355,-22700,bhn
2024-03-15,14,7500,535.71,20,7900,395,-400,bhn
2024-03-14,13,11200,861.54,12,10200,850,1000,bhn
2024-03-13,13,7500,576.92,14,10600,757,-3100,bhn
2024-03-12,16,9400,587.5,15,6400,427,3000,bhn
2024-03-11,35,10700,305.71,14,5900,421,4800,bhn
2024-03-08,19,11400,600.0,22,13300,605,-1900,bhn
2024-03-07,21,5400,257.14,17,6900,406,-1500,bhn
2024-03-06,26,19500,750.0,44,16100,366,3400,bhn
2024-03-05,48,18800,391.67,13,7100,546,11700,bhn
2024-03-04,29,9500,327.59,24,6200,258,3300,bhn
2024-03-01,16,5300,331.25,17,6400,376,-1100,bhn
2024-02-29,21,6000,285.71,40,15400,385,-9400,bhn
2024-02-28,19,7300,384.21,10,7500,750,-200,bhn
2024-02-27,18,5700,316.67,24,9800,408,-4100,bhn
2024-02-26,17,5200,305.88,21,10400,495,-5200,bhn
2024-02-23,20,12400,620.0,15,5400,360,7000,bhn
2024-02-22,23,10000,434.78,59,26500,449,-16500,bhn
2024-02-21,32,15100,471.88,14,6200,443,8900,bhn
2024-02-20,27,11800,437.04,22,13100,595,-1300,bhn
2024-02-19,25,7300,292.0,19,7800,411,-500,bhn
2024-02-16,22,5500,250.0,18,7400,411,-1900,bhn
2024-02-15,15,4300,286.67,19,6900,363,-2600,bhn
2024-02-07,0,0,0.0,0,0,0,0,bhn
2024-02-06,40,15700,392.5,14,8600,614,7100,bhn
2024-02-05,19,6200,326.32,31,10400,335,-4200,bhn
2024-02-02,34,13700,402.94,14,4700,336,9000,bhn
2024-02-01,17,8000,470.59,21,10400,495,-2400,bhn
2024-01-31,27,16800,622.22,20,10800,540,6000,bhn
2024-01-30,16,7200,450.0,14,6500,464,700,bhn
2024-01-29,14,3800,271.43,20,9500,475,-5700,bhn
2024-01-26,15,5000,333.33,11,7000,636,-2000,bhn
2024-01-25,23,7200,313.04,16,9800,612,-2600,bhn
2024-01-24,22,8000,363.64,18,9700,539,-1700,bhn
2024-01-23,13,4400,338.46,16,9600,600,-5200,bhn
2024-01-22,20,5500,275.0,11,5500,500,0,bhn
2024-01-19,46,16900,367.39,18,10600,589,6300,bhn
2024-01-18,27,15000,555.56,27,15900,589,-900,bhn
2024-01-17,13,5300,407.69,33,16800,509,-11500,bhn
2024-01-16,13,7200,553.85,22,9000,409,-1800,bhn
2024-01-15,17,9400,552.94,21,12500,595,-3100,bhn
2024-01-12,21,13800,657.14,25,14300,572,-500,bhn
2024-01-11,19,9800,515.79,13,14100,1085,-4300,bhn
2024-01-10,0,0,0.0,0,0,0,0,bhn
2024-01-09,18,7300,405.56,17,11800,694,-4500,bhn
2024-01-08,17,9800,576.47,18,13400,744,-3600,bhn
2024-01-05,12,6800,566.67,12,6700,558,100,bhn
2024-01-04,12,11000,916.67,20,9000,450,2000,bhn
2024-01-03,19,25000,1315.79,29,12500,431,12500,bhn
2024-01-02,47,35100,746.81,18,6000,333,29100,bhn
2024-09-12,3,500,166.67,1,100,100,400,bhp
2024-09-11,1,100,100.0,1,100,100,0,bhp
2024-09-10,2,400,200.0,1,100,100,300,bhp
2024-09-09,3,500,166.67,1,100,100,400,bhp
2024-09-06,6,44800,7466.67,3,39600,13200,5200,bhp
2024-09-05,2,400,200.0,5,1300,260,-900,bhp
2024-09-04,1,100,100.0,3,300,100,-200,bhp
2024-08-30,1,100,100.0,3,300,100,-200,bhp
2024-08-29,10,3700,370.0,3,1100,367,2600,bhp
2024-08-28,10,1500,150.0,5,700,140,800,bhp
2024-08-27,1,100,100.0,4,1300,325,-1200,bhp
2024-08-26,1,100,100.0,5,2000,400,-1900,bhp
2024-08-23,1,100,100.0,4,1700,425,-1600,bhp
2024-08-22,1,100,100.0,3,700,233,-600,bhp
2024-08-21,1,100,100.0,3,1200,400,-1100,bhp
2024-08-20,2,400,200.0,6,2300,383,-1900,bhp
2024-08-19,1,100,100.0,4,800,200,-700,bhp
2024-08-16,2,400,200.0,6,2100,350,-1700,bhp
2024-08-15,1,100,100.0,5,1700,340,-1600,bhp
2024-08-14,1,100,100.0,6,2000,333,-1900,bhp
2024-08-13,3,300,100.0,6,2100,350,-1800,bhp
2024-08-12,7,1300,185.71,6,2300,383,-1000,bhp
2024-08-09,2,200,100.0,6,2600,433,-2400,bhp
2024-08-08,5,900,180.0,7,2300,329,-1400,bhp
2024-08-07,4,1100,275.0,8,4400,550,-3300,bhp
2024-08-06,2,1100,550.0,7,4000,571,-2900,bhp
2024-08-05,6,2800,466.67,8,5800,725,-3000,bhp
2024-08-02,8,2100,262.5,4,1900,475,200,bhp
2024-08-01,4,1200,300.0,3,1600,533,-400,bhp
2024-07-31,8,9600,1200.0,4,2600,650,7000,bhp
2024-07-30,3,5300,1766.67,1,100,100,5200,bhp
2024-07-29,5,1900,380.0,1,100,100,1800,bhp
2024-07-26,12,2500,208.33,1,100,100,2400,bhp
2024-07-25,12,9300,775.0,1,100,100,9200,bhp
2024-07-24,14,7100,507.14,5,600,120,6500,bhp
2024-07-23,4,600,150.0,0,0,0,600,bhp
2024-07-22,2,600,300.0,1,300,300,300,bhp
2024-07-19,4,1200,300.0,0,0,0,1200,bhp
2024-07-18,8,1400,175.0,1,100,100,1300,bhp
2024-07-17,9,4900,544.44,0,0,0,4900,bhp
2024-07-16,20,10100,505.0,1,100,100,10000,bhp
2024-07-15,6,1300,216.67,0,0,0,1300,bhp
2024-07-12,10,6000,600.0,5,2200,440,3800,bhp
2024-07-11,9,5500,611.11,6,3100,517,2400,bhp
2024-07-10,11,2800,254.55,1,100,100,2700,bhp
2024-07-09,15,5600,373.33,1,100,100,5500,bhp
2024-07-08,21,7700,366.67,2,200,100,7500,bhp
2024-07-05,11,2600,236.36,3,300,100,2300,bhp
2024-07-04,9,11900,1322.22,0,0,0,11900,bhp
2024-07-03,13,4500,346.15,2,800,400,3700,bhp
2024-07-02,2,200,100.0,3,1300,433,-1100,bhp
2024-07-01,11,8000,727.27,4,1800,450,6200,bhp
2024-06-28,6,1300,216.67,3,1200,400,100,bhp
2024-06-27,6,700,116.67,3,1100,367,-400,bhp
2024-06-26,3,700,233.33,1,100,100,600,bhp
2024-06-25,4,1300,325.0,1,100,100,1200,bhp
2024-06-24,4,2100,525.0,1,500,500,1600,bhp
2024-06-21,2,600,300.0,0,0,0,600,bhp
2024-06-20,3,900,300.0,0,0,0,900,bhp
2024-06-19,3,900,300.0,0,0,0,900,bhp
2024-06-18,7,1100,157.14,0,0,0,1100,bhp
2024-06-17,25,5400,216.0,4,1200,300,4200,bhp
2024-06-14,2,200,100.0,2,1300,650,-1100,bhp
2024-06-13,1,100,100.0,0,0,0,100,bhp
2024-06-12,1,100,100.0,1,1000,1000,-900,bhp
2024-06-11,2,400,200.0,3,2200,733,-1800,bhp
2024-06-10,1,100,100.0,1,1000,1000,-900,bhp
2024-06-07,1,100,100.0,1,1000,1000,-900,bhp
2024-06-06,2,2000,1000.0,2,1100,550,900,bhp
2024-06-05,3,1300,433.33,2,1300,650,0,bhp
2024-06-04,3,2100,700.0,2,1300,650,800,bhp
2024-06-03,4,2700,675.0,0,0,0,2700,bhp
2024-05-31,3,2100,700.0,3,2000,667,100,bhp
2024-05-30,3,2600,866.67,1,1000,1000,1600,bhp
2024-05-29,4,2200,550.0,2,600,300,1600,bhp
2024-05-28,2,200,100.0,2,1200,600,-1000,bhp
2024-05-27,3,2100,700.0,2,1200,600,900,bhp
2024-05-24,6,3200,533.33,3,2400,800,800,bhp
2024-05-23,3,100,33.33,2,1200,600,-1100,bhp
2024-05-22,4,2300,575.0,1,200,200,2100,bhp
2024-05-21,6,7000,1166.67,4,2300,575,4700,bhp
2024-05-20,5,7000,1400.0,3,6600,2200,400,bhp
2024-05-17,3,1600,533.33,2,500,250,1100,bhp
2024-05-16,4,2100,525.0,2,1400,700,700,bhp
2024-05-15,5,6700,1340.0,10,7200,720,-500,bhp
2024-05-14,7,7700,1100.0,13,8900,685,-1200,bhp
2024-05-13,4,1800,450.0,7,4300,614,-2500,bhp
2024-05-10,5,1900,380.0,5,2200,440,-300,bhp
2024-05-09,4,1700,425.0,7,2600,371,-900,bhp
2024-05-08,4,1700,425.0,6,2100,350,-400,bhp
2024-05-07,8,2900,362.5,4,1600,400,1300,bhp
2024-05-06,5,2100,420.0,3,800,267,1300,bhp
2024-05-03,3,1200,400.0,4,700,175,500,bhp
2024-05-02,4,1700,425.0,3,1500,500,200,bhp
2024-04-26,4,1300,325.0,3,1800,600,-500,bhp
2024-04-25,11,11300,1027.27,8,11400,1425,-100,bhp
2024-04-24,6,1500,250.0,5,2500,500,-1000,bhp
2024-04-23,4,1700,425.0,3,600,200,1100,bhp
2024-04-22,5,1800,360.0,4,1800,450,0,bhp
2024-04-19,6,2000,333.33,2,500,250,1500,bhp
2024-04-17,5,2200,440.0,5,1200,240,1000,bhp
2024-04-16,5,1700,340.0,5,1700,340,0,bhp
2024-04-15,5,1800,360.0,6,1400,233,400,bhp
2024-04-12,4,1300,325.0,4,700,175,600,bhp
2024-04-11,4,1300,325.0,4,500,125,800,bhp
2024-04-10,10,13700,1370.0,10,18800,1880,-5100,bhp
2024-04-09,4,1500,375.0,6,1900,317,-400,bhp
2024-04-08,5,1700,340.0,5,1700,340,0,bhp
2024-04-05,8,6500,812.5,8,7300,912,-800,bhp
2024-04-04,6,1500,250.0,5,2300,460,-800,bhp
2024-04-03,8,1600,200.0,2,400,200,1200,bhp
2024-04-02,16,11700,731.25,14,14900,1064,-3200,bhp
2024-04-01,4,1300,325.0,5,2700,540,-1400,bhp
2024-03-29,4,1500,375.0,3,2700,900,-1200,bhp
2024-03-28,6,3200,533.33,5,3800,760,-600,bhp
2024-03-27,2,1100,550.0,4,2400,600,-1300,bhp
2024-03-26,2,1100,550.0,4,3400,850,-2300,bhp
2024-03-25,2,1100,550.0,3,3400,1133,-2300,bhp
2024-03-22,3,1200,400.0,5,3500,700,-2300,bhp
2024-03-21,5,2200,440.0,5,3500,700,-1300,bhp
2024-03-20,3,1200,400.0,2,2000,1000,-800,bhp
2024-03-19,3,1200,400.0,2,2200,1100,-1000,bhp
2024-03-18,4,1400,350.0,2,1500,750,-100,bhp
2024-03-15,3,1200,400.0,2,3400,1700,-2200,bhp
2024-03-14,4,2200,550.0,1,1200,1200,1000,bhp
2024-03-13,3,2300,766.67,3,3000,1000,-700,bhp
2024-03-12,4,2200,550.0,2,2200,1100,0,bhp
2024-03-11,3,1200,400.0,2,2200,1100,-1000,bhp
2024-03-08,4,3100,775.0,2,2000,1000,1100,bhp
2024-03-07,6,4200,700.0,9,8000,889,-3800,bhp
2024-03-06,6,1600,266.67,1,100,100,1500,bhp
2024-03-05,4,1300,325.0,1,100,100,1200,bhp
2024-03-04,9,6200,688.89,3,2100,700,4100,bhp
2024-03-01,6,6500,1083.33,5,2300,460,4200,bhp
2024-02-29,11,8900,809.09,11,3300,300,5600,bhp
2024-02-28,15,12800,853.33,3,1200,400,11600,bhp
2024-02-27,8,3300,412.5,6,112300,18717,-109000,bhp
2024-02-26,7,1800,257.14,4,1800,450,0,bhp
2024-02-23,4,1200,300.0,3,1800,600,-600,bhp
2024-02-22,5,1400,280.0,2,400,200,1000,bhp
2024-02-21,11,4200,381.82,6,3200,533,1000,bhp
2024-02-20,5,1400,280.0,1,300,300,1100,bhp
2024-02-19,5,1400,280.0,2,400,200,1000,bhp
2024-02-16,4,1400,350.0,2,400,200,1000,bhp
2024-02-15,4,1300,325.0,2,400,200,900,bhp
2024-02-07,5,1400,280.0,2,400,200,1000,bhp
2024-02-06,5,1400,280.0,3,500,167,900,bhp
2024-02-05,7,4400,628.57,4,1500,375,2900,bhp
2024-02-02,4,1300,325.0,3,500,167,800,bhp
2024-02-01,4,1300,325.0,3,400,133,900,bhp
2024-01-31,4,1300,325.0,4,1300,325,0,bhp
2024-01-30,8,3800,475.0,4,400,100,3400,bhp
2024-01-29,10,5500,550.0,10,5700,570,-200,bhp
2024-01-26,3,1200,400.0,6,3200,533,-2000,bhp
2024-01-25,3,1200,400.0,5,2300,460,-1100,bhp
2024-01-24,5,3500,700.0,5,2300,460,1200,bhp
2024-01-23,5,6900,1380.0,6,6100,1017,800,bhp
2024-01-22,4,1300,325.0,5,1400,280,-100,bhp
2024-01-19,3,1200,400.0,5,1400,280,-200,bhp
2024-01-18,3,1300,433.33,4,1300,325,0,bhp
2024-01-17,5,1400,280.0,4,1300,325,100,bhp
2024-01-16,3,1200,400.0,4,400,100,800,bhp
2024-01-15,3,1200,400.0,2,200,100,1000,bhp
2024-01-12,5,1400,280.0,4,1500,375,-100,bhp
2024-01-11,6,1700,283.33,6,2000,333,-300,bhp
2024-01-10,3,1200,400.0,1,100,100,1100,bhp
2024-01-09,3,1200,400.0,2,1900,950,-700,bhp
2024-01-08,5,1500,300.0,2,300,150,1200,bhp
2024-01-05,6,7500,1250.0,4,8000,2000,-500,bhp
2024-01-04,4,1900,475.0,2,1900,950,0,bhp
2024-01-03,5,4200,840.0,2,1100,550,3100,bhp
2024-01-02,5,2800,560.0,3,2000,667,800,bhp
2024-09-12,275,210400,765.09,258,168800,654,41600,bic
2024-09-11,281,350900,1248.75,264,377900,1431,-27000,bic
2024-09-10,324,331700,1023.77,308,316000,1026,15700,bic
2024-09-09,144,134300,932.64,195,192700,988,-58400,bic
2024-09-06,203,176100,867.49,183,182800,999,-6700,bic
2024-09-05,115,130000,1130.43,185,135700,734,-5700,bic
2024-09-04,109,157500,1444.95,150,119800,799,37700,bic
2024-08-30,163,114100,700.0,166,162200,977,-48100,bic
2024-08-29,162,190100,1173.46,159,138400,870,51700,bic
2024-08-28,218,200000,917.43,160,200900,1256,-900,bic
2024-08-27,250,158500,634.0,176,150200,853,8300,bic
2024-08-26,109,92600,849.54,191,163900,858,-71300,bic
2024-08-23,100,116400,1164.0,113,162300,1436,-45900,bic
2024-08-22,136,185400,1363.24,250,174500,698,10900,bic
2024-08-21,121,76200,629.75,123,97500,793,-21300,bic
2024-08-20,284,307300,1082.04,198,272800,1378,34500,bic
2024-08-19,153,147200,962.09,301,114900,382,32300,bic
2024-08-16,171,144300,843.86,169,136800,809,7500,bic
2024-08-15,130,131300,1010.0,88,103800,1180,27500,bic
2024-08-14,147,106300,723.13,239,103800,434,2500,bic
2024-08-13,136,132500,974.26,199,81400,409,51100,bic
2024-08-12,137,129100,942.34,73,105300,1442,23800,bic
2024-08-08,87,94400,1085.06,62,56900,918,37500,bic
2024-08-07,95,143700,1512.63,89,148400,1667,-4700,bic
2024-08-06,144,314300,2182.64,149,146600,984,167700,bic
2024-08-05,169,183000,1082.84,147,220300,1499,-37300,bic
2024-08-02,146,160400,1098.63,143,109200,764,51200,bic
2024-08-01,129,160600,1244.96,181,182100,1006,-21500,bic
2024-07-31,81,82700,1020.99,177,109400,618,-26700,bic
2024-07-30,85,68700,808.24,156,139700,896,-71000,bic
2024-07-29,92,130700,1420.65,214,200700,938,-70000,bic
2024-07-26,87,48500,557.47,94,75000,798,-26500,bic
2024-07-25,95,55700,586.32,91,80900,889,-25200,bic
2024-07-24,246,236000,959.35,235,202000,860,34000,bic
2024-07-22,208,163800,787.5,284,208300,733,-44500,bic
2024-07-19,246,258500,1050.81,203,396300,1952,-137800,bic
2024-07-18,118,157100,1331.36,103,161500,1568,-4400,bic
2024-07-17,224,214400,957.14,153,227600,1488,-13200,bic
2024-07-16,200,146900,734.5,141,169900,1205,-23000,bic
2024-07-15,242,136900,565.7,157,201000,1280,-64100,bic
2024-07-12,139,124900,898.56,118,191700,1625,-66800,bic
2024-07-11,128,147500,1152.34,119,136400,1146,11100,bic
2024-07-10,126,150500,1194.44,122,180600,1480,-30100,bic
2024-07-09,248,368200,1484.68,242,317300,1311,50900,bic
2024-07-08,119,91700,770.59,167,154100,923,-62400,bic
2024-07-05,89,114700,1288.76,148,126600,855,-11900,bic
2024-07-04,177,187900,1061.58,109,132000,1211,55900,bic
2024-07-03,254,196100,772.05,153,239100,1563,-43000,bic
2024-07-02,151,118200,782.78,116,142400,1228,-24200,bic
2024-07-01,165,138800,841.21,127,148100,1166,-9300,bic
2024-06-28,213,332500,1561.03,227,409500,1804,-77000,bic
2024-06-27,259,383700,1481.47,286,579000,2024,-195300,bic
2024-06-26,214,573500,2679.91,229,296200,1293,277300,bic
2024-06-25,113,90600,801.77,117,95600,817,-5000,bic
2024-06-24,427,518600,1214.52,323,403900,1250,114700,bic
2024-06-21,121,75600,624.79,201,126800,631,-51200,bic
2024-06-20,149,159200,1068.46,210,169600,808,-10400,bic
2024-06-19,176,163900,931.25,141,147400,1045,16500,bic
2024-06-18,194,223900,1154.12,253,302000,1194,-78100,bic
2024-06-17,329,362900,1103.04,261,249900,957,113000,bic
2024-06-14,236,253800,1075.42,281,279300,994,-25500,bic
2024-06-13,116,91100,785.34,105,109700,1045,-18600,bic
2024-06-12,132,160900,1218.94,131,184600,1409,-23700,bic
2024-06-11,150,132400,882.67,155,194700,1256,-62300,bic
2024-06-10,122,138300,1133.61,143,174000,1217,-35700,bic
2024-06-07,173,145600,841.62,178,219400,1233,-73800,bic
2024-06-06,119,100600,845.38,98,118000,1204,-17400,bic
2024-06-05,252,287900,1142.46,265,333700,1259,-45800,bic
2024-06-04,172,144500,840.12,211,211800,1004,-67300,bic
2024-06-03,124,68500,552.42,154,138000,896,-69500,bic
2024-05-31,223,166400,746.19,123,138600,1127,27800,bic
2024-05-30,334,245300,734.43,191,414800,2172,-169500,bic
2024-05-29,261,217800,834.48,168,267400,1592,-49600,bic
2024-05-28,405,424200,1047.41,420,436200,1039,-12000,bic
2024-05-27,379,409700,1081.0,286,303800,1062,105900,bic
2024-05-24,608,668300,1099.18,423,592100,1400,76200,bic
2024-05-23,431,515000,1194.9,290,428400,1477,86600,bic
2024-05-22,396,481500,1215.91,274,598300,2184,-116800,bic
2024-05-21,307,394300,1284.36,316,430100,1361,-35800,bic
2024-05-20,511,1153600,2257.53,326,475700,1459,677900,bic
2024-05-17,164,151600,924.39,141,165200,1172,-13600,bic
2024-05-16,181,337500,1864.64,180,259400,1441,78100,bic
2024-05-15,148,160900,1087.16,123,167200,1359,-6300,bic
2024-05-14,153,141000,921.57,127,134000,1055,7000,bic
2024-05-13,161,207800,1290.68,130,204000,1569,3800,bic
2024-05-10,283,274500,969.96,157,350800,2234,-76300,bic
2024-05-09,178,184600,1037.08,130,183200,1409,1400,bic
2024-05-08,175,306400,1750.86,215,291600,1356,14800,bic
2024-05-07,264,282000,1068.18,244,321400,1317,-39400,bic
2024-05-06,252,455700,1808.33,223,439500,1971,16200,bic
2024-05-03,242,428000,1768.6,241,488100,2025,-60100,bic
2024-05-02,353,899800,2549.01,280,686700,2452,213100,bic
2024-04-26,137,265900,1940.88,140,354200,2530,-88300,bic
2024-04-25,59,54900,930.51,66,97800,1482,-42900,bic
2024-04-24,58,67300,1160.34,63,112400,1784,-45100,bic
2024-04-23,90,100200,1113.33,91,145800,1602,-45600,bic
2024-04-22,52,44000,846.15,61,88700,1454,-44700,bic
2024-04-19,183,249400,1362.84,108,187400,1735,62000,bic
2024-04-17,104,112600,1082.69,72,123300,1712,-10700,bic
2024-04-16,217,308700,1422.58,243,378700,1558,-70000,bic
2024-04-15,101,159800,1582.18,101,219200,2170,-59400,bic
2024-04-12,150,260900,1739.33,161,238300,1480,22600,bic
2024-04-11,114,212700,1865.79,108,165700,1534,47000,bic
2024-04-10,142,320500,2257.04,198,491100,2480,-170600,bic
2024-04-09,148,298900,2019.59,90,183200,2036,115700,bic
2024-04-08,241,537600,2230.71,151,440400,2917,97200,bic
2024-04-05,207,413000,1995.17,164,456100,2781,-43100,bic
2024-04-04,206,536800,2605.83,232,423900,1827,112900,bic
2024-04-03,102,115300,1130.39,89,196800,2211,-81500,bic
2024-04-02,105,116700,1111.43,101,255200,2527,-138500,bic
2024-04-01,195,217600,1115.9,115,335500,2917,-117900,bic
2024-03-29,159,296800,1866.67,211,322400,1528,-25600,bic
2024-03-28,183,333200,1820.77,202,242000,1198,91200,bic
2024-03-27,125,170000,1360.0,129,148000,1147,22000,bic
2024-03-26,116,135800,1170.69,81,112800,1393,23000,bic
2024-03-25,151,116500,771.52,85,107600,1266,8900,bic
2024-03-22,171,187500,1096.49,148,172500,1166,15000,bic
2024-03-21,108,96400,892.59,160,182200,1139,-85800,bic
2024-03-20,132,136800,1036.36,80,80700,1009,56100,bic
2024-03-19,208,266600,1281.73,204,303200,1486,-36600,bic
2024-03-18,181,101100,558.56,92,122800,1335,-21700,bic
2024-03-15,155,177300,1143.87,100,151900,1519,25400,bic
2024-03-14,119,100700,846.22,153,149600,978,-48900,bic
2024-03-13,75,121500,1620.0,101,136500,1351,-15000,bic
2024-03-12,60,96000,1600.0,76,171100,2251,-75100,bic
2024-03-11,87,114000,1310.34,137,196200,1432,-82200,bic
2024-03-08,60,69800,1163.33,77,93500,1214,-23700,bic
2024-03-07,97,146800,1513.4,104,160400,1542,-13600,bic
2024-03-06,77,134400,1745.45,140,228600,1633,-94200,bic
2024-03-05,121,160600,1327.27,94,179300,1907,-18700,bic
2024-03-04,109,205200,1882.57,118,222000,1881,-16800,bic
2024-03-01,86,116200,1351.16,97,129200,1332,-13000,bic
2024-02-29,132,160900,1218.94,280,184000,657,-23100,bic
2024-02-28,95,137800,1450.53,108,142800,1322,-5000,bic
2024-02-27,140,166300,1187.86,109,161400,1481,4900,bic
2024-02-26,88,103800,1179.55,109,179200,1644,-75400,bic
2024-02-23,102,132300,1297.06,133,205500,1545,-73200,bic
2024-02-22,84,126000,1500.0,109,175800,1613,-49800,bic
2024-02-21,119,184300,1548.74,134,228100,1702,-43800,bic
2024-02-20,90,120700,1341.11,109,167200,1534,-46500,bic
2024-02-19,201,309100,1537.81,220,368500,1675,-59400,bic
2024-02-16,94,101900,1084.04,140,201500,1439,-99600,bic
2024-02-15,100,202600,2026.0,184,309800,1684,-107200,bic
2024-02-07,0,0,0.0,0,0,0,0,bic
2024-02-06,245,378000,1542.86,223,416300,1867,-38300,bic
2024-02-05,153,169400,1107.19,162,229900,1419,-60500,bic
2024-02-02,136,236100,1736.03,264,368400,1395,-132300,bic
2024-02-01,168,260500,1550.6,191,251100,1315,9400,bic
2024-01-31,300,537800,1792.67,258,457100,1772,80700,bic
2024-01-30,86,136500,1587.21,81,147300,1819,-10800,bic
2024-01-29,69,105800,1533.33,100,187200,1872,-81400,bic
2024-01-26,68,71700,1054.41,91,148800,1635,-77100,bic
2024-01-25,79,93200,1179.75,87,131100,1507,-37900,bic
2024-01-24,88,135600,1540.91,110,157400,1431,-21800,bic
2024-01-23,93,144700,1555.91,146,275200,1885,-130500,bic
2024-01-22,99,151500,1530.3,167,260700,1561,-109200,bic
2024-01-19,264,357700,1354.92,156,276000,1769,81700,bic
2024-01-18,123,214100,1740.65,175,296900,1697,-82800,bic
2024-01-17,143,402200,2812.59,113,432600,3828,-30400,bic
2024-01-16,62,94400,1522.58,121,222400,1838,-128000,bic
2024-01-15,99,244500,2469.7,178,438700,2465,-194200,bic
2024-01-12,106,306200,2888.68,126,370600,2941,-64400,bic
2024-01-11,401,555300,1384.79,309,578400,1872,-23100,bic
2024-01-10,0,0,0.0,0,0,0,0,bic
2024-01-09,154,122900,798.05,121,261100,2158,-138200,bic
2024-01-08,77,126100,1637.66,120,283800,2365,-157700,bic
2024-01-05,104,101200,973.08,126,119500,948,-18300,bic
2024-01-04,82,67300,820.73,131,104300,796,-37000,bic
2024-01-03,80,84800,1060.0,146,182800,1252,-98000,bic
2024-01-02,104,166800,1603.85,100,138000,1380,28800,bic
2024-09-12,1187,2265800,1908.85,1316,3504300,2663,-1238500,bid
2024-09-11,2302,3477200,1510.51,1111,3700100,3330,-222900,bid
2024-09-10,2831,4158900,1469.06,1279,5435300,4250,-1276400,bid
2024-09-09,1603,2677100,1670.06,1075,3005300,2796,-328200,bid
2024-09-06,2237,5136600,2296.2,1614,4169800,2584,966800,bid
2024-09-05,2347,4519400,1925.61,1604,5041100,3143,-521700,bid
2024-09-04,2798,4581900,1637.56,1420,3667900,2583,914000,bid
2024-08-30,2177,3252600,1494.07,1711,3489800,2040,-237200,bid
2024-08-29,1814,3443400,1898.24,2345,4668700,1991,-1225300,bid
2024-08-28,1528,2629000,1720.55,1419,2817200,1985,-188200,bid
2024-08-27,4395,8541800,1943.53,3394,7657300,2256,884500,bid
2024-08-26,1985,4305400,2168.97,2722,5382300,1977,-1076900,bid
2024-08-23,2011,4632700,2303.68,2225,5194100,2334,-561400,bid
2024-08-22,3545,5182000,1461.78,3324,5727500,1723,-545500,bid
2024-08-21,4859,9978400,2053.59,5142,11120000,2163,-1141600,bid
2024-08-20,3217,7333000,2279.45,4205,8905700,2118,-1572700,bid
2024-08-19,1688,4029000,2386.85,2389,4784000,2003,-755000,bid
2024-08-16,1870,4854500,2595.99,2239,4090800,1827,763700,bid
2024-08-15,1333,1985100,1489.2,1394,2734900,1962,-749800,bid
2024-08-14,1855,3643700,1964.26,2297,3881900,1690,-238200,bid
2024-08-13,1654,2229900,1348.19,1201,2341600,1950,-111700,bid
2024-08-12,1560,2666400,1709.23,1640,3192000,1946,-525600,bid
2024-08-08,1868,2904400,1554.82,1437,2869500,1997,34900,bid
2024-08-07,2331,4011700,1721.02,1565,3340800,2135,670900,bid
2024-08-06,1566,3831200,2446.49,1971,3886700,1972,-55500,bid
2024-08-05,2489,4861100,1953.03,1777,5068800,2852,-207700,bid
2024-08-02,2425,3442800,1419.71,1362,3544700,2603,-101900,bid
2024-08-01,3761,6050000,1608.61,3972,8611000,2168,-2561000,bid
2024-07-31,1727,5194200,3007.64,3279,6892300,2102,-1698100,bid
2024-07-30,1677,3329700,1985.51,1923,4723200,2456,-1393500,bid
2024-07-29,1074,2106000,1960.89,1612,2825800,1753,-719800,bid
2024-07-26,1400,3282100,2344.36,1354,2554200,1886,727900,bid
2024-07-25,2120,3507300,1654.39,1611,2847200,1767,660100,bid
2024-07-24,3514,5989900,1704.58,1840,4280100,2326,1709800,bid
2024-07-22,4242,5482100,1292.34,3448,7261200,2106,-1779100,bid
2024-07-19,2689,5592000,2079.58,2376,6464200,2721,-872200,bid
2024-07-18,2350,6227700,2650.09,2600,7184900,2763,-957200,bid
2024-07-17,4779,13437300,2811.74,7548,13191600,1748,245700,bid
2024-07-16,2579,10080700,3908.76,4981,8672500,1741,1408200,bid
2024-07-15,1851,1983300,1071.47,1279,3319200,2595,-1335900,bid
2024-07-12,2621,2524000,962.99,1229,3660100,2978,-1136100,bid
2024-07-11,1389,2354900,1695.39,1889,3052900,1616,-698000,bid
2024-07-10,1411,3405700,2413.68,2177,4995900,2295,-1590200,bid
2024-07-09,1912,4423700,2313.65,2795,5878300,2103,-1454600,bid
2024-07-08,2006,3750500,1869.64,2082,4637200,2227,-886700,bid
2024-07-05,2768,6953500,2512.1,4804,8870700,1847,-1917200,bid
2024-07-04,2308,4328300,1875.35,3048,6170200,2024,-1841900,bid
2024-07-03,3172,6658700,2099.21,4449,8341100,1875,-1682400,bid
2024-07-02,3122,6298700,2017.52,3439,5749900,1672,548800,bid
2024-07-01,2153,2977400,1382.91,1506,2617600,1738,359800,bid
2024-06-28,3084,3950600,1281.0,1897,4164700,2195,-214100,bid
2024-06-27,2013,3218300,1598.76,2169,2720200,1254,498100,bid
2024-06-26,2476,3687800,1489.42,1499,3121000,2082,566800,bid
2024-06-25,3765,5261700,1397.53,2050,5659800,2761,-398100,bid
2024-06-24,2542,3180300,1251.1,3281,3887900,1185,-707600,bid
2024-06-21,2260,3665500,1621.9,2534,2966200,1171,699300,bid
2024-06-20,4031,4666900,1157.75,2189,4826700,2205,-159800,bid
2024-06-19,3833,4647700,1212.55,1878,4044700,2154,603000,bid
2024-06-18,2465,2614600,1060.69,2212,2742600,1240,-128000,bid
2024-06-17,4128,4157200,1007.07,2199,4513800,2053,-356600,bid
2024-06-14,2669,3293300,1233.91,2811,4918700,1750,-1625400,bid
2024-06-13,1878,4471800,2381.15,2778,4593600,1654,-121800,bid
2024-06-12,3933,4660000,1184.85,2276,4032400,1772,627600,bid
2024-06-11,3817,4656600,1219.96,1773,4726600,2666,-70000,bid
2024-06-10,2070,3410700,1647.68,1861,4285000,2303,-874300,bid
2024-06-07,1842,2200400,1194.57,1432,2710900,1893,-510500,bid
2024-06-06,1560,2625800,1683.21,1539,2859200,1858,-233400,bid
2024-06-05,2185,3452900,1580.27,2093,3577000,1709,-124100,bid
2024-06-04,1776,2345500,1320.66,1491,3041800,2040,-696300,bid
2024-06-03,2230,3038100,1362.38,1840,3356700,1824,-318600,bid
2024-05-31,2623,3062300,1167.48,1290,3605900,2795,-543600,bid
2024-05-30,3862,3607600,934.13,2141,3223000,1505,384600,bid
2024-05-29,2117,2214700,1046.15,1287,2867200,2228,-652500,bid
2024-05-28,2360,2543500,1077.75,1051,2406400,2290,137100,bid
2024-05-27,1744,1439000,825.11,727,1943900,2674,-504900,bid
2024-05-24,2316,4300000,1856.65,2347,5179600,2207,-879600,bid
2024-05-23,1962,2873300,1464.48,1488,3642500,2448,-769200,bid
2024-05-22,1880,4506900,2397.29,2532,5923800,2340,-1416900,bid
2024-05-21,1437,3118400,2170.08,1949,4304700,2209,-1186300,bid
2024-05-20,1438,3570900,2483.24,2628,4928300,1875,-1357400,bid
2024-05-17,2263,2953200,1304.99,2131,2777500,1303,175700,bid
2024-05-16,1866,4479900,2400.8,3279,4499200,1372,-19300,bid
2024-05-15,1686,3212500,1905.4,2130,2073900,974,1138600,bid
2024-05-14,2697,3602700,1335.82,1800,2984800,1658,617900,bid
2024-05-13,2215,2729900,1232.46,1429,2921300,2044,-191400,bid
2024-05-10,1810,1861300,1028.34,960,2379300,2478,-518000,bid
2024-05-09,1460,1946600,1333.29,1211,2882400,2380,-935800,bid
2024-05-08,1509,2184200,1447.45,1761,2651500,1506,-467300,bid
2024-05-07,1149,1997900,1738.82,1412,2568700,1819,-570800,bid
2024-05-06,1041,2668400,2563.3,1560,2716200,1741,-47800,bid
2024-05-03,924,1341900,1452.27,1082,2056300,1900,-714400,bid
2024-05-02,1077,1140700,1059.15,930,1381600,1486,-240900,bid
2024-04-26,1398,1673900,1197.35,1163,1960000,1685,-286100,bid
2024-04-25,1036,1969200,1900.77,1673,2713100,1622,-743900,bid
2024-04-24,1282,2588700,2019.27,1818,2838400,1561,-249700,bid
2024-04-23,1828,3301200,1805.91,2365,4308600,1822,-1007400,bid
2024-04-22,1027,2480000,2414.8,1222,2108800,1726,371200,bid
2024-04-19,2258,4407800,1952.08,2098,4044200,1928,363600,bid
2024-04-17,2443,3728900,1526.36,1314,5009800,3813,-1280900,bid
2024-04-16,3482,5987100,1719.44,2179,4057700,1862,1929400,bid
2024-04-15,2275,3536800,1554.64,1654,4051100,2449,-514300,bid
2024-04-12,2235,5449700,2438.34,3090,5521200,1787,-71500,bid
2024-04-11,1668,3907000,2342.33,2453,5000000,2038,-1093000,bid
2024-04-10,1649,1881600,1141.06,1865,3373600,1809,-1492000,bid
2024-04-09,1216,2781000,2287.01,1689,3162100,1872,-381100,bid
2024-04-08,1370,2233400,1630.22,1502,2742800,1826,-509400,bid
2024-04-05,2347,2670400,1137.79,1539,3007200,1954,-336800,bid
2024-04-04,1477,1979100,1339.95,1281,2218900,1732,-239800,bid
2024-04-03,1609,2559900,1590.99,1672,2756300,1649,-196400,bid
2024-04-02,1980,3006500,1518.43,1271,2479400,1951,527100,bid
2024-04-01,1921,2418300,1258.88,1732,3063700,1769,-645400,bid
2024-03-29,2604,3805300,1461.33,1425,3465300,2432,340000,bid
2024-03-28,1870,2929400,1566.52,1588,3425400,2157,-496000,bid
2024-03-27,2376,2821900,1187.67,1215,3022900,2488,-201000,bid
2024-03-26,1579,2671000,1691.58,1081,2895300,2678,-224300,bid
2024-03-25,1946,2413400,1240.18,1536,2658900,1731,-245500,bid
2024-03-22,3925,8817600,2246.52,4199,7895800,1880,921800,bid
2024-03-21,1635,3320000,2030.58,1785,3850000,2157,-530000,bid
2024-03-20,3013,5933300,1969.23,3255,5016000,1541,917300,bid
2024-03-19,1258,1558800,1239.11,1104,2076900,1881,-518100,bid
2024-03-18,2441,2850900,1167.92,1856,3224900,1738,-374000,bid
2024-03-15,2120,2870800,1354.15,1287,2896200,2250,-25400,bid
2024-03-14,2350,2895700,1232.21,1678,3867800,2305,-972100,bid
2024-03-13,1502,2722400,1812.52,1254,2905500,2317,-183100,bid
2024-03-12,1739,3454500,1986.49,1495,2558200,1711,896300,bid
2024-03-11,1964,3487300,1775.61,1238,2840700,2295,646600,bid
2024-03-08,3902,6831900,1750.87,1254,4353100,3471,2478800,bid
2024-03-07,2568,3221200,1254.36,2096,4020200,1918,-799000,bid
2024-03-06,1203,2430600,2020.45,1336,3359100,2514,-928500,bid
2024-03-05,1381,2039900,1477.12,1256,2382600,1897,-342700,bid
2024-03-04,2110,4241700,2010.28,1823,4118300,2259,123400,bid
2024-03-01,1959,2291600,1169.78,1166,2580200,2213,-288600,bid
2024-02-29,1458,2188800,1501.23,1473,2469800,1677,-281000,bid
2024-02-28,2160,3980000,1842.59,2242,4786600,2135,-806600,bid
2024-02-27,862,2317400,2688.4,1493,2823300,1891,-505900,bid
2024-02-26,1146,3702600,3230.89,1386,2614000,1886,1088600,bid
2024-02-23,3446,11548200,3351.19,3337,8922600,2674,2625600,bid
2024-02-22,1184,2769200,2338.85,1322,2692400,2037,76800,bid
2024-02-21,1321,3760500,2846.71,1725,3217200,1865,543300,bid
2024-02-20,1159,2534900,2187.14,1759,3022200,1718,-487300,bid
2024-02-19,2301,5578500,2424.38,3336,4954200,1485,624300,bid
2024-02-16,2238,2194600,980.61,1219,2653500,2177,-458900,bid
2024-02-15,1801,2649200,1470.96,1407,3198900,2274,-549700,bid
2024-02-07,0,0,0.0,0,0,0,0,bid
2024-02-06,1571,2707000,1723.11,1424,2630200,1847,76800,bid
2024-02-05,2110,5376900,2548.29,2332,4401900,1888,975000,bid
2024-02-02,2154,3166300,1469.96,1762,3947600,2240,-781300,bid
2024-02-01,1888,3139800,1663.03,1872,2501200,1336,638600,bid
2024-01-31,2058,3115400,1513.8,1702,3028000,1779,87400,bid
2024-01-30,1499,2579400,1720.75,1402,2101200,1499,478200,bid
2024-01-29,1102,2194000,1990.93,1335,1924800,1442,269200,bid
2024-01-26,904,1542700,1706.53,1092,1905300,1745,-362600,bid
2024-01-25,1118,2292900,2050.89,1784,2485100,1393,-192200,bid
2024-01-24,1921,3018800,1571.47,1797,3012300,1676,6500,bid
2024-01-23,1673,3317600,1983.02,2273,3316400,1459,1200,bid
2024-01-22,1661,3554600,2140.04,1876,4528100,2414,-973500,bid
2024-01-19,2346,7920900,3376.34,3066,4378300,1428,3542600,bid
2024-01-18,1265,3784900,2992.02,2050,3576100,1744,208800,bid
2024-01-17,1410,2376800,1685.67,1975,3487300,1766,-1110500,bid
2024-01-16,726,1755100,2417.49,1527,2846900,1864,-1091800,bid
2024-01-15,1041,2648900,2544.57,1756,3349500,1907,-700600,bid
2024-01-12,2185,5690500,2604.35,2730,6699400,2454,-1008900,bid
2024-01-11,2171,4641400,2137.91,3585,6224700,1736,-1583300,bid
2024-01-10,0,0,0.0,0,0,0,0,bid
2024-01-09,1073,2437500,2271.67,1332,2930400,2200,-492900,bid
2024-01-08,1125,3460700,3076.18,1794,2990300,1667,470400,bid
2024-01-05,1235,2900200,2348.34,1396,2246300,1609,653900,bid
2024-01-04,1723,4100500,2379.86,2010,4921500,2449,-821000,bid
2024-01-03,796,2589800,3253.52,1854,2314900,1249,274900,bid
2024-01-02,805,1680700,2087.83,994,2136300,2149,-455600,bid
2024-09-12,0,0,0.0,0,0,0,0,bii
2024-09-11,0,0,0.0,0,0,0,0,bii
2024-09-10,0,0,0.0,0,0,0,0,bii
2024-09-09,0,0,0.0,0,0,0,0,bii
2024-09-06,143,1825300,12764.34,90,809100,8990,1016200,bii
2024-09-05,0,0,0.0,0,0,0,0,bii
2024-09-04,0,0,0.0,0,0,0,0,bii
2024-08-30,116,823000,7094.83,97,892300,9199,-69300,bii
2024-08-29,0,0,0.0,0,0,0,0,bii
2024-08-28,0,0,0.0,0,0,0,0,bii
2024-08-27,0,0,0.0,0,0,0,0,bii
2024-08-26,0,0,0.0,0,0,0,0,bii
2024-08-23,144,1009900,7013.19,117,1092500,9338,-82600,bii
2024-08-22,0,0,0.0,0,0,0,0,bii
2024-08-21,0,0,0.0,0,0,0,0,bii
2024-08-20,0,0,0.0,0,0,0,0,bii
2024-08-19,0,0,0.0,0,0,0,0,bii
2024-08-16,167,1110100,6647.31,136,981200,7215,128900,bii
2024-08-15,0,0,0.0,0,0,0,0,bii
2024-08-14,0,0,0.0,0,0,0,0,bii
2024-08-13,0,0,0.0,0,0,0,0,bii
2024-08-12,0,0,0.0,0,0,0,0,bii
2024-08-09,122,1002400,8216.39,118,1083200,9180,-80800,bii
2024-08-08,0,0,0.0,0,0,0,0,bii
2024-08-07,0,0,0.0,0,0,0,0,bii
2024-08-06,0,0,0.0,0,0,0,0,bii
2024-08-05,0,0,0.0,0,0,0,0,bii
2024-08-02,116,1243900,10723.28,138,1021300,7401,222600,bii
2024-08-01,0,0,0.0,0,0,0,0,bii
2024-07-31,0,0,0.0,0,0,0,0,bii
2024-07-30,0,0,0.0,0,0,0,0,bii
2024-07-29,0,0,0.0,0,0,0,0,bii
2024-07-26,106,1661000,15669.81,161,1381900,8583,279100,bii
2024-07-25,0,0,0.0,0,0,0,0,bii
2024-07-24,0,0,0.0,0,0,0,0,bii
2024-07-23,0,0,0.0,0,0,0,0,bii
2024-07-22,0,0,0.0,0,0,0,0,bii
2024-07-19,120,1316200,10968.33,135,1094600,8108,221600,bii
2024-07-18,0,0,0.0,0,0,0,0,bii
2024-07-17,0,0,0.0,0,0,0,0,bii
2024-07-16,0,0,0.0,0,0,0,0,bii
2024-07-15,0,0,0.0,0,0,0,0,bii
2024-07-12,157,1546700,9851.59,141,864000,6128,682700,bii
2024-07-11,0,0,0.0,0,0,0,0,bii
2024-07-10,0,0,0.0,0,0,0,0,bii
2024-07-09,0,0,0.0,0,0,0,0,bii
2024-07-08,0,0,0.0,0,0,0,0,bii
2024-07-05,191,1935700,10134.55,165,1362000,8255,573700,bii
2024-07-04,0,0,0.0,0,0,0,0,bii
2024-07-03,0,0,0.0,0,0,0,0,bii
2024-07-02,0,0,0.0,0,0,0,0,bii
2024-07-01,0,0,0.0,0,0,0,0,bii
2024-06-28,137,1098700,8019.71,169,1498300,8866,-399600,bii
2024-06-27,0,0,0.0,0,0,0,0,bii
2024-06-26,0,0,0.0,0,0,0,0,bii
2024-06-25,0,0,0.0,0,0,0,0,bii
2024-06-24,0,0,0.0,0,0,0,0,bii
2024-06-21,212,1981100,9344.81,214,1941500,9072,39600,bii
2024-06-20,0,0,0.0,0,0,0,0,bii
2024-06-19,0,0,0.0,0,0,0,0,bii
2024-06-18,0,0,0.0,0,0,0,0,bii
2024-06-17,0,0,0.0,0,0,0,0,bii
2024-06-14,211,1786500,8466.82,233,1976600,8483,-190100,bii
2024-06-13,0,0,0.0,0,0,0,0,bii
2024-06-12,0,0,0.0,0,0,0,0,bii
2024-06-11,0,0,0.0,0,0,0,0,bii
2024-06-10,0,0,0.0,0,0,0,0,bii
2024-06-07,236,1719800,7287.29,253,2246200,8878,-526400,bii
2024-06-06,0,0,0.0,0,0,0,0,bii
2024-06-05,0,0,0.0,0,0,0,0,bii
2024-06-04,0,0,0.0,0,0,0,0,bii
2024-06-03,0,0,0.0,0,0,0,0,bii
2024-05-31,253,2593600,10251.38,249,1598300,6419,995300,bii
2024-05-30,0,0,0.0,0,0,0,0,bii
2024-05-29,0,0,0.0,0,0,0,0,bii
2024-05-28,0,0,0.0,0,0,0,0,bii
2024-05-27,0,0,0.0,0,0,0,0,bii
2024-05-24,202,1099300,5442.08,223,1925800,8636,-826500,bii
2024-05-23,0,0,0.0,0,0,0,0,bii
2024-05-22,0,0,0.0,0,0,0,0,bii
2024-05-21,0,0,0.0,0,0,0,0,bii
2024-05-20,0,0,0.0,0,0,0,0,bii
2024-05-17,252,1971100,7821.83,223,1854800,8317,116300,bii
2024-05-16,0,0,0.0,0,0,0,0,bii
2024-05-15,0,0,0.0,0,0,0,0,bii
2024-05-14,0,0,0.0,0,0,0,0,bii
2024-05-13,0,0,0.0,0,0,0,0,bii
2024-05-10,217,1567300,7222.58,167,1216000,7281,351300,bii
2024-05-09,0,0,0.0,0,0,0,0,bii
2024-05-08,0,0,0.0,0,0,0,0,bii
2024-05-07,0,0,0.0,0,0,0,0,bii
2024-05-06,0,0,0.0,0,0,0,0,bii
2024-05-03,270,2293800,8495.56,146,735100,5035,1558700,bii
2024-05-02,0,0,0.0,0,0,0,0,bii
2024-04-26,206,2007300,9744.17,135,772600,5723,1234700,bii
2024-04-25,0,0,0.0,0,0,0,0,bii
2024-04-24,0,0,0.0,0,0,0,0,bii
2024-04-23,0,0,0.0,0,0,0,0,bii
2024-04-22,0,0,0.0,0,0,0,0,bii
2024-04-19,246,2078000,8447.15,205,2276100,11103,-198100,bii
2024-04-17,0,0,0.0,0,0,0,0,bii
2024-04-16,0,0,0.0,0,0,0,0,bii
2024-04-15,0,0,0.0,0,0,0,0,bii
2024-04-12,217,1717400,7914.29,149,2035000,13658,-317600,bii
2024-04-11,0,0,0.0,0,0,0,0,bii
2024-04-10,0,0,0.0,0,0,0,0,bii
2024-04-09,0,0,0.0,0,0,0,0,bii
2024-04-08,0,0,0.0,0,0,0,0,bii
2024-04-05,246,1408100,5723.98,154,2207400,14334,-799300,bii
2024-04-04,0,0,0.0,0,0,0,0,bii
2024-04-03,0,0,0.0,0,0,0,0,bii
2024-04-02,0,0,0.0,0,0,0,0,bii
2024-04-01,0,0,0.0,0,0,0,0,bii
2024-03-29,196,1841800,9396.94,185,1925200,10406,-83400,bii
2024-03-28,0,0,0.0,0,0,0,0,bii
2024-03-27,0,0,0.0,0,0,0,0,bii
2024-03-26,0,0,0.0,0,0,0,0,bii
2024-03-25,0,0,0.0,0,0,0,0,bii
2024-03-22,311,2087100,6710.93,217,1895300,8734,191800,bii
2024-03-21,0,0,0.0,0,0,0,0,bii
2024-03-20,0,0,0.0,0,0,0,0,bii
2024-03-19,0,0,0.0,0,0,0,0,bii
2024-03-18,0,0,0.0,0,0,0,0,bii
2024-03-15,265,1400000,5283.02,238,2652500,11145,-1252500,bii
2024-03-14,0,0,0.0,0,0,0,0,bii
2024-03-13,0,0,0.0,0,0,0,0,bii
2024-03-12,0,0,0.0,0,0,0,0,bii
2024-03-11,0,0,0.0,0,0,0,0,bii
2024-03-08,251,1491500,5942.23,291,3494100,12007,-2002600,bii
2024-03-07,0,0,0.0,0,0,0,0,bii
2024-03-06,0,0,0.0,0,0,0,0,bii
2024-03-05,0,0,0.0,0,0,0,0,bii
2024-03-04,0,0,0.0,0,0,0,0,bii
2024-03-01,487,3112300,6390.76,208,2536400,12194,575900,bii
2024-02-29,0,0,0.0,0,0,0,0,bii
2024-02-28,0,0,0.0,0,0,0,0,bii
2024-02-27,0,0,0.0,0,0,0,0,bii
2024-02-26,0,0,0.0,0,0,0,0,bii
2024-02-23,371,4347200,11717.52,324,1889200,5831,2458000,bii
2024-02-22,0,0,0.0,0,0,0,0,bii
2024-02-21,0,0,0.0,0,0,0,0,bii
2024-02-20,0,0,0.0,0,0,0,0,bii
2024-02-19,0,0,0.0,0,0,0,0,bii
2024-02-16,188,1258900,6696.28,207,1734000,8377,-475100,bii
2024-02-15,0,0,0.0,0,0,0,0,bii
2024-02-07,0,0,0.0,0,0,0,0,bii
2024-02-06,0,0,0.0,0,0,0,0,bii
2024-02-05,0,0,0.0,0,0,0,0,bii
2024-02-02,161,1885500,11711.18,268,2430500,9069,-545000,bii
2024-02-01,0,0,0.0,0,0,0,0,bii
2024-01-31,0,0,0.0,0,0,0,0,bii
2024-01-30,0,0,0.0,0,0,0,0,bii
2024-01-29,0,0,0.0,0,0,0,0,bii
2024-01-26,232,2202500,9493.53,292,2509600,8595,-307100,bii
2024-01-25,0,0,0.0,0,0,0,0,bii
2024-01-24,0,0,0.0,0,0,0,0,bii
2024-01-23,0,0,0.0,0,0,0,0,bii
2024-01-22,0,0,0.0,0,0,0,0,bii
2024-01-19,196,2266000,11561.22,234,1278100,5462,987900,bii
2024-01-18,0,0,0.0,0,0,0,0,bii
2024-01-17,0,0,0.0,0,0,0,0,bii
2024-01-16,0,0,0.0,0,0,0,0,bii
2024-01-15,0,0,0.0,0,0,0,0,bii
2024-01-12,195,2187900,11220.0,184,1587900,8630,600000,bii
2024-01-11,0,0,0.0,0,0,0,0,bii
2024-01-10,0,0,0.0,0,0,0,0,bii
2024-01-09,0,0,0.0,0,0,0,0,bii
2024-01-08,0,0,0.0,0,0,0,0,bii
2024-01-05,283,2912100,10290.11,181,1536100,8487,1376000,bii
2024-01-04,0,0,0.0,0,0,0,0,bii
2024-01-03,0,0,0.0,0,0,0,0,bii
2024-01-02,0,0,0.0,0,0,0,0,bii
2024-09-12,3,1000,333.33,10,7500,750,-6500,bkc
2024-09-11,11,3200,290.91,12,9800,817,-6600,bkc
2024-09-10,5,1700,340.0,9,6600,733,-4900,bkc
2024-09-09,11,2600,236.36,10,7800,780,-5200,bkc
2024-09-06,6,1100,183.33,10,6000,600,-4900,bkc
2024-09-05,6,1300,216.67,10,5700,570,-4400,bkc
2024-09-04,7,1100,157.14,7,6300,900,-5200,bkc
2024-08-30,6,600,100.0,12,5400,450,-4800,bkc
2024-08-29,7,1200,171.43,15,5800,387,-4600,bkc
2024-08-28,23,3700,160.87,13,7100,546,-3400,bkc
2024-08-27,15,3900,260.0,17,8700,512,-4800,bkc
2024-08-26,13,2500,192.31,13,5500,423,-3000,bkc
2024-08-23,12,2400,200.0,12,7200,600,-4800,bkc
2024-08-22,6,1200,200.0,13,5600,431,-4400,bkc
2024-08-21,6,700,116.67,16,6900,431,-6200,bkc
2024-08-20,10,2700,270.0,12,7000,583,-4300,bkc
2024-08-19,20,5300,265.0,14,8300,593,-3000,bkc
2024-08-16,10,2400,240.0,14,6600,471,-4200,bkc
2024-08-15,3,600,200.0,8,4600,575,-4000,bkc
2024-08-14,3,1500,500.0,9,7100,789,-5600,bkc
2024-08-13,5,1200,240.0,11,6100,555,-4900,bkc
2024-08-12,2,500,250.0,9,4800,533,-4300,bkc
2024-08-09,1,200,200.0,7,4500,643,-4300,bkc
2024-08-08,5,900,180.0,8,4800,600,-3900,bkc
2024-08-07,5,1200,240.0,9,5300,589,-4100,bkc
2024-08-06,7,2900,414.29,9,6200,689,-3300,bkc
2024-08-05,3,1000,333.33,10,3200,320,-2200,bkc
2024-08-02,4,1200,300.0,9,6800,756,-5600,bkc
2024-08-01,7,2400,342.86,11,6100,555,-3700,bkc
2024-07-31,10,5200,520.0,13,7600,585,-2400,bkc
2024-07-30,6,1600,266.67,12,6200,517,-4600,bkc
2024-07-29,6,1600,266.67,13,6300,485,-4700,bkc
2024-07-26,12,16300,1358.33,12,6900,575,9400,bkc
2024-07-25,8,2800,350.0,12,6900,575,-4100,bkc
2024-07-24,9,4400,488.89,11,8400,764,-4000,bkc
2024-07-23,11,3900,354.55,11,6600,600,-2700,bkc
2024-07-22,4,1300,325.0,17,10700,629,-9400,bkc
2024-07-19,8,2500,312.5,19,12600,663,-10100,bkc
2024-07-18,12,3200,266.67,10,7600,760,-4400,bkc
2024-07-17,27,10100,374.07,24,13400,558,-3300,bkc
2024-07-16,7,2200,314.29,9,7900,878,-5700,bkc
2024-07-15,9,2800,311.11,21,11400,543,-8600,bkc
2024-07-12,5,1300,260.0,12,7600,633,-6300,bkc
2024-07-11,8,1500,187.5,12,8300,692,-6800,bkc
2024-07-10,5,1900,380.0,9,6700,744,-4800,bkc
2024-07-09,10,8700,870.0,10,8100,810,600,bkc
2024-07-08,8,8600,1075.0,13,7100,546,1500,bkc
2024-07-05,17,23400,1376.47,17,9700,571,13700,bkc
2024-07-04,23,19400,843.48,22,21200,964,-1800,bkc
2024-07-03,27,29300,1085.19,17,15600,918,13700,bkc
2024-07-02,35,18500,528.57,26,23500,904,-5000,bkc
2024-07-01,36,20600,572.22,21,16000,762,4600,bkc
2024-06-28,26,24000,923.08,20,17800,890,6200,bkc
2024-06-27,26,23400,900.0,19,17700,932,5700,bkc
2024-06-26,30,35500,1183.33,31,34400,1110,1100,bkc
2024-06-25,52,33000,634.62,59,55000,932,-22000,bkc
2024-06-24,34,46100,1355.88,16,9600,600,36500,bkc
2024-06-21,182,129000,708.79,15,56400,3760,72600,bkc
2024-06-20,6,2500,416.67,10,5500,550,-3000,bkc
2024-06-19,5,1500,300.0,8,4400,550,-2900,bkc
2024-06-18,8,2000,250.0,7,4900,700,-2900,bkc
2024-06-17,7,2300,328.57,7,3900,557,-1600,bkc
2024-06-14,13,2700,207.69,11,7600,691,-4900,bkc
2024-06-13,20,5800,290.0,12,7000,583,-1200,bkc
2024-06-12,5,2500,500.0,7,3500,500,-1000,bkc
2024-06-11,4,1800,450.0,9,5300,589,-3500,bkc
2024-06-10,14,4100,292.86,8,7000,875,-2900,bkc
2024-06-07,22,10600,481.82,12,10100,842,500,bkc
2024-06-06,7,3900,557.14,7,3200,457,700,bkc
2024-06-05,13,4900,376.92,11,4500,409,400,bkc
2024-06-04,15,4500,300.0,7,3400,486,1100,bkc
2024-06-03,13,3900,300.0,10,4000,400,-100,bkc
2024-05-31,7,1400,200.0,9,4000,444,-2600,bkc
2024-05-30,8,2400,300.0,9,4300,478,-1900,bkc
2024-05-29,6,2000,333.33,8,3800,475,-1800,bkc
2024-05-28,6,1700,283.33,10,8800,880,-7100,bkc
2024-05-27,5,1800,360.0,9,4500,500,-2700,bkc
2024-05-24,6,3400,566.67,13,7100,546,-3700,bkc
2024-05-23,10,5800,580.0,11,4700,427,1100,bkc
2024-05-22,21,8700,414.29,22,8800,400,-100,bkc
2024-05-21,13,4400,338.46,13,6200,477,-1800,bkc
2024-05-20,17,4500,264.71,14,5300,379,-800,bkc
2024-05-17,21,8200,390.48,22,9800,445,-1600,bkc
2024-05-16,10,3300,330.0,11,4800,436,-1500,bkc
2024-05-15,22,7400,336.36,11,4400,400,3000,bkc
2024-05-14,19,9800,515.79,10,6900,690,2900,bkc
2024-05-13,20,11900,595.0,12,11600,967,300,bkc
2024-05-10,4,1200,300.0,8,2900,362,-1700,bkc
2024-05-09,10,2300,230.0,17,3500,206,-1200,bkc
2024-05-08,6,1100,183.33,5,1700,340,-600,bkc
2024-05-07,12,2800,233.33,12,3600,300,-800,bkc
2024-05-06,8,1900,237.5,9,1600,178,300,bkc
2024-05-03,7,2800,400.0,15,3600,240,-800,bkc
2024-05-02,3,1100,366.67,5,1100,220,0,bkc
2024-04-26,2,1000,500.0,4,1000,250,0,bkc
2024-04-25,5,1400,280.0,7,3000,429,-1600,bkc
2024-04-24,4,600,150.0,7,2800,400,-2200,bkc
2024-04-23,1,200,200.0,8,3400,425,-3200,bkc
2024-04-22,2,600,300.0,6,1600,267,-1000,bkc
2024-04-19,3,1400,466.67,7,1800,257,-400,bkc
2024-04-17,4,1900,475.0,5,1300,260,600,bkc
2024-04-16,2,1600,800.0,8,900,112,700,bkc
2024-04-15,10,8700,870.0,11,4900,445,3800,bkc
2024-04-12,5,2300,460.0,7,1300,186,1000,bkc
2024-04-11,8,3600,450.0,8,2800,350,800,bkc
2024-04-10,8,2600,325.0,5,900,180,1700,bkc
2024-04-09,13,4500,346.15,9,3300,367,1200,bkc
2024-04-08,10,3500,350.0,10,5000,500,-1500,bkc
2024-04-05,11,5800,527.27,12,6900,575,-1100,bkc
2024-04-04,12,5000,416.67,12,5800,483,-800,bkc
2024-04-03,12,4500,375.0,7,4300,614,200,bkc
2024-04-02,12,5400,450.0,5,4300,860,1100,bkc
2024-04-01,18,5800,322.22,12,5600,467,200,bkc
2024-03-29,13,4800,369.23,10,2500,250,2300,bkc
2024-03-28,7,4900,700.0,10,3200,320,1700,bkc
2024-03-27,25,7500,300.0,15,7000,467,500,bkc
2024-03-26,24,3300,137.5,23,3400,148,-100,bkc
2024-03-25,16,4300,268.75,13,6500,500,-2200,bkc
2024-03-22,11,1800,163.64,8,2200,275,-400,bkc
2024-03-21,4,1600,400.0,8,1700,212,-100,bkc
2024-03-20,5,1300,260.0,9,1900,211,-600,bkc
2024-03-19,9,1500,166.67,14,4400,314,-2900,bkc
2024-03-18,15,4800,320.0,13,3200,246,1600,bkc
2024-03-15,13,3800,292.31,12,2700,225,1100,bkc
2024-03-14,11,2900,263.64,12,2900,242,0,bkc
2024-03-13,3,400,133.33,7,2600,371,-2200,bkc
2024-03-12,1,200,200.0,7,1600,229,-1400,bkc
2024-03-11,3,900,300.0,7,1700,243,-800,bkc
2024-03-08,3,900,300.0,5,700,140,200,bkc
2024-03-07,3,700,233.33,7,1500,214,-800,bkc
2024-03-06,8,1800,225.0,5,900,180,900,bkc
2024-03-05,8,1500,187.5,9,2700,300,-1200,bkc
2024-03-04,14,2400,171.43,12,2800,233,-400,bkc
2024-03-01,5,800,160.0,10,2600,260,-1800,bkc
2024-02-29,12,5800,483.33,8,1900,238,3900,bkc
2024-02-28,6,400,66.67,11,2400,218,-2000,bkc
2024-02-27,13,4800,369.23,8,4400,550,400,bkc
2024-02-26,3,300,100.0,7,6400,914,-6100,bkc
2024-02-23,9,1700,188.89,14,11000,786,-9300,bkc
2024-02-22,1,100,100.0,18,8400,467,-8300,bkc
2024-02-21,3,700,233.33,5,3300,660,-2600,bkc
2024-02-20,2,300,150.0,4,700,175,-400,bkc
2024-02-19,2,300,150.0,4,800,200,-500,bkc
2024-02-16,2,300,150.0,5,1000,200,-700,bkc
2024-02-15,3,400,133.33,3,200,67,200,bkc
2024-02-07,4,800,200.0,5,700,140,100,bkc
2024-02-06,2,300,150.0,5,1400,280,-1100,bkc
2024-02-05,2,500,250.0,6,1800,300,-1300,bkc
2024-02-02,2,500,250.0,4,400,100,100,bkc
2024-02-01,4,500,125.0,5,1100,220,-600,bkc
2024-01-31,6,3200,533.33,9,2300,256,900,bkc
2024-01-30,3,300,100.0,7,2100,300,-1800,bkc
2024-01-29,4,300,75.0,9,5000,556,-4700,bkc
2024-01-26,3,200,66.67,7,6900,986,-6700,bkc
2024-01-25,4,500,125.0,7,4800,686,-4300,bkc
2024-01-24,7,1900,271.43,10,7000,700,-5100,bkc
2024-01-23,8,4700,587.5,7,1800,257,2900,bkc
2024-01-22,8,8100,1012.5,8,1400,175,6700,bkc
2024-01-19,2,400,200.0,7,4400,629,-4000,bkc
2024-01-18,3,400,133.33,7,7300,1043,-6900,bkc
2024-01-17,2,400,200.0,8,8300,1038,-7900,bkc
2024-01-16,2,300,150.0,8,7900,988,-7600,bkc
2024-01-15,2,200,100.0,7,1700,243,-1500,bkc
2024-01-12,2,300,150.0,4,400,100,-100,bkc
2024-01-11,2,400,200.0,11,4100,373,-3700,bkc
2024-01-10,2,200,100.0,6,1500,250,-1300,bkc
2024-01-09,5,2400,480.0,9,2200,244,200,bkc
2024-01-08,4,1200,300.0,9,2400,267,-1200,bkc
2024-01-05,4,400,100.0,12,7300,608,-6900,bkc
2024-01-04,4,2900,725.0,7,800,114,2100,bkc
2024-01-03,2,400,200.0,6,800,133,-400,bkc
2024-01-02,6,900,150.0,7,1200,171,-300,bkc
2024-09-12,13,25700,1976.92,11,4800,436,20900,blf
2024-09-11,10,6900,690.0,18,19300,1072,-12400,blf
2024-09-10,13,11100,853.85,11,17400,1582,-6300,blf
2024-09-09,12,22100,1841.67,11,10100,918,12000,blf
2024-09-06,4,4900,1225.0,7,6200,886,-1300,blf
2024-09-05,6,5700,950.0,7,6100,871,-400,blf
2024-09-04,8,10700,1337.5,8,6000,750,4700,blf
2024-08-30,24,23200,966.67,18,19600,1089,3600,blf
2024-08-29,17,27400,1611.76,15,27100,1807,300,blf
2024-08-28,10,12100,1210.0,6,15500,2583,-3400,blf
2024-08-27,7,6700,957.14,9,12700,1411,-6000,blf
2024-08-26,8,7600,950.0,9,14200,1578,-6600,blf
2024-08-23,12,16400,1366.67,13,20100,1546,-3700,blf
2024-08-22,8,7600,950.0,7,9900,1414,-2300,blf
2024-08-21,19,14700,773.68,10,16800,1680,-2100,blf
2024-08-20,9,6300,700.0,12,14500,1208,-8200,blf
2024-08-19,8,9700,1212.5,12,13000,1083,-3300,blf
2024-08-16,10,8900,890.0,11,14100,1282,-5200,blf
2024-08-15,14,9600,685.71,13,21600,1662,-12000,blf
2024-08-14,14,10500,750.0,10,16300,1630,-5800,blf
2024-08-13,10,7600,760.0,12,14600,1217,-7000,blf
2024-08-12,14,10900,778.57,14,21300,1521,-10400,blf
2024-08-09,14,17700,1264.29,10,17300,1730,400,blf
2024-08-08,24,16400,683.33,13,12700,977,3700,blf
2024-08-07,16,17700,1106.25,13,30300,2331,-12600,blf
2024-08-06,16,10400,650.0,12,17800,1483,-7400,blf
2024-08-05,13,19100,1469.23,14,21900,1564,-2800,blf
2024-08-02,32,33800,1056.25,25,36500,1460,-2700,blf
2024-08-01,29,13900,479.31,27,43000,1593,-29100,blf
2024-07-31,5,4300,860.0,10,16800,1680,-12500,blf
2024-07-30,16,32900,2056.25,15,41700,2780,-8800,blf
2024-07-29,12,9600,800.0,7,22900,3271,-13300,blf
2024-07-26,19,31500,1657.89,12,32700,2725,-1200,blf
2024-07-25,9,13900,1544.44,8,19400,2425,-5500,blf
2024-07-24,15,17300,1153.33,5,15200,3040,2100,blf
2024-07-23,15,8800,586.67,13,22000,1692,-13200,blf
2024-07-22,21,16000,761.9,20,29100,1455,-13100,blf
2024-07-19,13,25900,1992.31,18,39200,2178,-13300,blf
2024-07-18,21,30600,1457.14,20,42500,2125,-11900,blf
2024-07-17,19,29000,1526.32,22,32000,1455,-3000,blf
2024-07-16,38,54500,1434.21,24,40800,1700,13700,blf
2024-07-15,46,52600,1143.48,36,52000,1444,600,blf
2024-07-12,30,42100,1403.33,37,54600,1476,-12500,blf
2024-07-11,25,13700,548.0,33,50100,1518,-36400,blf
2024-07-10,53,45500,858.49,30,47500,1583,-2000,blf
2024-07-09,24,21100,879.17,24,33400,1392,-12300,blf
2024-07-08,28,41400,1478.57,25,53400,2136,-12000,blf
2024-07-05,17,20900,1229.41,26,35300,1358,-14400,blf
2024-07-04,37,32400,875.68,35,64100,1831,-31700,blf
2024-07-03,14,12000,857.14,30,51700,1723,-39700,blf
2024-07-02,34,27100,797.06,29,23900,824,3200,blf
2024-07-01,38,33200,873.68,30,26700,890,6500,blf
2024-06-28,22,13500,613.64,35,50900,1454,-37400,blf
2024-06-27,21,18500,880.95,29,20800,717,-2300,blf
2024-06-26,31,63500,2048.39,34,51900,1526,11600,blf
2024-06-25,50,48500,970.0,50,68400,1368,-19900,blf
2024-06-24,55,40600,738.18,28,34000,1214,6600,blf
2024-06-21,60,70700,1178.33,59,127600,2163,-56900,blf
2024-06-20,41,37600,917.07,32,37600,1175,0,blf
2024-06-19,43,53500,1244.19,50,74300,1486,-20800,blf
2024-06-18,57,74600,1308.77,41,84500,2061,-9900,blf
2024-06-17,36,29600,822.22,35,47700,1363,-18100,blf
2024-06-14,47,71400,1519.15,44,74700,1698,-3300,blf
2024-06-13,49,43500,887.76,38,58300,1534,-14800,blf
2024-06-12,81,76200,940.74,39,90200,2313,-14000,blf
2024-06-11,43,53300,1239.53,42,88600,2110,-35300,blf
2024-06-10,68,46400,682.35,41,56300,1373,-9900,blf
2024-06-07,117,82100,701.71,67,120500,1799,-38400,blf
2024-06-06,65,36100,555.38,52,55800,1073,-19700,blf
2024-06-05,102,65800,645.1,40,67700,1692,-1900,blf
2024-06-04,57,56900,998.25,52,92600,1781,-35700,blf
2024-06-03,146,176000,1205.48,97,197600,2037,-21600,blf
2024-05-31,85,60000,705.88,75,100200,1336,-40200,blf
2024-05-30,213,350500,1645.54,155,321300,2073,29200,blf
2024-05-29,66,383300,5807.58,31,69900,2255,313400,blf
2024-05-28,93,752700,8093.55,21,18000,857,734700,blf
2024-05-27,115,2267700,19719.13,34,78500,2309,2189200,blf
2024-05-24,39,30000,769.23,28,61100,2182,-31100,blf
2024-05-23,37,30700,829.73,30,51500,1717,-20800,blf
2024-05-22,60,58700,978.33,37,104700,2830,-46000,blf
2024-05-21,36,46300,1286.11,32,67300,2103,-21000,blf
2024-05-20,20,28900,1445.0,28,53300,1904,-24400,blf
2024-05-17,42,58700,1397.62,46,90100,1959,-31400,blf
2024-05-16,72,91300,1268.06,44,116500,2648,-25200,blf
2024-05-15,53,78800,1486.79,44,94000,2136,-15200,blf
2024-05-14,44,49600,1127.27,41,56700,1383,-7100,blf
2024-05-13,47,68600,1459.57,33,85500,2591,-16900,blf
2024-05-10,22,34800,1581.82,26,39400,1515,-4600,blf
2024-05-09,39,35700,915.38,28,41800,1493,-6100,blf
2024-05-08,20,16300,815.0,20,39000,1950,-22700,blf
2024-05-07,26,27000,1038.46,31,36100,1165,-9100,blf
2024-05-06,28,42400,1514.29,29,44200,1524,-1800,blf
2024-05-03,31,28900,932.26,35,73400,2097,-44500,blf
2024-05-02,28,27100,967.86,26,55900,2150,-28800,blf
2024-04-26,42,44200,1052.38,22,28900,1314,15300,blf
2024-04-25,32,21500,671.88,43,91000,2116,-69500,blf
2024-04-24,41,44400,1082.93,38,77300,2034,-32900,blf
2024-04-23,32,35600,1112.5,34,36900,1085,-1300,blf
2024-04-22,29,32700,1127.59,23,58100,2526,-25400,blf
2024-04-19,52,55600,1069.23,35,55600,1589,0,blf
2024-04-17,21,30200,1438.1,38,41000,1079,-10800,blf
2024-04-16,26,41600,1600.0,30,54000,1800,-12400,blf
2024-04-15,46,50300,1093.48,33,66000,2000,-15700,blf
2024-04-12,28,26900,960.71,65,92900,1429,-66000,blf
2024-04-11,37,27100,732.43,29,15400,531,11700,blf
2024-04-10,37,25600,691.89,26,21600,831,4000,blf
2024-04-09,33,28200,854.55,25,29500,1180,-1300,blf
2024-04-08,60,50100,835.0,47,69300,1474,-19200,blf
2024-04-05,43,51300,1193.02,36,67400,1872,-16100,blf
2024-04-04,59,69600,1179.66,41,86700,2115,-17100,blf
2024-04-03,46,76000,1652.17,29,88500,3052,-12500,blf
2024-04-02,46,38500,836.96,53,82900,1564,-44400,blf
2024-04-01,44,47600,1081.82,47,88500,1883,-40900,blf
2024-03-29,29,48500,1672.41,45,72800,1618,-24300,blf
2024-03-28,85,133400,1569.41,46,116100,2524,17300,blf
2024-03-27,75,139200,1856.0,47,112500,2394,26700,blf
2024-03-26,58,48200,831.03,40,69000,1725,-20800,blf
2024-03-25,46,63700,1384.78,33,77700,2355,-14000,blf
2024-03-22,77,55700,723.38,43,75400,1753,-19700,blf
2024-03-21,100,69100,691.0,55,66600,1211,2500,blf
2024-03-20,48,62500,1302.08,42,56300,1340,6200,blf
2024-03-19,88,68300,776.14,78,99900,1281,-31600,blf
2024-03-18,71,40600,571.83,41,125000,3049,-84400,blf
2024-03-15,204,286700,1405.39,119,282900,2377,3800,blf
2024-03-14,96,204200,2127.08,16,12100,756,192100,blf
2024-03-13,91,249200,2738.46,15,25900,1727,223300,blf
2024-03-12,61,178700,2929.51,10,5500,550,173200,blf
2024-03-11,39,151000,3871.79,31,69900,2255,81100,blf
2024-03-08,13,24000,1846.15,11,26000,2364,-2000,blf
2024-03-07,31,72600,2341.94,13,38400,2954,34200,blf
2024-03-06,10,43200,4320.0,11,42000,3818,1200,blf
2024-03-05,8,22900,2862.5,18,21900,1217,1000,blf
2024-03-04,10,30100,3010.0,22,35500,1614,-5400,blf
2024-03-01,9,8800,977.78,19,29400,1547,-20600,blf
2024-02-29,12,27600,2300.0,29,32400,1117,-4800,blf
2024-02-28,13,23100,1776.92,26,45800,1762,-22700,blf
2024-02-27,14,53100,3792.86,16,14900,931,38200,blf
2024-02-26,14,39000,2785.71,26,40200,1546,-1200,blf
2024-02-23,20,26500,1325.0,32,56500,1766,-30000,blf
2024-02-22,22,32400,1472.73,30,51800,1727,-19400,blf
2024-02-21,22,46500,2113.64,33,65200,1976,-18700,blf
2024-02-20,25,35000,1400.0,25,51300,2052,-16300,blf
2024-02-19,13,7100,546.15,18,24700,1372,-17600,blf
2024-02-16,23,62000,2695.65,36,61800,1717,200,blf
2024-02-15,15,27800,1853.33,21,22900,1090,4900,blf
2024-02-07,25,18800,752.0,8,6200,775,12600,blf
2024-02-06,8,2800,350.0,13,8400,646,-5600,blf
2024-02-05,14,8600,614.29,21,22200,1057,-13600,blf
2024-02-02,18,12200,677.78,25,24900,996,-12700,blf
2024-02-01,11,9900,900.0,22,17700,805,-7800,blf
2024-01-31,2,1100,550.0,18,14600,811,-13500,blf
2024-01-30,11,31300,2845.45,25,23900,956,7400,blf
2024-01-29,7,10600,1514.29,17,22400,1318,-11800,blf
2024-01-26,8,38000,4750.0,21,33300,1586,4700,blf
2024-01-25,12,26500,2208.33,35,36400,1040,-9900,blf
2024-01-24,17,34400,2023.53,38,35500,934,-1100,blf
2024-01-23,14,47400,3385.71,19,43400,2284,4000,blf
2024-01-22,13,25300,1946.15,26,41100,1581,-15800,blf
2024-01-19,18,91600,5088.89,37,109700,2965,-18100,blf
2024-01-18,17,38200,2247.06,35,49800,1423,-11600,blf
2024-01-17,22,22700,1031.82,33,50800,1539,-28100,blf
2024-01-16,28,53600,1914.29,36,121300,3369,-67700,blf
2024-01-15,27,19700,729.63,36,57300,1592,-37600,blf
2024-01-12,31,48300,1558.06,33,86600,2624,-38300,blf
2024-01-11,36,87300,2425.0,46,84900,1846,2400,blf
2024-01-10,16,5500,343.75,22,37000,1682,-31500,blf
2024-01-09,32,24600,768.75,34,31500,926,-6900,blf
2024-01-08,32,19000,593.75,24,37100,1546,-18100,blf
2024-01-05,33,9200,278.79,25,30000,1200,-20800,blf
2024-01-04,48,29000,604.17,60,61500,1025,-32500,blf
2024-01-03,21,13300,633.33,25,28400,1136,-15100,blf
2024-01-02,72,42000,583.33,54,58800,1089,-16800,blf
2024-09-12,64,109300,1707.81,38,104000,2737,5300,bli
2024-09-11,59,102800,1742.37,25,68900,2756,33900,bli
2024-09-10,65,99700,1533.85,31,89700,2894,10000,bli
2024-09-09,60,98700,1645.0,27,48500,1796,50200,bli
2024-09-06,79,134100,1697.47,22,72400,3291,61700,bli
2024-09-05,104,127500,1225.96,29,79100,2728,48400,bli
2024-09-04,62,100400,1619.35,37,98700,2668,1700,bli
2024-08-30,47,50200,1068.09,24,58000,2417,-7800,bli
2024-08-29,76,92100,1211.84,34,82800,2435,9300,bli
2024-08-28,119,165900,1394.12,61,158000,2590,7900,bli
2024-08-27,21,17200,819.05,33,52900,1603,-35700,bli
2024-08-26,23,14000,608.7,25,32400,1296,-18400,bli
2024-08-23,27,43500,1611.11,23,44200,1922,-700,bli
2024-08-22,35,48700,1391.43,39,59600,1528,-10900,bli
2024-08-21,33,34100,1033.33,32,51300,1603,-17200,bli
2024-08-20,30,45100,1503.33,46,80800,1757,-35700,bli
2024-08-19,39,41600,1066.67,42,48400,1152,-6800,bli
2024-08-16,48,91500,1906.25,38,41600,1095,49900,bli
2024-08-15,60,46100,768.33,51,72500,1422,-26400,bli
2024-08-14,41,36600,892.68,49,123500,2520,-86900,bli
2024-08-13,26,21800,838.46,20,40000,2000,-18200,bli
2024-08-12,20,21600,1080.0,22,58700,2668,-37100,bli
2024-08-09,24,22400,933.33,20,27800,1390,-5400,bli
2024-08-08,21,21000,1000.0,21,59800,2848,-38800,bli
2024-08-07,27,19100,707.41,17,28200,1659,-9100,bli
2024-08-06,30,29600,986.67,20,37400,1870,-7800,bli
2024-08-05,36,25900,719.44,29,51100,1762,-25200,bli
2024-08-02,49,49400,1008.16,30,52600,1753,-3200,bli
2024-08-01,54,47300,875.93,36,64000,1778,-16700,bli
2024-07-31,26,35000,1346.15,28,50400,1800,-15400,bli
2024-07-30,23,17600,765.22,16,30900,1931,-13300,bli
2024-07-29,24,16500,687.5,19,33600,1768,-17100,bli
2024-07-26,36,29200,811.11,24,35300,1471,-6100,bli
2024-07-25,37,31300,845.95,36,46800,1300,-15500,bli
2024-07-24,46,88900,1932.61,23,55400,2409,33500,bli
2024-07-23,59,70000,1186.44,36,85500,2375,-15500,bli
2024-07-22,37,59300,1602.7,35,75100,2146,-15800,bli
2024-07-19,35,56400,1611.43,38,60500,1592,-4100,bli
2024-07-18,66,116200,1760.61,56,145700,2602,-29500,bli
2024-07-17,52,73600,1415.38,50,115400,2308,-41800,bli
2024-07-16,34,50600,1488.24,44,84400,1918,-33800,bli
2024-07-15,38,49500,1302.63,40,88500,2212,-39000,bli
2024-07-12,46,56300,1223.91,41,99300,2422,-43000,bli
2024-07-11,52,50200,965.38,42,120800,2876,-70600,bli
2024-07-10,87,72500,833.33,61,162100,2657,-89600,bli
2024-07-09,96,132500,1380.21,50,116900,2338,15600,bli
2024-07-08,51,51100,1001.96,49,102900,2100,-51800,bli
2024-07-05,56,50500,901.79,57,102600,1800,-52100,bli
2024-07-04,37,64900,1754.05,54,74900,1387,-10000,bli
2024-07-03,29,41700,1437.93,36,84500,2347,-42800,bli
2024-07-02,45,60900,1353.33,45,79900,1776,-19000,bli
2024-07-01,60,82600,1376.67,43,126500,2942,-43900,bli
2024-06-28,59,68900,1167.8,84,176900,2106,-108000,bli
2024-06-27,84,119800,1426.19,107,159600,1492,-39800,bli
2024-06-26,46,73500,1597.83,72,112200,1558,-38700,bli
2024-06-25,59,104700,1774.58,81,125900,1554,-21200,bli
2024-06-24,132,195300,1479.55,162,290200,1791,-94900,bli
2024-06-21,92,113800,1236.96,76,120200,1582,-6400,bli
2024-06-20,170,252000,1482.35,109,223500,2050,28500,bli
2024-06-19,80,79900,998.75,52,145300,2794,-65400,bli
2024-06-18,50,54800,1096.0,51,82000,1608,-27200,bli
2024-06-17,80,117700,1471.25,56,115100,2055,2600,bli
2024-06-14,106,104000,981.13,109,197000,1807,-93000,bli
2024-06-13,85,186200,2190.59,116,257900,2223,-71700,bli
2024-06-12,131,241300,1841.98,137,201300,1469,40000,bli
2024-06-11,55,220400,4007.27,61,143300,2349,77100,bli
2024-06-10,81,202800,2503.7,62,127100,2050,75700,bli
2024-06-07,79,167500,2120.25,67,131200,1958,36300,bli
2024-06-06,72,178700,2481.94,47,122600,2609,56100,bli
2024-06-05,89,223200,2507.87,73,204600,2803,18600,bli
2024-06-04,63,79800,1266.67,42,110900,2640,-31100,bli
2024-06-03,67,97000,1447.76,38,102800,2705,-5800,bli
2024-05-31,63,122100,1938.1,42,146700,3493,-24600,bli
2024-05-30,64,59900,935.94,35,103500,2957,-43600,bli
2024-05-29,101,95600,946.53,51,110300,2163,-14700,bli
2024-05-28,88,115000,1306.82,63,149500,2373,-34500,bli
2024-05-27,98,152800,1559.18,69,143000,2072,9800,bli
2024-05-24,91,237500,2609.89,60,183900,3065,53600,bli
2024-05-23,32,27000,843.75,30,62500,2083,-35500,bli
2024-05-22,27,33000,1222.22,32,56500,1766,-23500,bli
2024-05-21,29,53200,1834.48,39,57300,1469,-4100,bli
2024-05-20,29,50300,1734.48,35,52500,1500,-2200,bli
2024-05-17,12,15100,1258.33,12,12500,1042,2600,bli
2024-05-16,17,12400,729.41,13,12100,931,300,bli
2024-05-15,24,28100,1170.83,25,30900,1236,-2800,bli
2024-05-14,25,30200,1208.0,19,23800,1253,6400,bli
2024-05-13,23,16100,700.0,16,17100,1069,-1000,bli
2024-05-10,16,5800,362.5,10,6800,680,-1000,bli
2024-05-09,17,7900,464.71,17,10600,624,-2700,bli
2024-05-08,11,7000,636.36,9,7600,844,-600,bli
2024-05-07,23,11200,486.96,13,9700,746,1500,bli
2024-05-06,23,15400,669.57,11,15600,1418,-200,bli
2024-05-03,24,28700,1195.83,19,21600,1137,7100,bli
2024-05-02,17,15700,923.53,17,17900,1053,-2200,bli
2024-04-26,18,33600,1866.67,23,56100,2439,-22500,bli
2024-04-25,30,32600,1086.67,28,39600,1414,-7000,bli
2024-04-24,24,38800,1616.67,22,46600,2118,-7800,bli
2024-04-23,17,14800,870.59,14,20900,1493,-6100,bli
2024-04-22,33,35500,1075.76,20,36800,1840,-1300,bli
2024-04-19,26,20400,784.62,30,39600,1320,-19200,bli
2024-04-17,18,11100,616.67,16,19100,1194,-8000,bli
2024-04-16,9,3900,433.33,14,25800,1843,-21900,bli
2024-04-15,9,5000,555.56,11,17700,1609,-12700,bli
2024-04-12,18,20100,1116.67,16,35300,2206,-15200,bli
2024-04-11,17,12600,741.18,11,14700,1336,-2100,bli
2024-04-10,22,27100,1231.82,18,42800,2378,-15700,bli
2024-04-09,48,81400,1695.83,22,98600,4482,-17200,bli
2024-04-08,8,18100,2262.5,19,18700,984,-600,bli
2024-04-05,9,17200,1911.11,18,29500,1639,-12300,bli
2024-04-04,12,24100,2008.33,16,28200,1762,-4100,bli
2024-04-03,12,3600,300.0,17,31400,1847,-27800,bli
2024-04-02,20,54800,2740.0,23,77100,3352,-22300,bli
2024-04-01,11,13700,1245.45,16,24300,1519,-10600,bli
2024-03-29,35,100200,2862.86,33,95200,2885,5000,bli
2024-03-28,14,37600,2685.71,16,23800,1488,13800,bli
2024-03-27,13,36500,2807.69,21,25800,1229,10700,bli
2024-03-26,19,54600,2873.68,21,34000,1619,20600,bli
2024-03-25,28,56500,2017.86,27,39900,1478,16600,bli
2024-03-22,17,39500,2323.53,28,35400,1264,4100,bli
2024-03-21,24,34500,1437.5,26,12800,492,21700,bli
2024-03-20,12,30000,2500.0,26,26900,1035,3100,bli
2024-03-19,21,44300,2109.52,34,32500,956,11800,bli
2024-03-18,17,29800,1752.94,27,25300,937,4500,bli
2024-03-15,14,36900,2635.71,36,27000,750,9900,bli
2024-03-14,16,44200,2762.5,28,33500,1196,10700,bli
2024-03-13,23,56000,2434.78,30,52100,1737,3900,bli
2024-03-12,15,41900,2793.33,18,24500,1361,17400,bli
2024-03-11,20,35300,1765.0,25,21300,852,14000,bli
2024-03-08,23,42900,1865.22,18,20700,1150,22200,bli
2024-03-07,19,16300,857.89,24,21000,875,-4700,bli
2024-03-06,21,36900,1757.14,28,30100,1075,6800,bli
2024-03-05,24,44100,1837.5,25,24300,972,19800,bli
2024-03-04,19,42900,2257.89,30,26600,887,16300,bli
2024-03-01,28,62000,2214.29,34,46200,1359,15800,bli
2024-02-29,31,62000,2000.0,36,40300,1119,21700,bli
2024-02-28,25,48300,1932.0,28,33100,1182,15200,bli
2024-02-27,28,66600,2378.57,50,65100,1302,1500,bli
2024-02-26,25,27900,1116.0,21,38900,1852,-11000,bli
2024-02-23,30,46600,1553.33,25,51300,2052,-4700,bli
2024-02-22,69,61100,885.51,40,57500,1438,3600,bli
2024-02-21,53,69700,1315.09,48,79900,1665,-10200,bli
2024-02-20,21,16300,776.19,20,17900,895,-1600,bli
2024-02-19,31,20500,661.29,25,31900,1276,-11400,bli
2024-02-16,25,22000,880.0,16,41700,2606,-19700,bli
2024-02-15,66,120700,1828.79,44,135900,3089,-15200,bli
2024-02-07,16,24600,1537.5,27,15700,581,8900,bli
2024-02-06,15,44400,2960.0,25,34800,1392,9600,bli
2024-02-05,9,10800,1200.0,15,7800,520,3000,bli
2024-02-02,16,24400,1525.0,20,14800,740,9600,bli
2024-02-01,17,22000,1294.12,19,12600,663,9400,bli
2024-01-31,15,11800,786.67,15,9500,633,2300,bli
2024-01-30,9,28900,3211.11,16,27000,1688,1900,bli
2024-01-29,17,24400,1435.29,20,22900,1145,1500,bli
2024-01-26,17,31200,1835.29,14,13500,964,17700,bli
2024-01-25,12,7100,591.67,17,10200,600,-3100,bli
2024-01-24,13,21800,1676.92,17,13400,788,8400,bli
2024-01-23,15,16400,1093.33,12,6700,558,9700,bli
2024-01-22,31,89600,2890.32,33,92000,2788,-2400,bli
2024-01-19,16,11800,737.5,14,21200,1514,-9400,bli
2024-01-18,10,6000,600.0,17,10800,635,-4800,bli
2024-01-17,8,3300,412.5,14,19600,1400,-16300,bli
2024-01-16,11,8700,790.91,18,19700,1094,-11000,bli
2024-01-15,12,7900,658.33,13,16300,1254,-8400,bli
2024-01-12,18,32500,1805.56,25,39300,1572,-6800,bli
2024-01-11,4,2400,600.0,16,14400,900,-12000,bli
2024-01-10,8,7500,937.5,19,21200,1116,-13700,bli
2024-01-09,11,10200,927.27,18,20200,1122,-10000,bli
2024-01-08,5,1400,280.0,19,18400,968,-17000,bli
2024-01-05,5,1200,240.0,12,5700,475,-4500,bli
2024-01-04,5,1300,260.0,16,10300,644,-9000,bli
2024-01-03,4,1200,300.0,15,9800,653,-8600,bli
2024-01-02,14,2100,150.0,19,9900,521,-7800,bli
2024-09-12,0,0,0.0,0,0,0,0,bln
2024-09-11,0,0,0.0,0,0,0,0,bln
2024-09-10,0,0,0.0,0,0,0,0,bln
2024-09-09,0,0,0.0,0,0,0,0,bln
2024-09-06,0,0,0.0,1,100,100,-100,bln
2024-09-05,0,0,0.0,0,0,0,0,bln
2024-09-04,0,0,0.0,0,0,0,0,bln
2024-08-30,1,0,0.0,1,100,100,-100,bln
2024-08-29,0,0,0.0,0,0,0,0,bln
2024-08-28,0,0,0.0,0,0,0,0,bln
2024-08-27,0,0,0.0,0,0,0,0,bln
2024-08-26,0,0,0.0,0,0,0,0,bln
2024-08-23,0,0,0.0,0,0,0,0,bln
2024-08-22,0,0,0.0,0,0,0,0,bln
2024-08-21,0,0,0.0,0,0,0,0,bln
2024-08-20,0,0,0.0,0,0,0,0,bln
2024-08-19,0,0,0.0,0,0,0,0,bln
2024-08-16,0,0,0.0,0,0,0,0,bln
2024-08-15,0,0,0.0,0,0,0,0,bln
2024-08-14,0,0,0.0,0,0,0,0,bln
2024-08-13,0,0,0.0,0,0,0,0,bln
2024-08-12,0,0,0.0,0,0,0,0,bln
2024-08-09,0,0,0.0,0,0,0,0,bln
2024-08-08,0,0,0.0,0,0,0,0,bln
2024-08-07,0,0,0.0,0,0,0,0,bln
2024-08-06,0,0,0.0,0,0,0,0,bln
2024-08-05,0,0,0.0,0,0,0,0,bln
2024-08-02,0,0,0.0,0,0,0,0,bln
2024-08-01,0,0,0.0,0,0,0,0,bln
2024-07-31,0,0,0.0,0,0,0,0,bln
2024-07-30,1,100,100.0,0,0,0,100,bln
2024-07-29,0,0,0.0,0,0,0,0,bln
2024-07-26,0,0,0.0,0,0,0,0,bln
2024-07-25,0,0,0.0,0,0,0,0,bln
2024-07-24,1,100,100.0,0,0,0,100,bln
2024-07-23,0,0,0.0,0,0,0,0,bln
2024-07-22,0,0,0.0,0,0,0,0,bln
2024-07-19,0,0,0.0,0,0,0,0,bln
2024-07-18,1,100,100.0,0,0,0,100,bln
2024-07-17,0,0,0.0,0,0,0,0,bln
2024-07-16,0,0,0.0,0,0,0,0,bln
2024-07-15,1,100,100.0,0,0,0,100,bln
2024-07-12,2,300,150.0,0,0,0,300,bln
2024-07-11,0,0,0.0,0,0,0,0,bln
2024-07-10,0,0,0.0,0,0,0,0,bln
2024-07-09,0,0,0.0,0,0,0,0,bln
2024-07-08,0,0,0.0,0,0,0,0,bln
2024-07-05,0,0,0.0,0,0,0,0,bln
2024-07-04,0,0,0.0,0,0,0,0,bln
2024-07-03,0,0,0.0,0,0,0,0,bln
2024-07-02,0,0,0.0,0,0,0,0,bln
2024-07-01,0,0,0.0,0,0,0,0,bln
2024-06-28,0,0,0.0,0,0,0,0,bln
2024-06-27,0,0,0.0,0,0,0,0,bln
2024-06-26,0,0,0.0,0,0,0,0,bln
2024-06-25,0,0,0.0,0,0,0,0,bln
2024-06-24,0,0,0.0,0,0,0,0,bln
2024-06-21,0,0,0.0,1,0,0,0,bln
2024-06-20,0,0,0.0,0,0,0,0,bln
2024-06-19,0,0,0.0,0,0,0,0,bln
2024-06-18,0,0,0.0,0,0,0,0,bln
2024-06-17,0,0,0.0,0,0,0,0,bln
2024-06-14,0,0,0.0,0,0,0,0,bln
2024-06-13,0,0,0.0,0,0,0,0,bln
2024-06-12,0,0,0.0,1,1100,1100,-1100,bln
2024-06-11,0,0,0.0,0,0,0,0,bln
2024-06-10,0,0,0.0,0,0,0,0,bln
2024-06-07,0,0,0.0,0,0,0,0,bln
2024-06-06,0,0,0.0,0,0,0,0,bln
2024-06-05,0,0,0.0,0,0,0,0,bln
2024-06-04,0,0,0.0,0,0,0,0,bln
2024-06-03,0,0,0.0,0,0,0,0,bln
2024-05-31,0,0,0.0,0,0,0,0,bln
2024-05-30,0,0,0.0,0,0,0,0,bln
2024-05-29,0,0,0.0,0,0,0,0,bln
2024-05-28,0,0,0.0,0,0,0,0,bln
2024-05-27,1,100,100.0,1,100,100,0,bln
2024-05-24,0,0,0.0,0,0,0,0,bln
2024-05-23,0,0,0.0,0,0,0,0,bln
2024-05-22,0,0,0.0,0,0,0,0,bln
2024-05-21,0,0,0.0,0,0,0,0,bln
2024-05-20,0,0,0.0,0,0,0,0,bln
2024-05-17,0,0,0.0,0,0,0,0,bln
2024-05-16,0,0,0.0,0,0,0,0,bln
2024-05-15,0,0,0.0,0,0,0,0,bln
2024-05-14,0,0,0.0,0,0,0,0,bln
2024-05-13,0,0,0.0,0,0,0,0,bln
2024-05-10,0,0,0.0,0,0,0,0,bln
2024-05-09,0,0,0.0,1,100,100,-100,bln
2024-05-08,1,0,0.0,0,0,0,0,bln
2024-05-07,0,0,0.0,0,0,0,0,bln
2024-05-06,0,0,0.0,0,0,0,0,bln
2024-05-03,0,0,0.0,0,0,0,0,bln
2024-05-02,0,0,0.0,1,100,100,-100,bln
2024-04-26,0,0,0.0,0,0,0,0,bln
2024-04-25,0,0,0.0,0,0,0,0,bln
2024-04-24,0,0,0.0,1,100,100,-100,bln
2024-04-23,1,100,100.0,0,0,0,100,bln
2024-04-22,0,0,0.0,0,0,0,0,bln
2024-04-19,0,0,0.0,0,0,0,0,bln
2024-04-17,0,0,0.0,1,100,100,-100,bln
2024-04-16,0,0,0.0,0,0,0,0,bln
2024-04-15,0,0,0.0,0,0,0,0,bln
2024-04-12,0,0,0.0,0,0,0,0,bln
2024-04-11,0,0,0.0,0,0,0,0,bln
2024-04-10,0,0,0.0,0,0,0,0,bln
2024-04-09,0,0,0.0,0,0,0,0,bln
2024-04-08,0,0,0.0,0,0,0,0,bln
2024-04-05,0,0,0.0,0,0,0,0,bln
2024-04-04,0,0,0.0,0,0,0,0,bln
2024-04-03,1,100,100.0,0,0,0,100,bln
2024-04-02,0,0,0.0,0,0,0,0,bln
2024-04-01,0,0,0.0,0,0,0,0,bln
2024-03-29,0,0,0.0,0,0,0,0,bln
2024-03-28,0,0,0.0,0,0,0,0,bln
2024-03-27,0,0,0.0,0,0,0,0,bln
2024-03-26,0,0,0.0,0,0,0,0,bln
2024-03-25,0,0,0.0,0,0,0,0,bln
2024-03-22,0,0,0.0,0,0,0,0,bln
2024-03-21,0,0,0.0,0,0,0,0,bln
2024-03-20,0,0,0.0,0,0,0,0,bln
2024-03-19,0,0,0.0,0,0,0,0,bln
2024-03-18,0,0,0.0,0,0,0,0,bln
2024-03-15,0,0,0.0,0,0,0,0,bln
2024-03-14,0,0,0.0,0,0,0,0,bln
2024-03-13,2,3100,1550.0,0,0,0,3100,bln
2024-03-12,1,3000,3000.0,0,0,0,3000,bln
2024-03-11,1,2000,2000.0,1,100,100,1900,bln
2024-03-08,0,0,0.0,0,0,0,0,bln
2024-03-07,0,0,0.0,0,0,0,0,bln
2024-03-06,0,0,0.0,0,0,0,0,bln
2024-03-05,0,0,0.0,1,100,100,-100,bln
2024-03-04,0,0,0.0,0,0,0,0,bln
2024-03-01,0,0,0.0,0,0,0,0,bln
2024-02-29,0,0,0.0,0,0,0,0,bln
2024-02-28,0,0,0.0,0,0,0,0,bln
2024-02-27,0,0,0.0,0,0,0,0,bln
2024-02-26,1,10000,10000.0,0,0,0,10000,bln
2024-02-23,0,0,0.0,0,0,0,0,bln
2024-02-22,0,0,0.0,1,100,100,-100,bln
2024-02-21,0,0,0.0,0,0,0,0,bln
2024-02-20,0,0,0.0,1,100,100,-100,bln
2024-02-19,0,0,0.0,1,100,100,-100,bln
2024-02-16,0,0,0.0,0,0,0,0,bln
2024-02-15,1,100,100.0,0,0,0,100,bln
2024-02-07,1,500,500.0,0,0,0,500,bln
2024-02-06,0,0,0.0,0,0,0,0,bln
2024-02-05,1,20000,20000.0,1,400,400,19600,bln
2024-02-02,0,0,0.0,0,0,0,0,bln
2024-02-01,0,0,0.0,0,0,0,0,bln
2024-01-31,0,0,0.0,0,0,0,0,bln
2024-01-30,0,0,0.0,0,0,0,0,bln
2024-01-29,0,0,0.0,0,0,0,0,bln
2024-01-26,0,0,0.0,0,0,0,0,bln
2024-01-25,0,0,0.0,1,100,100,-100,bln
2024-01-24,0,0,0.0,0,0,0,0,bln
2024-01-23,0,0,0.0,0,0,0,0,bln
2024-01-22,0,0,0.0,1,100,100,-100,bln
2024-01-19,1,1000,1000.0,0,0,0,1000,bln
2024-01-18,2,2200,1100.0,0,0,0,2200,bln
2024-01-17,3,2200,733.33,0,0,0,2200,bln
2024-01-16,2,2000,1000.0,0,0,0,2000,bln
2024-01-15,0,0,0.0,0,0,0,0,bln
2024-01-12,0,0,0.0,0,0,0,0,bln
2024-01-11,0,0,0.0,0,0,0,0,bln
2024-01-10,0,0,0.0,0,0,0,0,bln
2024-01-09,2,993200,496600.0,1,992200,992200,1000,bln
2024-01-08,0,0,0.0,0,0,0,0,bln
2024-01-05,0,0,0.0,0,0,0,0,bln
2024-01-04,0,0,0.0,0,0,0,0,bln
2024-01-03,0,0,0.0,0,0,0,0,bln
2024-01-02,0,0,0.0,0,0,0,0,bln
2024-09-12,138,187600,1359.42,241,278900,1157,-91300,bmc
2024-09-11,226,428300,1895.13,164,198000,1207,230300,bmc
2024-09-10,87,58200,668.97,94,120000,1277,-61800,bmc
2024-09-09,76,54700,719.74,85,78200,920,-23500,bmc
2024-09-06,83,78200,942.17,114,112300,985,-34100,bmc
2024-09-05,106,121200,1143.4,138,173200,1255,-52000,bmc
2024-09-04,96,133100,1386.46,112,142700,1274,-9600,bmc
2024-08-30,135,155500,1151.85,152,165000,1086,-9500,bmc
2024-08-29,238,298100,1252.52,182,177700,976,120400,bmc
2024-08-28,159,110900,697.48,110,116200,1056,-5300,bmc
2024-08-27,160,140300,876.88,116,144400,1245,-4100,bmc
2024-08-26,124,87500,705.65,127,153000,1205,-65500,bmc
2024-08-23,97,112200,1156.7,149,154200,1035,-42000,bmc
2024-08-22,185,181500,981.08,169,200100,1184,-18600,bmc
2024-08-21,284,260400,916.9,151,311800,2065,-51400,bmc
2024-08-20,276,413700,1498.91,249,508000,2040,-94300,bmc
2024-08-19,126,160600,1274.6,146,231500,1586,-70900,bmc
2024-08-16,279,444700,1593.91,310,379500,1224,65200,bmc
2024-08-15,160,227900,1424.38,176,182600,1038,45300,bmc
2024-08-14,129,631200,4893.02,204,338600,1660,292600,bmc
2024-08-13,230,297100,1291.74,191,219000,1147,78100,bmc
2024-08-12,397,594200,1496.73,266,726400,2731,-132200,bmc
2024-08-08,372,1077900,2897.58,311,503100,1618,574800,bmc
2024-08-07,172,504900,2935.47,142,381500,2687,123400,bmc
2024-08-06,110,200500,1822.73,110,222900,2026,-22400,bmc
2024-08-05,213,329100,1545.07,195,357300,1832,-28200,bmc
2024-08-02,166,330300,1989.76,171,291700,1706,38600,bmc
2024-08-01,181,247800,1369.06,273,389600,1427,-141800,bmc
2024-07-31,258,711400,2757.36,150,348200,2321,363200,bmc
2024-07-30,59,66800,1132.2,67,112300,1676,-45500,bmc
2024-07-29,69,62200,901.45,98,123800,1263,-61600,bmc
2024-07-26,80,125800,1572.5,64,74300,1161,51500,bmc
2024-07-25,100,123600,1236.0,84,151500,1804,-27900,bmc
2024-07-24,51,78000,1529.41,88,121200,1377,-43200,bmc
2024-07-22,94,199000,2117.02,106,173700,1639,25300,bmc
2024-07-19,89,131100,1473.03,125,189800,1518,-58700,bmc
2024-07-18,109,150600,1381.65,126,191500,1520,-40900,bmc
2024-07-17,276,360700,1306.88,263,338200,1286,22500,bmc
2024-07-16,103,110900,1076.7,171,139500,816,-28600,bmc
2024-07-15,115,134900,1173.04,127,116200,915,18700,bmc
2024-07-12,61,66100,1083.61,80,77200,965,-11100,bmc
2024-07-11,62,43300,698.39,60,52800,880,-9500,bmc
2024-07-10,61,35400,580.33,59,57600,976,-22200,bmc
2024-07-09,59,71100,1205.08,86,95400,1109,-24300,bmc
2024-07-08,83,92000,1108.43,100,91800,918,200,bmc
2024-07-05,93,90700,975.27,89,65900,740,24800,bmc
2024-07-04,67,50900,759.7,54,33400,619,17500,bmc
2024-07-03,96,81200,845.83,72,112500,1562,-31300,bmc
2024-07-02,72,61100,848.61,60,57300,955,3800,bmc
2024-07-01,53,52900,998.11,73,58200,797,-5300,bmc
2024-06-28,48,74000,1541.67,60,51100,852,22900,bmc
2024-06-27,72,75000,1041.67,70,75700,1081,-700,bmc
2024-06-26,64,83500,1304.69,76,79700,1049,3800,bmc
2024-06-25,55,71600,1301.82,64,55400,866,16200,bmc
2024-06-24,77,61800,802.6,76,64700,851,-2900,bmc
2024-06-21,106,104100,982.08,58,79200,1366,24900,bmc
2024-06-20,47,44300,942.55,65,57200,880,-12900,bmc
2024-06-19,83,100700,1213.25,68,104500,1537,-3800,bmc
2024-06-18,114,134000,1175.44,65,79000,1215,55000,bmc
2024-06-17,119,110700,930.25,89,146100,1642,-35400,bmc
2024-06-14,100,122100,1221.0,87,121800,1400,300,bmc
2024-06-13,141,292700,2075.89,96,163200,1700,129500,bmc
2024-06-12,68,61100,898.53,70,81600,1166,-20500,bmc
2024-06-11,153,181200,1184.31,133,277800,2089,-96600,bmc
2024-06-10,91,133900,1471.43,150,250300,1669,-116400,bmc
2024-06-07,99,110300,1114.14,182,254700,1399,-144400,bmc
2024-06-06,80,78100,976.25,174,183700,1056,-105600,bmc
2024-06-05,175,234000,1337.14,260,346700,1333,-112700,bmc
2024-06-04,100,481700,4817.0,93,101900,1096,379800,bmc
2024-06-03,97,81800,843.3,92,121000,1315,-39200,bmc
2024-05-31,57,66200,1161.4,55,53800,978,12400,bmc
2024-05-30,130,143000,1100.0,62,84800,1368,58200,bmc
2024-05-29,68,82900,1219.12,100,108500,1085,-25600,bmc
2024-05-28,80,197700,2471.25,100,138300,1383,59400,bmc
2024-05-27,70,54900,784.29,51,48900,959,6000,bmc
2024-05-24,186,162900,875.81,94,203000,2160,-40100,bmc
2024-05-23,185,137900,745.41,132,203700,1543,-65800,bmc
2024-05-22,123,83800,681.3,95,149300,1572,-65500,bmc
2024-05-21,99,96000,969.7,89,170500,1916,-74500,bmc
2024-05-20,142,87500,616.2,120,131600,1097,-44100,bmc
2024-05-17,224,324700,1449.55,107,167900,1569,156800,bmc
2024-05-16,227,342100,1507.05,217,256000,1180,86100,bmc
2024-05-15,213,283000,1328.64,162,333200,2057,-50200,bmc
2024-05-14,149,183000,1228.19,141,212600,1508,-29600,bmc
2024-05-13,150,259900,1732.67,140,222000,1586,37900,bmc
2024-05-10,243,277600,1142.39,149,202900,1362,74700,bmc
2024-05-09,129,158400,1227.91,137,161100,1176,-2700,bmc
2024-05-08,188,620300,3299.47,129,170400,1321,449900,bmc
2024-05-07,343,428800,1250.15,140,180100,1286,248700,bmc
2024-05-06,113,118400,1047.79,62,88400,1426,30000,bmc
2024-05-03,99,73300,740.4,43,72200,1679,1100,bmc
2024-05-02,68,43600,641.18,50,41800,836,1800,bmc
2024-04-26,138,94500,684.78,83,134600,1622,-40100,bmc
2024-04-25,111,80600,726.13,79,76100,963,4500,bmc
2024-04-24,151,133200,882.12,74,125100,1691,8100,bmc
2024-04-23,83,47000,566.27,56,84200,1504,-37200,bmc
2024-04-22,88,97700,1110.23,44,122400,2782,-24700,bmc
2024-04-19,99,104800,1058.59,72,112900,1568,-8100,bmc
2024-04-17,67,37800,564.18,46,53400,1161,-15600,bmc
2024-04-16,59,51800,877.97,60,79400,1323,-27600,bmc
2024-04-15,43,53100,1234.88,82,92200,1124,-39100,bmc
2024-04-12,40,25500,637.5,85,66200,779,-40700,bmc
2024-04-11,33,33000,1000.0,56,114000,2036,-81000,bmc
2024-04-10,54,158700,2938.89,87,113800,1308,44900,bmc
2024-04-09,67,118700,1771.64,89,153900,1729,-35200,bmc
2024-04-08,30,19700,656.67,52,42200,812,-22500,bmc
2024-04-05,37,26700,721.62,64,53500,836,-26800,bmc
2024-04-04,54,30000,555.56,76,70300,925,-40300,bmc
2024-04-03,92,406500,4418.48,79,166900,2113,239600,bmc
2024-04-02,97,151900,1565.98,52,94100,1810,57800,bmc
2024-04-01,44,52700,1197.73,73,65700,900,-13000,bmc
2024-03-29,50,126600,2532.0,84,107200,1276,19400,bmc
2024-03-28,61,812100,13313.11,82,128100,1562,684000,bmc
2024-03-27,78,471000,6038.46,81,134100,1656,336900,bmc
2024-03-26,66,511900,7756.06,44,88800,2018,423100,bmc
2024-03-25,65,66200,1018.46,82,158000,1927,-91800,bmc
2024-03-22,45,34000,755.56,76,103100,1357,-69100,bmc
2024-03-21,77,89300,1159.74,83,146000,1759,-56700,bmc
2024-03-20,55,61300,1114.55,41,104300,2544,-43000,bmc
2024-03-19,109,156100,1432.11,96,467200,4867,-311100,bmc
2024-03-18,119,133300,1120.17,158,258300,1635,-125000,bmc
2024-03-15,121,192000,1586.78,101,99300,983,92700,bmc
2024-03-14,157,144300,919.11,134,158400,1182,-14100,bmc
2024-03-13,127,109000,858.27,114,173800,1525,-64800,bmc
2024-03-12,141,208300,1477.3,160,230600,1441,-22300,bmc
2024-03-11,181,152800,844.2,166,347500,2093,-194700,bmc
2024-03-08,308,991700,3219.81,192,373400,1945,618300,bmc
2024-03-07,264,269700,1021.59,245,527500,2153,-257800,bmc
2024-03-06,172,307800,1789.53,163,380200,2333,-72400,bmc
2024-03-05,407,741700,1822.36,154,383500,2490,358200,bmc
2024-03-04,174,338600,1945.98,117,259700,2220,78900,bmc
2024-03-01,69,58400,846.38,79,88600,1122,-30200,bmc
2024-02-29,38,32500,855.26,85,67800,798,-35300,bmc
2024-02-28,68,77500,1139.71,89,85800,964,-8300,bmc
2024-02-27,132,95600,724.24,115,138600,1205,-43000,bmc
2024-02-26,97,66700,687.63,82,115000,1402,-48300,bmc
2024-02-23,116,125700,1083.62,120,147000,1225,-21300,bmc
2024-02-22,107,103300,965.42,84,78900,939,24400,bmc
2024-02-21,75,75800,1010.67,77,96900,1258,-21100,bmc
2024-02-20,55,64000,1163.64,59,73400,1244,-9400,bmc
2024-02-19,104,126000,1211.54,81,99500,1228,26500,bmc
2024-02-16,62,85700,1382.26,78,74800,959,10900,bmc
2024-02-15,77,76300,990.91,95,108400,1141,-32100,bmc
2024-02-07,0,0,0.0,0,0,0,0,bmc
2024-02-06,147,639200,4348.3,153,451000,2948,188200,bmc
2024-02-05,58,93500,1612.07,74,112800,1524,-19300,bmc
2024-02-02,107,350200,3272.9,110,236100,2146,114100,bmc
2024-02-01,68,119900,1763.24,84,124200,1479,-4300,bmc
2024-01-31,71,106100,1494.37,131,184200,1406,-78100,bmc
2024-01-30,66,88400,1339.39,107,169100,1580,-80700,bmc
2024-01-29,79,135200,1711.39,125,217700,1742,-82500,bmc
2024-01-26,68,98600,1450.0,114,182500,1601,-83900,bmc
2024-01-25,78,128600,1648.72,116,196600,1695,-68000,bmc
2024-01-24,134,448600,3347.76,157,308700,1966,139900,bmc
2024-01-23,173,312100,1804.05,171,319500,1868,-7400,bmc
2024-01-22,124,237900,1918.55,147,218200,1484,19700,bmc
2024-01-19,198,1379700,6968.18,176,394700,2243,985000,bmc
2024-01-18,53,139300,2628.3,91,129400,1422,9900,bmc
2024-01-17,86,234100,2722.09,94,122600,1304,111500,bmc
2024-01-16,80,209800,2622.5,103,185200,1798,24600,bmc
2024-01-15,127,299400,2357.48,122,158700,1301,140700,bmc
2024-01-12,103,260000,2524.27,113,157200,1391,102800,bmc
2024-01-11,113,238800,2113.27,123,203900,1658,34900,bmc
2024-01-10,0,0,0.0,0,0,0,0,bmc
2024-01-09,161,884300,5492.55,229,417800,1824,466500,bmc
2024-01-08,134,430000,3208.96,233,305200,1310,124800,bmc
2024-01-05,133,1548600,11643.61,178,297000,1669,1251600,bmc
2024-01-04,149,840800,5642.95,181,242900,1342,597900,bmc
2024-01-03,82,153600,1873.17,85,101700,1196,51900,bmc
2024-01-02,98,255500,2607.14,136,157800,1160,97700,bmc
2024-09-12,344,601600,1748.84,144,492300,3419,109300,bmi
2024-09-11,222,452400,2037.84,126,415300,3296,37100,bmi
2024-09-10,138,346600,2511.59,108,302000,2796,44600,bmi
2024-09-09,150,263900,1759.33,87,267500,3075,-3600,bmi
2024-09-06,145,330700,2280.69,92,203600,2213,127100,bmi
2024-09-05,188,373500,1986.7,117,221800,1896,151700,bmi
2024-09-04,213,223600,1049.77,113,235500,2084,-11900,bmi
2024-08-30,109,337800,3099.08,55,153600,2793,184200,bmi
2024-08-29,193,354600,1837.31,593,296300,500,58300,bmi
2024-08-28,124,357200,2880.65,103,395300,3838,-38100,bmi
2024-08-27,174,494000,2839.08,129,298600,2315,195400,bmi
2024-08-26,172,616200,3582.56,191,500300,2619,115900,bmi
2024-08-23,81,228700,2823.46,155,433000,2794,-204300,bmi
2024-08-22,150,706400,4709.33,363,1051800,2898,-345400,bmi
2024-08-21,102,248200,2433.33,137,286000,2088,-37800,bmi
2024-08-20,98,403200,4114.29,197,319600,1622,83600,bmi
2024-08-19,88,228000,2590.91,124,229100,1848,-1100,bmi
2024-08-16,144,313400,2176.39,203,371000,1828,-57600,bmi
2024-08-15,250,1063600,4254.4,302,684500,2267,379100,bmi
2024-08-14,114,212600,1864.91,164,181700,1108,30900,bmi
2024-08-13,134,224500,1675.37,119,183600,1543,40900,bmi
2024-08-12,173,349200,2018.5,133,299100,2249,50100,bmi
2024-08-08,132,166400,1260.61,176,234400,1332,-68000,bmi
2024-08-07,231,300400,1300.43,152,200700,1320,99700,bmi
2024-08-06,204,408200,2000.98,166,153000,922,255200,bmi
2024-08-05,451,1065100,2361.64,267,607500,2275,457600,bmi
2024-08-02,204,277800,1361.76,158,258900,1639,18900,bmi
2024-08-01,268,394700,1472.76,216,465400,2155,-70700,bmi
2024-07-31,127,154300,1214.96,139,240800,1732,-86500,bmi
2024-07-30,191,211500,1107.33,157,264900,1687,-53400,bmi
2024-07-29,157,283200,1803.82,341,347800,1020,-64600,bmi
2024-07-26,177,354000,2000.0,138,245900,1782,108100,bmi
2024-07-25,208,412800,1984.62,248,329600,1329,83200,bmi
2024-07-24,318,483700,1521.07,179,441900,2469,41800,bmi
2024-07-22,514,812200,1580.16,392,783600,1999,28600,bmi
2024-07-19,378,732500,1937.83,248,485200,1956,247300,bmi
2024-07-18,409,730900,1787.04,292,573900,1965,157000,bmi
2024-07-17,487,1224900,2515.2,568,1325700,2334,-100800,bmi
2024-07-16,304,939300,3089.8,515,868700,1687,70600,bmi
2024-07-15,273,517200,1894.51,378,544000,1439,-26800,bmi
2024-07-12,455,1663100,3655.16,571,1146800,2008,516300,bmi
2024-07-11,306,973800,3182.35,379,874300,2307,99500,bmi
2024-07-10,450,897200,1993.78,489,977400,1999,-80200,bmi
2024-07-09,991,1718400,1734.01,1000,2230600,2231,-512200,bmi
2024-07-08,421,740300,1758.43,458,994000,2170,-253700,bmi
2024-07-05,360,625800,1738.33,364,809600,2224,-183800,bmi
2024-07-04,442,910500,2059.95,458,921000,2011,-10500,bmi
2024-07-03,321,484800,1510.28,305,527600,1730,-42800,bmi
2024-07-02,338,677100,2003.25,483,942800,1952,-265700,bmi
2024-07-01,232,405500,1747.84,246,677900,2756,-272400,bmi
2024-06-28,563,978700,1738.37,361,934100,2588,44600,bmi
2024-06-27,569,1121800,1971.53,684,1421100,2078,-299300,bmi
2024-06-26,362,832400,2299.45,275,452300,1645,380100,bmi
2024-06-25,419,544800,1300.24,202,413700,2048,131100,bmi
2024-06-24,611,1086700,1778.56,549,1541300,2807,-454600,bmi
2024-06-21,443,791200,1786.0,355,723800,2039,67400,bmi
2024-06-20,1236,1741900,1409.3,809,2056600,2542,-314700,bmi
2024-06-19,746,891800,1195.44,382,951500,2491,-59700,bmi
2024-06-18,302,487400,1613.91,300,684300,2281,-196900,bmi
2024-06-17,518,1049600,2026.25,325,909700,2799,139900,bmi
2024-06-14,249,409600,1644.98,298,563700,1892,-154100,bmi
2024-06-13,423,534000,1262.41,223,479900,2152,54100,bmi
2024-06-12,659,1584000,2403.64,331,1155700,3492,428300,bmi
2024-06-11,516,1024700,1985.85,343,1141600,3328,-116900,bmi
2024-06-10,436,900500,2065.37,313,867600,2772,32900,bmi
2024-06-07,596,1133500,1901.85,414,1145100,2766,-11600,bmi
2024-06-06,508,734000,1444.88,373,835900,2241,-101900,bmi
2024-06-05,882,1763200,1999.09,1001,2066600,2065,-303400,bmi
2024-06-04,432,1231400,2850.46,377,828400,2197,403000,bmi
2024-06-03,487,834200,1712.94,391,854200,2185,-20000,bmi
2024-05-31,292,524800,1797.26,289,703400,2434,-178600,bmi
2024-05-30,628,1418300,2258.44,402,1179400,2934,238900,bmi
2024-05-29,382,922400,2414.66,472,1131600,2397,-209200,bmi
2024-05-28,737,1565700,2124.42,630,1660400,2636,-94700,bmi
2024-05-27,636,1797100,2825.63,724,1772900,2449,24200,bmi
2024-05-24,1035,2109800,2038.45,1016,2140800,2107,-31000,bmi
2024-05-23,874,3040600,3478.95,550,1532000,2785,1508600,bmi
2024-05-22,667,1001900,1502.1,560,1296800,2316,-294900,bmi
2024-05-21,534,674900,1263.86,295,898600,3046,-223700,bmi
2024-05-20,1354,2497900,1844.83,513,1770400,3451,727500,bmi
2024-05-17,140,145300,1037.86,134,250800,1872,-105500,bmi
2024-05-16,167,224200,1342.51,113,278700,2466,-54500,bmi
2024-05-15,203,266700,1313.79,115,284100,2470,-17400,bmi
2024-05-14,132,295800,2240.91,97,226000,2330,69800,bmi
2024-05-13,140,214100,1529.29,98,218300,2228,-4200,bmi
2024-05-10,112,155800,1391.07,172,297100,1727,-141300,bmi
2024-05-09,132,276000,2090.91,184,313400,1703,-37400,bmi
2024-05-08,113,147500,1305.31,91,209800,2305,-62300,bmi
2024-05-07,164,305500,1862.8,197,382400,1941,-76900,bmi
2024-05-06,107,126600,1183.18,109,119300,1094,7300,bmi
2024-05-03,106,131400,1239.62,99,169000,1707,-37600,bmi
2024-05-02,87,122700,1410.34,71,129400,1823,-6700,bmi
2024-04-26,89,85600,961.8,104,66300,638,19300,bmi
2024-04-25,61,48700,798.36,85,70900,834,-22200,bmi
2024-04-24,65,101700,1564.62,120,126100,1051,-24400,bmi
2024-04-23,91,145800,1602.2,109,136000,1248,9800,bmi
2024-04-22,122,244900,2007.38,217,305300,1407,-60400,bmi
2024-04-19,213,359700,1688.73,232,353100,1522,6600,bmi
2024-04-17,141,223100,1582.27,130,143800,1106,79300,bmi
2024-04-16,381,529200,1388.98,210,353000,1681,176200,bmi
2024-04-15,221,314300,1422.17,176,233200,1325,81100,bmi
2024-04-12,132,106300,805.3,108,107900,999,-1600,bmi
2024-04-11,231,296500,1283.55,143,195000,1364,101500,bmi
2024-04-10,99,106100,1071.72,97,132500,1366,-26400,bmi
2024-04-09,265,320600,1209.81,123,153300,1246,167300,bmi
2024-04-08,152,248900,1637.5,111,175300,1579,73600,bmi
2024-04-05,179,233200,1302.79,128,210600,1645,22600,bmi
2024-04-04,146,227800,1560.27,152,318500,2095,-90700,bmi
2024-04-03,134,184700,1378.36,149,234800,1576,-50100,bmi
2024-04-02,171,267300,1563.16,181,341500,1887,-74200,bmi
2024-04-01,205,295800,1442.93,186,291800,1569,4000,bmi
2024-03-29,177,329300,1860.45,128,237000,1852,92300,bmi
2024-03-28,143,191800,1341.26,178,357000,2006,-165200,bmi
2024-03-27,125,240400,1923.2,190,338100,1779,-97700,bmi
2024-03-26,152,308200,2027.63,215,426800,1985,-118600,bmi
2024-03-25,246,630900,2564.63,381,847900,2225,-217000,bmi
2024-03-22,298,667600,2240.27,365,657200,1801,10400,bmi
2024-03-21,186,289700,1557.53,243,379100,1560,-89400,bmi
2024-03-20,178,254700,1430.9,171,334300,1955,-79600,bmi
2024-03-19,345,569000,1649.28,236,517800,2194,51200,bmi
2024-03-18,359,644900,1796.38,382,785300,2056,-140400,bmi
2024-03-15,414,947100,2287.68,552,842300,1526,104800,bmi
2024-03-14,486,959800,1974.9,264,506000,1917,453800,bmi
2024-03-13,220,430000,1954.55,156,437600,2805,-7600,bmi
2024-03-12,239,339800,1421.76,142,324300,2284,15500,bmi
2024-03-11,190,590500,3107.89,174,560100,3219,30400,bmi
2024-03-08,239,562700,2354.39,303,556900,1838,5800,bmi
2024-03-07,241,645500,2678.42,204,613200,3006,32300,bmi
2024-03-06,217,344900,1589.4,257,540800,2104,-195900,bmi
2024-03-05,193,419900,2175.65,240,563800,2349,-143900,bmi
2024-03-04,233,399100,1712.88,309,483200,1564,-84100,bmi
2024-03-01,197,408400,2073.1,184,349100,1897,59300,bmi
2024-02-29,235,352200,1498.72,234,537000,2295,-184800,bmi
2024-02-28,232,564500,2433.19,336,582500,1734,-18000,bmi
2024-02-27,202,529200,2619.8,278,520800,1873,8400,bmi
2024-02-26,207,557000,2690.82,200,337200,1686,219800,bmi
2024-02-23,401,791500,1973.82,309,722300,2338,69200,bmi
2024-02-22,277,583300,2105.78,378,791000,2093,-207700,bmi
2024-02-21,437,910300,2083.07,329,678400,2062,231900,bmi
2024-02-20,427,751300,1759.48,478,936600,1959,-185300,bmi
2024-02-19,510,1469400,2881.18,567,1313300,2316,156100,bmi
2024-02-16,760,1636400,2153.16,358,1048700,2929,587700,bmi
2024-02-15,284,381200,1342.25,224,521600,2329,-140400,bmi
2024-02-07,0,0,0.0,0,0,0,0,bmi
2024-02-06,168,529600,3152.38,204,465500,2282,64100,bmi
2024-02-05,206,460200,2233.98,223,328300,1472,131900,bmi
2024-02-02,228,409000,1793.86,232,404300,1743,4700,bmi
2024-02-01,254,469200,1847.24,205,386800,1887,82400,bmi
2024-01-31,259,506500,1955.6,238,490800,2062,15700,bmi
2024-01-30,188,307100,1633.51,195,280500,1438,26600,bmi
2024-01-29,202,446300,2209.41,168,383700,2284,62600,bmi
2024-01-26,151,273900,1813.91,143,180300,1261,93600,bmi
2024-01-25,153,261600,1709.8,130,166000,1277,95600,bmi
2024-01-24,165,272500,1651.52,176,301100,1711,-28600,bmi
2024-01-23,229,445300,1944.54,250,479700,1919,-34400,bmi
2024-01-22,185,319800,1728.65,285,468200,1643,-148400,bmi
2024-01-19,343,1023400,2983.67,704,893400,1269,130000,bmi
2024-01-18,174,347000,1994.25,162,323900,1999,23100,bmi
2024-01-17,246,611200,2484.55,276,705100,2555,-93900,bmi
2024-01-16,235,728300,3099.15,354,1479800,4180,-751500,bmi
2024-01-15,125,314600,2516.8,206,1131600,5493,-817000,bmi
2024-01-12,240,440700,1836.25,267,546200,2046,-105500,bmi
2024-01-11,333,515400,1547.75,338,719400,2128,-204000,bmi
2024-01-10,0,0,0.0,0,0,0,0,bmi
2024-01-09,210,363100,1729.05,184,451100,2452,-88000,bmi
2024-01-08,209,541200,2589.47,214,562000,2626,-20800,bmi
2024-01-05,391,874200,2235.81,352,708000,2011,166200,bmi
2024-01-04,310,560700,1808.71,227,525700,2316,35000,bmi
2024-01-03,201,356600,1774.13,133,276500,2079,80100,bmi
2024-01-02,200,289200,1446.0,168,295000,1756,-5800,bmi
2024-09-12,0,0,0.0,4,1000,250,-1000,bmj
2024-09-11,0,0,0.0,7,5700,814,-5700,bmj
2024-09-10,0,0,0.0,8,8500,1062,-8500,bmj
2024-09-09,0,0,0.0,10,4400,440,-4400,bmj
2024-09-06,0,0,0.0,10,4500,450,-4500,bmj
2024-09-05,0,0,0.0,7,1900,271,-1900,bmj
2024-09-04,0,0,0.0,6,2400,400,-2400,bmj
2024-08-30,0,0,0.0,8,2800,350,-2800,bmj
2024-08-29,0,0,0.0,9,3700,411,-3700,bmj
2024-08-28,0,0,0.0,16,11700,731,-11700,bmj
2024-08-27,0,0,0.0,9,4900,544,-4900,bmj
2024-08-26,4,700,175.0,12,10800,900,-10100,bmj
2024-08-23,2,600,300.0,2,700,350,-100,bmj
2024-08-22,2,600,300.0,3,2700,900,-2100,bmj
2024-08-21,2,100,50.0,1,600,600,-500,bmj
2024-08-20,0,0,0.0,5,3100,620,-3100,bmj
2024-08-19,3,10400,3466.67,2,6900,3450,3500,bmj
2024-08-16,1,0,0.0,6,8300,1383,-8300,bmj
2024-08-15,2,200,100.0,3,1800,600,-1600,bmj
2024-08-14,5,2800,560.0,4,2600,650,200,bmj
2024-08-13,10,3700,370.0,6,8400,1400,-4700,bmj
2024-08-12,19,7800,410.53,6,7800,1300,0,bmj
2024-08-09,1,100,100.0,9,2300,256,-2200,bmj
2024-08-08,0,0,0.0,4,2000,500,-2000,bmj
2024-08-07,1,10000,10000.0,6,1500,250,8500,bmj
2024-08-06,8,2900,362.5,9,10200,1133,-7300,bmj
2024-08-05,9,10300,1144.44,11,14900,1355,-4600,bmj
2024-08-02,0,0,0.0,6,2400,400,-2400,bmj
2024-08-01,0,0,0.0,6,6000,1000,-6000,bmj
2024-07-31,0,0,0.0,5,1900,380,-1900,bmj
2024-07-30,0,0,0.0,7,5400,771,-5400,bmj
2024-07-29,0,0,0.0,10,4900,490,-4900,bmj
2024-07-26,8,2100,262.5,10,11900,1190,-9800,bmj
2024-07-25,8,2300,287.5,8,2400,300,-100,bmj
2024-07-24,5,2700,540.0,11,5700,518,-3000,bmj
2024-07-23,7,2200,314.29,7,5000,714,-2800,bmj
2024-07-22,9,4000,444.44,4,2900,725,1100,bmj
2024-07-19,13,17200,1323.08,13,11100,854,6100,bmj
2024-07-18,13,5500,423.08,8,3600,450,1900,bmj
2024-07-17,14,16800,1200.0,11,8900,809,7900,bmj
2024-07-16,4,2300,575.0,19,8400,442,-6100,bmj
2024-07-15,0,0,0.0,14,2100,150,-2100,bmj
2024-07-12,5,2200,440.0,14,3900,279,-1700,bmj
2024-07-11,13,7400,569.23,6,1900,317,5500,bmj
2024-07-10,14,18500,1321.43,10,5600,560,12900,bmj
2024-07-09,20,6900,345.0,16,20900,1306,-14000,bmj
2024-07-08,5,1500,300.0,8,2200,275,-700,bmj
2024-07-05,2,600,300.0,4,3000,750,-2400,bmj
2024-07-04,2,600,300.0,5,4200,840,-3600,bmj
2024-07-03,2,600,300.0,4,1800,450,-1200,bmj
2024-07-02,4,1700,425.0,4,1900,475,-200,bmj
2024-07-01,5,12600,2520.0,4,2300,575,10300,bmj
2024-06-28,8,19700,2462.5,3,1900,633,17800,bmj
2024-06-27,10,15700,1570.0,3,18800,6267,-3100,bmj
2024-06-26,13,7200,553.85,3,1300,433,5900,bmj
2024-06-25,20,16300,815.0,2,1100,550,15200,bmj
2024-06-24,13,16300,1253.85,3,19600,6533,-3300,bmj
2024-06-21,27,26600,985.19,12,28500,2375,-1900,bmj
2024-06-20,7,11500,1642.86,8,20600,2575,-9100,bmj
2024-06-19,18,4500,250.0,28,14900,532,-10400,bmj
2024-06-18,6,2600,433.33,9,21600,2400,-19000,bmj
2024-06-17,8,13400,1675.0,6,2700,450,10700,bmj
2024-06-14,15,8300,553.33,20,12500,625,-4200,bmj
2024-06-13,30,51600,1720.0,22,16400,745,35200,bmj
2024-06-12,14,17400,1242.86,1,100,100,17300,bmj
2024-06-11,16,19100,1193.75,5,4500,900,14600,bmj
2024-06-10,13,5300,407.69,4,20000,5000,-14700,bmj
2024-06-07,10,7800,780.0,7,3500,500,4300,bmj
2024-06-06,15,16400,1093.33,6,21100,3517,-4700,bmj
2024-06-05,14,6100,435.71,10,2500,250,3600,bmj
2024-06-04,12,12300,1025.0,7,4500,643,7800,bmj
2024-06-03,12,17500,1458.33,8,5300,662,12200,bmj
2024-05-31,3,23000,7666.67,5,20000,4000,3000,bmj
2024-05-30,4,15000,3750.0,3,3500,1167,11500,bmj
2024-05-29,6,24300,4050.0,10,14300,1430,10000,bmj
2024-05-28,2,10100,5050.0,3,3000,1000,7100,bmj
2024-05-27,3,12000,4000.0,5,5900,1180,6100,bmj
2024-05-24,5,11200,2240.0,9,6000,667,5200,bmj
2024-05-23,2,2100,1050.0,8,10400,1300,-8300,bmj
2024-05-22,3,2100,700.0,2,4400,2200,-2300,bmj
2024-05-21,11,17000,1545.45,7,9100,1300,7900,bmj
2024-05-20,2,2000,1000.0,7,8300,1186,-6300,bmj
2024-05-17,2,11000,5500.0,6,9300,1550,1700,bmj
2024-05-16,5,12200,2440.0,6,8800,1467,3400,bmj
2024-05-15,8,4800,600.0,5,2000,400,2800,bmj
2024-05-14,9,6100,677.78,6,3900,650,2200,bmj
2024-05-13,6,15300,2550.0,5,5500,1100,9800,bmj
2024-05-10,11,13300,1209.09,5,4800,960,8500,bmj
2024-05-09,4,1200,300.0,8,7200,900,-6000,bmj
2024-05-08,3,1300,433.33,8,10500,1312,-9200,bmj
2024-05-07,1,1000,1000.0,7,5300,757,-4300,bmj
2024-05-06,4,6000,1500.0,10,7900,790,-1900,bmj
2024-05-03,1,100,100.0,8,4700,588,-4600,bmj
2024-05-02,1,100,100.0,7,6300,900,-6200,bmj
2024-04-26,1,1000,1000.0,7,6100,871,-5100,bmj
2024-04-25,3,300,100.0,5,6700,1340,-6400,bmj
2024-04-24,2,300,150.0,4,5600,1400,-5300,bmj
2024-04-23,2,200,100.0,5,8600,1720,-8400,bmj
2024-04-22,0,0,0.0,6,4400,733,-4400,bmj
2024-04-19,1,100,100.0,7,9100,1300,-9000,bmj
2024-04-17,1,100,100.0,4,4700,1175,-4600,bmj
2024-04-16,1,100,100.0,9,23300,2589,-23200,bmj
2024-04-15,2,1200,600.0,7,18600,2657,-17400,bmj
2024-04-12,2,1200,600.0,5,2400,480,-1200,bmj
2024-04-11,2,1200,600.0,6,18600,3100,-17400,bmj
2024-04-10,4,1600,400.0,5,5700,1140,-4100,bmj
2024-04-09,3,300,100.0,9,7500,833,-7200,bmj
2024-04-08,6,2300,383.33,10,5800,580,-3500,bmj
2024-04-05,3,1500,500.0,7,2300,329,-800,bmj
2024-04-04,4,11400,2850.0,8,1100,138,10300,bmj
2024-04-03,5,1500,300.0,10,23300,2330,-21800,bmj
2024-04-02,5,12200,2440.0,9,3700,411,8500,bmj
2024-04-01,4,7000,1750.0,8,3900,488,3100,bmj
2024-03-29,9,53200,5911.11,5,2000,400,51200,bmj
2024-03-28,13,55400,4261.54,7,2500,357,52900,bmj
2024-03-27,15,11400,760.0,8,4700,588,6700,bmj
2024-03-26,16,8400,525.0,2,400,200,8000,bmj
2024-03-25,11,14500,1318.18,6,18600,3100,-4100,bmj
2024-03-22,7,12400,1771.43,3,1500,500,10900,bmj
2024-03-21,15,8100,540.0,18,10600,589,-2500,bmj
2024-03-20,8,7100,887.5,4,2600,650,4500,bmj
2024-03-19,5,4600,920.0,10,4900,490,-300,bmj
2024-03-18,2,1200,600.0,10,6000,600,-4800,bmj
2024-03-15,2,1200,600.0,4,2100,525,-900,bmj
2024-03-14,9,11800,1311.11,7,3000,429,8800,bmj
2024-03-13,11,16100,1463.64,9,4200,467,11900,bmj
2024-03-12,5,1400,280.0,6,2100,350,-700,bmj
2024-03-11,16,8700,543.75,6,2000,333,6700,bmj
2024-03-08,12,34300,2858.33,21,19300,919,15000,bmj
2024-03-07,4,1600,400.0,13,20700,1592,-19100,bmj
2024-03-06,10,2300,230.0,8,9100,1138,-6800,bmj
2024-03-05,9,7900,877.78,3,3000,1000,4900,bmj
2024-03-04,33,7600,230.3,18,13800,767,-6200,bmj
2024-03-01,9,3500,388.89,8,6200,775,-2700,bmj
2024-02-29,4,600,150.0,8,12700,1588,-12100,bmj
2024-02-28,6,2700,450.0,10,11000,1100,-8300,bmj
2024-02-27,1,100,100.0,10,10700,1070,-10600,bmj
2024-02-26,0,0,0.0,8,5000,625,-5000,bmj
2024-02-23,1,100,100.0,10,5500,550,-5400,bmj
2024-02-22,0,0,0.0,11,9900,900,-9900,bmj
2024-02-21,0,0,0.0,15,7800,520,-7800,bmj
2024-02-20,0,0,0.0,15,7200,480,-7200,bmj
2024-02-19,11,11000,1000.0,25,12600,504,-1600,bmj
2024-02-16,2,1000,500.0,17,15700,924,-14700,bmj
2024-02-15,20,24800,1240.0,19,21500,1132,3300,bmj
2024-02-07,3,600,200.0,14,6300,450,-5700,bmj
2024-02-06,0,0,0.0,6,2600,433,-2600,bmj
2024-02-05,0,0,0.0,9,3000,333,-3000,bmj
2024-02-02,2,1500,750.0,11,2500,227,-1000,bmj
2024-02-01,0,0,0.0,3,700,233,-700,bmj
2024-01-31,0,0,0.0,3,5400,1800,-5400,bmj
2024-01-30,1,200,200.0,2,300,150,-100,bmj
2024-01-29,3,1100,366.67,6,1800,300,-700,bmj
2024-01-26,0,0,0.0,8,6100,762,-6100,bmj
2024-01-25,0,0,0.0,4,800,200,-800,bmj
2024-01-24,2,200,100.0,2,300,150,-100,bmj
2024-01-23,1,100,100.0,3,600,200,-500,bmj
2024-01-22,1,100,100.0,2,500,250,-400,bmj
2024-01-19,0,0,0.0,2,400,200,-400,bmj
2024-01-18,3,300,100.0,3,1500,500,-1200,bmj
2024-01-17,4,1400,350.0,2,300,150,1100,bmj
2024-01-16,1,100,100.0,3,300,100,-200,bmj
2024-01-15,5,700,140.0,5,5000,1000,-4300,bmj
2024-01-12,3,400,133.33,4,2100,525,-1700,bmj
2024-01-11,6,4100,683.33,6,4000,667,100,bmj
2024-01-10,2,200,100.0,5,4400,880,-4200,bmj
2024-01-09,4,500,125.0,4,4300,1075,-3800,bmj
2024-01-08,8,11700,1462.5,8,5300,662,6400,bmj
2024-01-05,5,1200,240.0,3,700,233,500,bmj
2024-01-04,3,900,300.0,3,700,233,200,bmj
2024-01-03,3,300,100.0,3,800,267,-500,bmj
2024-01-02,3,1300,433.33,7,3900,557,-2600,bmj
2024-09-12,3,800,266.67,4,1000,250,-200,bmn
2024-09-11,2,600,300.0,3,1200,400,-600,bmn
2024-09-10,3,900,300.0,6,1900,317,-1000,bmn
2024-09-09,5,1200,240.0,8,2200,275,-1000,bmn
2024-09-06,3,800,266.67,4,1200,300,-400,bmn
2024-09-05,4,1800,450.0,6,3400,567,-1600,bmn
2024-09-04,5,900,180.0,4,1600,400,-700,bmn
2024-08-30,3,500,166.67,6,2500,417,-2000,bmn
2024-08-29,4,2600,650.0,5,1500,300,1100,bmn
2024-08-28,3,400,133.33,3,1200,400,-800,bmn
2024-08-27,5,500,100.0,5,1800,360,-1300,bmn
2024-08-26,5,800,160.0,9,2800,311,-2000,bmn
2024-08-23,7,900,128.57,5,2100,420,-1200,bmn
2024-08-22,5,900,180.0,4,1400,350,-500,bmn
2024-08-21,3,500,166.67,4,2400,600,-1900,bmn
2024-08-20,3,1000,333.33,2,1600,800,-600,bmn
2024-08-19,3,700,233.33,2,2600,1300,-1900,bmn
2024-08-16,2,400,200.0,4,2400,600,-2000,bmn
2024-08-15,2,400,200.0,1,600,600,-200,bmn
2024-08-14,2,400,200.0,4,2400,600,-2000,bmn
2024-08-13,2,400,200.0,4,3100,775,-2700,bmn
2024-08-12,2,400,200.0,2,1100,550,-700,bmn
2024-08-09,3,400,133.33,3,2100,700,-1700,bmn
2024-08-08,3,700,233.33,2,1600,800,-900,bmn
2024-08-07,2,500,250.0,2,1500,750,-1000,bmn
2024-08-06,2,500,250.0,1,500,500,0,bmn
2024-08-05,3,2700,900.0,1,500,500,2200,bmn
2024-08-02,2,500,250.0,2,1000,500,-500,bmn
2024-08-01,2,500,250.0,1,500,500,0,bmn
2024-07-31,3,2700,900.0,2,2300,1150,400,bmn
2024-07-30,2,500,250.0,1,500,500,0,bmn
2024-07-29,2,500,250.0,1,500,500,0,bmn
2024-07-26,3,900,300.0,1,500,500,400,bmn
2024-07-25,2,500,250.0,1,500,500,0,bmn
2024-07-24,3,500,166.67,1,500,500,0,bmn
2024-07-23,3,2500,833.33,2,2300,1150,200,bmn
2024-07-22,2,500,250.0,1,500,500,0,bmn
2024-07-19,3,1500,500.0,3,2300,767,-800,bmn
2024-07-18,3,700,233.33,2,600,300,100,bmn
2024-07-17,2,600,300.0,3,1100,367,-500,bmn
2024-07-16,2,600,300.0,1,500,500,100,bmn
2024-07-15,2,600,300.0,6,3700,617,-3100,bmn
2024-07-12,3,1600,533.33,2,1000,500,600,bmn
2024-07-11,3,700,233.33,3,1400,467,-700,bmn
2024-07-10,2,600,300.0,2,1000,500,-400,bmn
2024-07-09,2,600,300.0,2,2300,1150,-1700,bmn
2024-07-08,3,200,66.67,2,1000,500,-800,bmn
2024-07-05,3,400,133.33,2,200,100,200,bmn
2024-07-04,7,1100,157.14,1,300,300,800,bmn
2024-07-03,5,1500,300.0,6,2900,483,-1400,bmn
2024-07-02,5,1900,380.0,4,2000,500,-100,bmn
2024-07-01,4,1200,300.0,2,900,450,300,bmn
2024-06-28,5,1300,260.0,3,2400,800,-1100,bmn
2024-06-27,7,1500,214.29,3,1000,333,500,bmn
2024-06-26,8,2000,250.0,3,900,300,1100,bmn
2024-06-25,5,800,160.0,2,600,300,200,bmn
2024-06-24,7,2200,314.29,2,2300,1150,-100,bmn
2024-06-21,10,1300,130.0,5,3000,600,-1700,bmn
2024-06-20,6,1100,183.33,4,1600,400,-500,bmn
2024-06-19,5,1200,240.0,4,2100,525,-900,bmn
2024-06-18,4,600,150.0,4,2000,500,-1400,bmn
2024-06-17,9,600,66.67,2,1000,500,-400,bmn
2024-06-14,9,2000,222.22,7,2200,314,-200,bmn
2024-06-13,5,1300,260.0,5,2000,400,-700,bmn
2024-06-12,11,12600,1145.45,8,3600,450,9000,bmn
2024-06-11,4,2700,675.0,6,2800,467,-100,bmn
2024-06-10,8,1500,187.5,4,1700,425,-200,bmn
2024-06-07,8,1600,200.0,4,1300,325,300,bmn
2024-06-06,11,1600,145.45,8,2600,325,-1000,bmn
2024-06-05,7,1200,171.43,3,700,233,500,bmn
2024-06-04,5,2200,440.0,3,700,233,1500,bmn
2024-06-03,6,1900,316.67,8,4000,500,-2100,bmn
2024-05-31,5,200,40.0,3,2300,767,-2100,bmn
2024-05-30,9,1200,133.33,5,4800,960,-3600,bmn
2024-05-29,5,1300,260.0,1,1500,1500,-200,bmn
2024-05-28,11,3200,290.91,4,2700,675,500,bmn
2024-05-27,3,1300,433.33,4,3000,750,-1700,bmn
2024-05-24,8,3100,387.5,3,1700,567,1400,bmn
2024-05-23,8,13700,1712.5,6,3700,617,10000,bmn
2024-05-22,5,3200,640.0,8,4900,612,-1700,bmn
2024-05-21,2,600,300.0,4,4000,1000,-3400,bmn
2024-05-20,4,700,175.0,3,2700,900,-2000,bmn
2024-05-17,5,1500,300.0,1,1800,1800,-300,bmn
2024-05-16,3,1000,333.33,3,3800,1267,-2800,bmn
2024-05-15,1,500,500.0,4,4100,1025,-3600,bmn
2024-05-14,1,500,500.0,3,3800,1267,-3300,bmn
2024-05-13,9,4000,444.44,3,3800,1267,200,bmn
2024-05-10,7,1300,185.71,4,4300,1075,-3000,bmn
2024-05-09,2,400,200.0,3,3800,1267,-3400,bmn
2024-05-08,2,200,100.0,3,3300,1100,-3100,bmn
2024-05-07,2,2100,1050.0,3,2500,833,-400,bmn
2024-05-06,2,600,300.0,3,4400,1467,-3800,bmn
2024-05-03,0,0,0.0,3,2500,833,-2500,bmn
2024-05-02,2,13300,6650.0,2,1100,550,12200,bmn
2024-04-26,1,500,500.0,4,1900,475,-1400,bmn
2024-04-25,1,500,500.0,2,1500,750,-1000,bmn
2024-04-24,1,500,500.0,2,2800,1400,-2300,bmn
2024-04-23,1,500,500.0,6,4200,700,-3700,bmn
2024-04-22,1,500,500.0,2,2800,1400,-2300,bmn
2024-04-19,1,500,500.0,3,2100,700,-1600,bmn
2024-04-17,1,500,500.0,4,4300,1075,-3800,bmn
2024-04-16,1,500,500.0,1,1000,1000,-500,bmn
2024-04-15,3,1600,533.33,1,1000,1000,600,bmn
2024-04-12,3,600,200.0,3,3800,1267,-3200,bmn
2024-04-11,4,1900,475.0,4,4700,1175,-2800,bmn
2024-04-10,3,500,166.67,3,2900,967,-2400,bmn
2024-04-09,2,600,300.0,5,5800,1160,-5200,bmn
2024-04-08,2,2500,1250.0,5,6300,1260,-3800,bmn
2024-04-05,3,2500,833.33,5,6400,1280,-3900,bmn
2024-04-04,0,0,0.0,1,1000,1000,-1000,bmn
2024-04-03,1,500,500.0,2,2000,1000,-1500,bmn
2024-04-02,1,500,500.0,3,3800,1267,-3300,bmn
2024-04-01,2,600,300.0,2,2000,1000,-1400,bmn
2024-03-29,1,500,500.0,3,3800,1267,-3300,bmn
2024-03-28,1,500,500.0,2,2000,1000,-1500,bmn
2024-03-27,1,500,500.0,2,2000,1000,-1500,bmn
2024-03-26,1,1000,1000.0,2,2000,1000,-1000,bmn
2024-03-25,1,500,500.0,3,4500,1500,-4000,bmn
2024-03-22,1,500,500.0,2,2000,1000,-1500,bmn
2024-03-21,1,500,500.0,2,2000,1000,-1500,bmn
2024-03-20,1,300,300.0,3,3800,1267,-3500,bmn
2024-03-19,1,300,300.0,1,1000,1000,-700,bmn
2024-03-18,1,500,500.0,2,2000,1000,-1500,bmn
2024-03-15,2,1000,500.0,2,1500,750,-500,bmn
2024-03-14,2,200,100.0,2,1000,500,-800,bmn
2024-03-13,3,1300,433.33,5,2200,440,-900,bmn
2024-03-12,1,1000,1000.0,4,4700,1175,-3700,bmn
2024-03-11,1,1000,1000.0,3,2100,700,-1100,bmn
2024-03-08,2,3000,1500.0,4,3900,975,-900,bmn
2024-03-07,3,3200,1066.67,6,4700,783,-1500,bmn
2024-03-06,3,3000,1000.0,3,2100,700,900,bmn
2024-03-05,5,3000,600.0,3,2100,700,900,bmn
2024-03-04,4,4200,1050.0,5,2300,460,1900,bmn
2024-03-01,3,4000,1333.33,3,2100,700,1900,bmn
2024-02-29,3,4000,1333.33,3,2100,700,1900,bmn
2024-02-28,3,3000,1000.0,3,2100,700,900,bmn
2024-02-27,3,3000,1000.0,5,2100,420,900,bmn
2024-02-26,5,3000,600.0,6,3000,500,0,bmn
2024-02-23,5,3300,660.0,4,3900,975,-600,bmn
2024-02-22,1,1000,1000.0,3,3800,1267,-2800,bmn
2024-02-21,1,1000,1000.0,2,2000,1000,-1000,bmn
2024-02-20,2,1000,500.0,2,2000,1000,-1000,bmn
2024-02-19,2,1500,750.0,3,2000,667,-500,bmn
2024-02-16,3,1500,500.0,2,2000,1000,-500,bmn
2024-02-15,2,1500,750.0,3,3800,1267,-2300,bmn
2024-02-07,2,1500,750.0,3,3800,1267,-2300,bmn
2024-02-06,2,1500,750.0,3,3800,1267,-2300,bmn
2024-02-05,4,1500,375.0,3,3800,1267,-2300,bmn
2024-02-02,2,1000,500.0,4,4800,1200,-3800,bmn
2024-02-01,1,1000,1000.0,3,3800,1267,-2800,bmn
2024-01-31,1,1000,1000.0,3,3800,1267,-2800,bmn
2024-01-30,2,1200,600.0,3,4400,1467,-3200,bmn
2024-01-29,1,1000,1000.0,3,3800,1267,-2800,bmn
2024-01-26,2,1500,750.0,3,3800,1267,-2300,bmn
2024-01-25,3,2500,833.33,3,3800,1267,-1300,bmn
2024-01-24,4,3500,875.0,3,3800,1267,-300,bmn
2024-01-23,3,3500,1166.67,3,3800,1267,-300,bmn
2024-01-22,3,2000,666.67,2,2000,1000,0,bmn
2024-01-19,3,2000,666.67,3,3800,1267,-1800,bmn
2024-01-18,3,4500,1500.0,5,6700,1340,-2200,bmn
2024-01-17,3,3000,1000.0,5,6700,1340,-3700,bmn
2024-01-16,3,2500,833.33,3,3400,1133,-900,bmn
2024-01-15,3,1900,633.33,4,5200,1300,-3300,bmn
2024-01-12,5,11200,2240.0,5,16300,3260,-5100,bmn
2024-01-11,1,1000,1000.0,4,9200,2300,-8200,bmn
2024-01-10,3,3000,1000.0,4,6700,1675,-3700,bmn
2024-01-09,3,4000,1333.33,3,6200,2067,-2200,bmn
2024-01-08,5,5900,1180.0,4,7200,1800,-1300,bmn
2024-01-05,3,2200,733.33,3,6200,2067,-4000,bmn
2024-01-04,3,3000,1000.0,3,3300,1100,-300,bmn
2024-01-03,2,2000,1000.0,4,6700,1675,-4700,bmn
2024-01-02,4,5000,1250.0,5,4300,860,700,bmn
2024-09-12,629,561500,892.69,1063,734200,691,-172700,bmp
2024-09-11,816,411700,504.53,895,551700,616,-140000,bmp
2024-09-10,1016,940000,925.2,1504,957500,637,-17500,bmp
2024-09-09,355,160100,450.99,250,137800,551,22300,bmp
2024-09-06,594,495400,834.01,428,286100,668,209300,bmp
2024-09-05,354,158400,447.46,317,237500,749,-79100,bmp
2024-09-04,351,172300,490.88,233,154200,662,18100,bmp
2024-08-30,488,213900,438.32,241,162900,676,51000,bmp
2024-08-29,460,185800,403.91,338,222200,657,-36400,bmp
2024-08-28,316,172800,546.84,309,183700,594,-10900,bmp
2024-08-27,393,309800,788.3,386,295500,766,14300,bmp
2024-08-26,342,251300,734.8,488,382900,785,-131600,bmp
2024-08-23,396,263700,665.91,544,347800,639,-84100,bmp
2024-08-22,772,742200,961.4,1187,768500,647,-26300,bmp
2024-08-21,632,405900,642.25,722,464200,643,-58300,bmp
2024-08-20,527,326300,619.17,662,446500,674,-120200,bmp
2024-08-19,366,237700,649.45,593,333600,563,-95900,bmp
2024-08-16,1289,1072200,831.81,1667,960700,576,111500,bmp
2024-08-15,450,261400,580.89,609,303900,499,-42500,bmp
2024-08-14,416,169800,408.17,395,207100,524,-37300,bmp
2024-08-13,439,232500,529.61,515,244200,474,-11700,bmp
2024-08-12,542,388400,716.61,497,220200,443,168200,bmp
2024-08-08,484,272600,563.22,307,174000,567,98600,bmp
2024-08-07,417,184000,441.25,219,131300,600,52700,bmp
2024-08-06,535,324800,607.1,460,227100,494,97700,bmp
2024-08-05,768,387700,504.82,427,338900,794,48800,bmp
2024-08-02,719,428100,595.41,396,266000,672,162100,bmp
2024-08-01,651,430800,661.75,585,434900,743,-4100,bmp
2024-07-31,373,343100,919.84,369,261700,709,81400,bmp
2024-07-30,351,331100,943.3,432,293000,678,38100,bmp
2024-07-29,482,402100,834.23,444,228700,515,173400,bmp
2024-07-26,405,277800,685.93,319,184500,578,93300,bmp
2024-07-25,442,273900,619.68,246,246900,1004,27000,bmp
2024-07-24,661,465400,704.08,573,457300,798,8100,bmp
2024-07-22,651,450000,691.24,550,424500,772,25500,bmp
2024-07-19,669,405500,606.13,528,435200,824,-29700,bmp
2024-07-18,415,310500,748.19,493,303600,616,6900,bmp
2024-07-17,983,1243700,1265.21,1618,1125500,696,118200,bmp
2024-07-16,537,349800,651.4,404,292100,723,57700,bmp
2024-07-15,782,357000,456.52,582,366200,629,-9200,bmp
2024-07-12,493,249100,505.27,306,195100,638,54000,bmp
2024-07-11,669,363900,543.95,498,357900,719,6000,bmp
2024-07-10,698,375800,538.4,467,323600,693,52200,bmp
2024-07-09,821,509100,620.1,384,374000,974,135100,bmp
2024-07-08,838,349000,416.47,481,228600,475,120400,bmp
2024-07-05,672,272000,404.76,370,208900,565,63100,bmp
2024-07-04,404,181700,449.75,390,213900,548,-32200,bmp
2024-07-03,871,584800,671.41,495,259200,524,325600,bmp
2024-07-02,964,652400,676.76,580,399500,689,252900,bmp
2024-07-01,921,561100,609.23,982,450700,459,110400,bmp
2024-06-28,800,411100,513.88,826,389400,471,21700,bmp
2024-06-27,507,240300,473.96,368,275100,748,-34800,bmp
2024-06-26,549,303800,553.37,437,302600,692,1200,bmp
2024-06-25,419,312300,745.35,509,290000,570,22300,bmp
2024-06-24,740,412600,557.57,425,360900,849,51700,bmp
2024-06-21,530,352100,664.34,625,429000,686,-76900,bmp
2024-06-20,363,408200,1124.52,837,534300,638,-126100,bmp
2024-06-19,440,281000,638.64,570,265600,466,15400,bmp
2024-06-18,482,251200,521.16,521,193600,372,57600,bmp
2024-06-17,585,318200,543.93,601,330100,549,-11900,bmp
2024-06-14,537,348100,648.23,606,320200,528,27900,bmp
2024-06-13,798,402000,503.76,814,340800,419,61200,bmp
2024-06-12,876,450700,514.5,646,388900,602,61800,bmp
2024-06-11,531,287900,542.18,549,306300,558,-18400,bmp
2024-06-10,737,346700,470.42,426,298200,700,48500,bmp
2024-06-07,588,288300,490.31,391,394400,1009,-106100,bmp
2024-06-06,529,290700,549.53,817,485700,594,-195000,bmp
2024-06-05,704,541100,768.61,1068,662800,621,-121700,bmp
2024-06-04,530,404800,763.77,741,369900,499,34900,bmp
2024-06-03,585,262500,448.72,617,267500,434,-5000,bmp
2024-05-31,386,181800,470.98,351,284400,810,-102600,bmp
2024-05-30,580,247100,426.03,381,340700,894,-93600,bmp
2024-05-29,761,287300,377.53,609,366700,602,-79400,bmp
2024-05-28,307,223400,727.69,682,568700,834,-345300,bmp
2024-05-27,358,186000,519.55,409,268900,657,-82900,bmp
2024-05-24,781,456800,584.89,648,525100,810,-68300,bmp
2024-05-23,603,508800,843.78,667,331400,497,177400,bmp
2024-05-22,670,380400,567.76,572,403800,706,-23400,bmp
2024-05-21,1463,680700,465.28,678,650900,960,29800,bmp
2024-05-20,1327,517300,389.83,798,664800,833,-147500,bmp
2024-05-17,1050,503500,479.52,716,731100,1021,-227600,bmp
2024-05-16,1081,577900,534.6,898,865500,964,-287600,bmp
2024-05-15,1169,728300,623.01,662,504100,761,224200,bmp
2024-05-14,868,419900,483.76,580,497900,858,-78000,bmp
2024-05-13,685,388300,566.86,615,495400,806,-107100,bmp
2024-05-10,700,311300,444.71,465,313400,674,-2100,bmp
2024-05-09,923,828600,897.72,776,704900,908,123700,bmp
2024-05-08,1117,456700,408.86,608,522000,859,-65300,bmp
2024-05-07,852,549500,644.95,578,470100,813,79400,bmp
2024-05-06,621,334800,539.13,615,477700,777,-142900,bmp
2024-05-03,1221,828300,678.38,1183,880000,744,-51700,bmp
2024-05-02,596,430100,721.64,787,508200,646,-78100,bmp
2024-04-26,1194,772500,646.98,635,509700,803,262800,bmp
2024-04-25,879,426600,485.32,472,481600,1020,-55000,bmp
2024-04-24,546,415100,760.26,919,336100,366,79000,bmp
2024-04-23,504,380700,755.36,663,402000,606,-21300,bmp
2024-04-22,865,588200,680.0,507,433100,854,155100,bmp
2024-04-19,1887,1074000,569.16,1430,1335200,934,-261200,bmp
2024-04-17,974,545000,559.55,891,660100,741,-115100,bmp
2024-04-16,1355,754300,556.68,992,627700,633,126600,bmp
2024-04-15,714,484700,678.85,697,550100,789,-65400,bmp
2024-04-12,1585,2186300,1379.37,1565,1092100,698,1094200,bmp
2024-04-11,496,320700,646.57,384,311500,811,9200,bmp
2024-04-10,324,229900,709.57,476,358200,753,-128300,bmp
2024-04-09,490,406100,828.78,693,459500,663,-53400,bmp
2024-04-08,421,271600,645.13,657,471300,717,-199700,bmp
2024-04-05,848,552200,651.18,1074,746500,695,-194300,bmp
2024-04-04,1043,507700,486.77,664,573500,864,-65800,bmp
2024-04-03,649,350100,539.45,896,667800,745,-317700,bmp
2024-04-02,1020,990900,971.47,1555,997100,641,-6200,bmp
2024-04-01,570,421500,739.47,661,409700,620,11800,bmp
2024-03-29,851,484700,569.57,542,528700,975,-44000,bmp
2024-03-28,443,277800,627.09,781,451600,578,-173800,bmp
2024-03-27,869,586700,675.14,975,579800,595,6900,bmp
2024-03-26,731,399900,547.06,489,330300,675,69600,bmp
2024-03-25,1083,480500,443.67,802,769900,960,-289400,bmp
2024-03-22,678,397600,586.43,817,444600,544,-47000,bmp
2024-03-21,553,293200,530.2,778,412900,531,-119700,bmp
2024-03-20,862,459800,533.41,592,319500,540,140300,bmp
2024-03-19,511,329700,645.21,655,379300,579,-49600,bmp
2024-03-18,1439,878100,610.22,1234,909800,737,-31700,bmp
2024-03-15,1201,544700,453.54,668,496500,743,48200,bmp
2024-03-14,1124,633500,563.61,802,707100,882,-73600,bmp
2024-03-13,1109,727400,655.91,1267,889200,702,-161800,bmp
2024-03-12,1456,820000,563.19,885,747700,845,72300,bmp
2024-03-11,839,393200,468.65,513,340900,665,52300,bmp
2024-03-08,1406,797000,566.86,898,828600,923,-31600,bmp
2024-03-07,712,599200,841.57,724,534900,739,64300,bmp
2024-03-06,633,473300,747.71,513,458200,893,15100,bmp
2024-03-05,908,740800,815.86,875,673200,769,67600,bmp
2024-03-04,875,479900,548.46,652,482000,739,-2100,bmp
2024-03-01,958,506000,528.18,641,470200,734,35800,bmp
2024-02-29,1285,953600,742.1,770,817700,1062,135900,bmp
2024-02-28,1154,637500,552.43,781,676000,866,-38500,bmp
2024-02-27,1020,554600,543.73,836,628000,751,-73400,bmp
2024-02-26,758,759000,1001.32,821,658100,802,100900,bmp
2024-02-23,1139,993300,872.08,980,800200,817,193100,bmp
2024-02-22,1920,1463400,762.19,1616,1126000,697,337400,bmp
2024-02-21,567,331400,584.48,465,282000,606,49400,bmp
2024-02-20,532,262000,492.48,415,242600,585,19400,bmp
2024-02-19,999,449000,449.45,488,371500,761,77500,bmp
2024-02-16,515,221800,430.68,237,176100,743,45700,bmp
2024-02-15,884,482400,545.7,894,509600,570,-27200,bmp
2024-02-07,0,0,0.0,0,0,0,0,bmp
2024-02-06,502,233100,464.34,368,413300,1123,-180200,bmp
2024-02-05,548,392000,715.33,626,427800,683,-35800,bmp
2024-02-02,471,279100,592.57,559,433500,775,-154400,bmp
2024-02-01,558,528000,946.24,775,508300,656,19700,bmp
2024-01-31,715,411400,575.38,514,348900,679,62500,bmp
2024-01-30,509,296000,581.53,356,250700,704,45300,bmp
2024-01-29,632,364200,576.27,352,321200,912,43000,bmp
2024-01-26,1207,884000,732.39,576,674100,1170,209900,bmp
2024-01-25,1295,739100,570.73,643,675300,1050,63800,bmp
2024-01-24,428,184800,431.78,423,233600,552,-48800,bmp
2024-01-23,350,164100,468.86,317,216900,684,-52800,bmp
2024-01-22,487,360600,740.45,483,328700,681,31900,bmp
2024-01-19,357,227600,637.54,276,212700,771,14900,bmp
2024-01-18,308,237000,769.48,210,174700,832,62300,bmp
2024-01-17,442,293400,663.8,577,352900,612,-59500,bmp
2024-01-16,243,135000,555.56,333,197800,594,-62800,bmp
2024-01-15,447,351900,787.25,589,486400,826,-134500,bmp
2024-01-12,430,235600,547.91,374,297400,795,-61800,bmp
2024-01-11,449,444300,989.53,622,408600,657,35700,bmp
2024-01-10,0,0,0.0,0,0,0,0,bmp
2024-01-09,429,199900,465.97,366,249000,680,-49100,bmp
2024-01-08,566,544900,962.72,564,467500,829,77400,bmp
2024-01-05,1048,558700,533.11,755,331600,439,227100,bmp
2024-01-04,897,429800,479.15,514,485700,945,-55900,bmp
2024-01-03,326,160900,493.56,320,222100,694,-61200,bmp
2024-01-02,583,672100,1152.83,550,435200,791,236900,bmp
2024-09-12,1,1400,1400.0,3,1200,400,200,bpc
2024-09-11,1,100,100.0,4,4100,1025,-4000,bpc
2024-09-10,1,1000,1000.0,3,4000,1333,-3000,bpc
2024-09-09,1,1000,1000.0,2,2500,1250,-1500,bpc
2024-09-06,0,0,0.0,2,1100,550,-1100,bpc
2024-09-05,1,100,100.0,3,2100,700,-2000,bpc
2024-09-04,15,21000,1400.0,1,100,100,20900,bpc
2024-08-30,6,6600,1100.0,1,100,100,6500,bpc
2024-08-29,15,50100,3340.0,5,44400,8880,5700,bpc
2024-08-28,5,4700,940.0,8,4800,600,-100,bpc
2024-08-27,8,5600,700.0,5,2200,440,3400,bpc
2024-08-26,15,11400,760.0,11,8900,809,2500,bpc
2024-08-23,5,3600,720.0,5,3100,620,500,bpc
2024-08-22,3,2500,833.33,4,3000,750,-500,bpc
2024-08-21,5,4800,960.0,6,5300,883,-500,bpc
2024-08-20,12,10700,891.67,8,7900,988,2800,bpc
2024-08-19,19,15300,805.26,8,12300,1538,3000,bpc
2024-08-16,19,7500,394.74,6,6500,1083,1000,bpc
2024-08-15,18,5000,277.78,7,5200,743,-200,bpc
2024-08-14,2,100,50.0,3,3000,1000,-2900,bpc
2024-08-13,10,6000,600.0,7,6400,914,-400,bpc
2024-08-12,9,1500,166.67,4,2200,550,-700,bpc
2024-08-09,3,900,300.0,2,400,200,500,bpc
2024-08-08,5,100,20.0,1,100,100,0,bpc
2024-08-07,4,1200,300.0,5,3300,660,-2100,bpc
2024-08-06,6,1800,300.0,2,700,350,1100,bpc
2024-08-05,10,3400,340.0,2,2100,1050,1300,bpc
2024-08-02,4,400,100.0,2,200,100,200,bpc
2024-08-01,3,100,33.33,4,1300,325,-1200,bpc
2024-07-31,2,2200,1100.0,2,2900,1450,-700,bpc
2024-07-30,12,200,16.67,1,100,100,100,bpc
2024-07-29,3,2600,866.67,1,100,100,2500,bpc
2024-07-26,5,700,140.0,1,100,100,600,bpc
2024-07-25,11,3700,336.36,3,400,133,3300,bpc
2024-07-24,17,2800,164.71,1,100,100,2700,bpc
2024-07-23,7,900,128.57,4,400,100,500,bpc
2024-07-22,8,300,37.5,2,200,100,100,bpc
2024-07-19,1,1000,1000.0,4,800,200,200,bpc
2024-07-18,3,300,100.0,6,4800,800,-4500,bpc
2024-07-17,4,300,75.0,6,4900,817,-4600,bpc
2024-07-16,3,1000,333.33,5,4300,860,-3300,bpc
2024-07-15,2,500,250.0,5,3500,700,-3000,bpc
2024-07-12,0,0,0.0,4,4600,1150,-4600,bpc
2024-07-11,1,100,100.0,5,5100,1020,-5000,bpc
2024-07-10,1,100,100.0,5,4600,920,-4500,bpc
2024-07-09,1,100,100.0,6,3700,617,-3600,bpc
2024-07-08,1,100,100.0,8,8900,1112,-8800,bpc
2024-07-05,2,200,100.0,7,3800,543,-3600,bpc
2024-07-04,5,4200,840.0,4,2200,550,2000,bpc
2024-07-03,6,5500,916.67,2,2100,1050,3400,bpc
2024-07-02,6,1200,200.0,5,2300,460,-1100,bpc
2024-07-01,4,2100,525.0,7,7000,1000,-4900,bpc
2024-06-28,3,1600,533.33,6,13000,2167,-11400,bpc
2024-06-27,3,1400,466.67,6,6400,1067,-5000,bpc
2024-06-26,8,4900,612.5,5,8700,1740,-3800,bpc
2024-06-25,18,18700,1038.89,5,13200,2640,5500,bpc
2024-06-24,3,1000,333.33,5,11700,2340,-10700,bpc
2024-06-21,2,3100,1550.0,4,11600,2900,-8500,bpc
2024-06-20,2,3100,1550.0,3,2600,867,500,bpc
2024-06-19,1,3000,3000.0,4,3000,750,0,bpc
2024-06-18,1,3000,3000.0,4,3700,925,-700,bpc
2024-06-17,2,4000,2000.0,4,3700,925,300,bpc
2024-06-14,3,3400,1133.33,5,3000,600,400,bpc
2024-06-13,4,3700,925.0,5,1200,240,2500,bpc
2024-06-12,4,3500,875.0,5,9500,1900,-6000,bpc
2024-06-11,1,100,100.0,7,7300,1043,-7200,bpc
2024-06-10,5,4200,840.0,4,1700,425,2500,bpc
2024-06-07,2,1200,600.0,5,3800,760,-2600,bpc
2024-06-06,3,3100,1033.33,6,4600,767,-1500,bpc
2024-06-05,5,5300,1060.0,10,10500,1050,-5200,bpc
2024-06-04,3,5200,1733.33,4,5000,1250,200,bpc
2024-06-03,4,4000,1000.0,5,5900,1180,-1900,bpc
2024-05-31,3,3700,1233.33,5,6600,1320,-2900,bpc
2024-05-30,5,4900,980.0,7,5100,729,-200,bpc
2024-05-29,5,5300,1060.0,5,4300,860,1000,bpc
2024-05-28,7,2000,285.71,4,2600,650,-600,bpc
2024-05-27,6,3300,550.0,7,4300,614,-1000,bpc
2024-05-24,5,4000,800.0,8,7000,875,-3000,bpc
2024-05-23,3,2500,833.33,5,5300,1060,-2800,bpc
2024-05-22,2,2100,1050.0,5,5200,1040,-3100,bpc
2024-05-21,3,1200,400.0,6,5400,900,-4200,bpc
2024-05-20,3,3400,1133.33,4,1900,475,1500,bpc
2024-05-17,7,3100,442.86,9,4700,522,-1600,bpc
2024-05-16,3,2800,933.33,5,3600,720,-800,bpc
2024-05-15,1,500,500.0,7,8000,1143,-7500,bpc
2024-05-14,1,100,100.0,5,3900,780,-3800,bpc
2024-05-13,0,0,0.0,3,2000,667,-2000,bpc
2024-05-10,0,0,0.0,4,1300,325,-1300,bpc
2024-05-09,1,100,100.0,6,6400,1067,-6300,bpc
2024-05-08,0,0,0.0,4,5700,1425,-5700,bpc
2024-05-07,2,600,300.0,5,8300,1660,-7700,bpc
2024-05-06,1,200,200.0,4,6500,1625,-6300,bpc
2024-05-03,1,100,100.0,2,2600,1300,-2500,bpc
2024-05-02,0,0,0.0,3,5500,1833,-5500,bpc
2024-04-26,0,0,0.0,2,3900,1950,-3900,bpc
2024-04-25,1,100,100.0,2,3600,1800,-3500,bpc
2024-04-24,2,200,100.0,6,6200,1033,-6000,bpc
2024-04-23,1,100,100.0,3,4600,1533,-4500,bpc
2024-04-22,3,300,100.0,3,4100,1367,-3800,bpc
2024-04-19,1,0,0.0,7,7100,1014,-7100,bpc
2024-04-17,3,1700,566.67,6,8000,1333,-6300,bpc
2024-04-16,1,0,0.0,5,7900,1580,-7900,bpc
2024-04-15,1,100,100.0,11,11800,1073,-11700,bpc
2024-04-12,0,0,0.0,6,7700,1283,-7700,bpc
2024-04-11,0,0,0.0,8,11300,1412,-11300,bpc
2024-04-10,12,7400,616.67,10,7400,740,0,bpc
2024-04-09,7,3100,442.86,1,100,100,3000,bpc
2024-04-08,3,1100,366.67,8,9900,1238,-8800,bpc
2024-04-05,10,5400,540.0,1,100,100,5300,bpc
2024-04-04,15,7200,480.0,6,2500,417,4700,bpc
2024-04-03,14,2300,164.29,5,2400,480,-100,bpc
2024-04-02,8,2500,312.5,4,2100,525,400,bpc
2024-04-01,16,9800,612.5,6,9200,1533,600,bpc
2024-03-29,6,500,83.33,7,4600,657,-4100,bpc
2024-03-28,6,600,100.0,5,2500,500,-1900,bpc
2024-03-27,12,2000,166.67,4,1300,325,700,bpc
2024-03-26,17,8100,476.47,7,3900,557,4200,bpc
2024-03-25,10,2400,240.0,5,10700,2140,-8300,bpc
2024-03-22,8,800,100.0,3,2600,867,-1800,bpc
2024-03-21,11,1400,127.27,7,5600,800,-4200,bpc
2024-03-20,18,60100,3338.89,8,59300,7412,800,bpc
2024-03-19,14,2500,178.57,9,1200,133,1300,bpc
2024-03-18,4,300,75.0,14,8600,614,-8300,bpc
2024-03-15,12,3100,258.33,7,7500,1071,-4400,bpc
2024-03-14,18,6600,366.67,7,8900,1271,-2300,bpc
2024-03-13,15,900,60.0,7,6700,957,-5800,bpc
2024-03-12,2,1100,550.0,7,6400,914,-5300,bpc
2024-03-11,2,1000,500.0,7,6900,986,-5900,bpc
2024-03-08,6,6200,1033.33,9,12900,1433,-6700,bpc
2024-03-07,3,4500,1500.0,8,9700,1212,-5200,bpc
2024-03-06,7,6100,871.43,13,15500,1192,-9400,bpc
2024-03-05,6,5500,916.67,6,5700,950,-200,bpc
2024-03-04,6,5200,866.67,6,9400,1567,-4200,bpc
2024-03-01,4,5100,1275.0,6,7700,1283,-2600,bpc
2024-02-29,3,500,166.67,3,14000,4667,-13500,bpc
2024-02-28,6,8500,1416.67,6,17500,2917,-9000,bpc
2024-02-27,7,7300,1042.86,8,20600,2575,-13300,bpc
2024-02-26,8,16700,2087.5,9,28800,3200,-12100,bpc
2024-02-23,4,5000,1250.0,6,18900,3150,-13900,bpc
2024-02-22,3,5000,1666.67,5,17100,3420,-12100,bpc
2024-02-21,2,3000,1500.0,6,17300,2883,-14300,bpc
2024-02-20,4,4000,1000.0,6,17300,2883,-13300,bpc
2024-02-19,3,2000,666.67,5,17100,3420,-15100,bpc
2024-02-16,7,21000,3000.0,7,31900,4557,-10900,bpc
2024-02-15,6,21100,3516.67,4,16100,4025,5000,bpc
2024-02-07,3,8100,2700.0,7,24300,3471,-16200,bpc
2024-02-06,1,6000,6000.0,6,19300,3217,-13300,bpc
2024-02-05,1,6000,6000.0,5,19200,3840,-13200,bpc
2024-02-02,1,6000,6000.0,4,16000,4000,-10000,bpc
2024-02-01,1,6000,6000.0,6,18500,3083,-12500,bpc
2024-01-31,7,11400,1628.57,5,20000,4000,-8600,bpc
2024-01-30,4,2300,575.0,6,16200,2700,-13900,bpc
2024-01-29,2,1200,600.0,6,21200,3533,-20000,bpc
2024-01-26,1,1000,1000.0,6,25700,4283,-24700,bpc
2024-01-25,1,1000,1000.0,6,16500,2750,-15500,bpc
2024-01-24,1,1000,1000.0,5,15700,3140,-14700,bpc
2024-01-23,1,100,100.0,6,19700,3283,-19600,bpc
2024-01-22,0,0,0.0,8,22200,2775,-22200,bpc
2024-01-19,0,0,0.0,6,18200,3033,-18200,bpc
2024-01-18,0,0,0.0,6,17800,2967,-17800,bpc
2024-01-17,0,0,0.0,5,25700,5140,-25700,bpc
2024-01-16,0,0,0.0,4,15700,3925,-15700,bpc
2024-01-15,0,0,0.0,4,15700,3925,-15700,bpc
2024-01-12,1,2200,2200.0,4,15700,3925,-13500,bpc
2024-01-11,1,2200,2200.0,4,15700,3925,-13500,bpc
2024-01-10,1,2200,2200.0,4,15700,3925,-13500,bpc
2024-01-09,1,2200,2200.0,5,10100,2020,-7900,bpc
2024-01-08,0,0,0.0,5,5200,1040,-5200,bpc
2024-01-05,0,0,0.0,4,5600,1400,-5600,bpc
2024-01-04,0,0,0.0,3,5100,1700,-5100,bpc
2024-01-03,1,0,0.0,3,5100,1700,-5100,bpc
2024-01-02,4,4900,1225.0,5,6600,1320,-1700,bpc
2024-09-12,27,55300,2048.15,28,67400,2407,-12100,brc
2024-09-11,50,71600,1432.0,36,55000,1528,16600,brc
2024-09-10,20,51500,2575.0,29,49900,1721,1600,brc
2024-09-09,28,37000,1321.43,28,44600,1593,-7600,brc
2024-09-06,28,28900,1032.14,26,66900,2573,-38000,brc
2024-09-05,25,22900,916.0,42,46100,1098,-23200,brc
2024-09-04,42,51700,1230.95,46,84400,1835,-32700,brc
2024-08-30,36,80800,2244.44,57,139900,2454,-59100,brc
2024-08-29,27,21400,792.59,21,60500,2881,-39100,brc
2024-08-28,50,46700,934.0,38,79200,2084,-32500,brc
2024-08-27,27,17000,629.63,26,45700,1758,-28700,brc
2024-08-26,37,46900,1267.57,42,81700,1945,-34800,brc
2024-08-23,53,70100,1322.64,52,75100,1444,-5000,brc
2024-08-22,45,84500,1877.78,76,94600,1245,-10100,brc
2024-08-21,37,38800,1048.65,41,32200,785,6600,brc
2024-08-20,44,50800,1154.55,50,51400,1028,-600,brc
2024-08-19,38,42800,1126.32,38,37800,995,5000,brc
2024-08-16,34,40500,1191.18,26,29100,1119,11400,brc
2024-08-15,31,51000,1645.16,35,43000,1229,8000,brc
2024-08-14,31,40900,1319.35,24,25600,1067,15300,brc
2024-08-13,39,68600,1758.97,30,91300,3043,-22700,brc
2024-08-12,43,23000,534.88,26,51800,1992,-28800,brc
2024-08-08,38,63600,1673.68,43,75000,1744,-11400,brc
2024-08-07,39,19300,494.87,25,87700,3508,-68400,brc
2024-08-06,60,36500,608.33,51,59400,1165,-22900,brc
2024-08-05,68,60400,888.24,63,113700,1805,-53300,brc
2024-08-02,63,73100,1160.32,66,94500,1432,-21400,brc
2024-08-01,57,39300,689.47,53,95700,1806,-56400,brc
2024-07-31,99,96100,970.71,58,87000,1500,9100,brc
2024-07-30,84,109900,1308.33,35,67300,1923,42600,brc
2024-07-29,63,69700,1106.35,35,80200,2291,-10500,brc
2024-07-26,38,34800,915.79,40,70800,1770,-36000,brc
2024-07-25,52,29400,565.38,30,31400,1047,-2000,brc
2024-07-24,41,40600,990.24,37,66900,1808,-26300,brc
2024-07-22,52,72300,1390.38,48,55800,1162,16500,brc
2024-07-19,58,267000,4603.45,77,83900,1090,183100,brc
2024-07-18,38,72800,1915.79,26,24300,935,48500,brc
2024-07-17,62,308900,4982.26,46,64400,1400,244500,brc
2024-07-16,92,208500,2266.3,51,159200,3122,49300,brc
2024-07-15,32,30000,937.5,23,19500,848,10500,brc
2024-07-12,31,47900,1545.16,24,45400,1892,2500,brc
2024-07-11,35,37000,1057.14,28,34300,1225,2700,brc
2024-07-10,15,15400,1026.67,21,12300,586,3100,brc
2024-07-09,27,21400,792.59,20,24700,1235,-3300,brc
2024-07-08,33,18700,566.67,21,21000,1000,-2300,brc
2024-07-05,27,19100,707.41,19,26000,1368,-6900,brc
2024-07-04,88,77400,879.55,43,76300,1774,1100,brc
2024-07-03,26,33500,1288.46,12,16400,1367,17100,brc
2024-07-02,22,19500,886.36,11,6900,627,12600,brc
2024-07-01,4,10100,2525.0,11,8700,791,1400,brc
2024-06-28,13,10100,776.92,11,12900,1173,-2800,brc
2024-06-27,18,25100,1394.44,16,8300,519,16800,brc
2024-06-26,15,22200,1480.0,17,19200,1129,3000,brc
2024-06-25,9,16400,1822.22,17,6700,394,9700,brc
2024-06-24,22,20900,950.0,28,31700,1132,-10800,brc
2024-06-21,15,10600,706.67,22,14400,655,-3800,brc
2024-06-20,12,11100,925.0,15,12100,807,-1000,brc
2024-06-19,15,15100,1006.67,19,8400,442,6700,brc
2024-06-18,9,29200,3244.44,15,10800,720,18400,brc
2024-06-17,12,11000,916.67,10,6700,670,4300,brc
2024-06-14,19,10200,536.84,17,15200,894,-5000,brc
2024-06-13,26,24500,942.31,19,6700,353,17800,brc
2024-06-12,32,30000,937.5,32,21000,656,9000,brc
2024-06-11,17,22700,1335.29,29,12900,445,9800,brc
2024-06-10,19,17100,900.0,17,21200,1247,-4100,brc
2024-06-07,13,7300,561.54,18,11500,639,-4200,brc
2024-06-06,9,14100,1566.67,10,9400,940,4700,brc
2024-06-05,18,28000,1555.56,21,21100,1005,6900,brc
2024-06-04,18,26700,1483.33,17,24900,1465,1800,brc
2024-06-03,25,37800,1512.0,25,28000,1120,9800,brc
2024-05-31,10,21800,2180.0,15,24900,1660,-3100,brc
2024-05-30,12,17200,1433.33,17,29300,1724,-12100,brc
2024-05-29,25,28500,1140.0,21,23100,1100,5400,brc
2024-05-28,47,67400,1434.04,41,52800,1288,14600,brc
2024-05-27,13,33200,2553.85,20,21300,1065,11900,brc
2024-05-24,11,15500,1409.09,21,15600,743,-100,brc
2024-05-23,23,51100,2221.74,35,25100,717,26000,brc
2024-05-22,12,24400,2033.33,17,19200,1129,5200,brc
2024-05-21,10,22500,2250.0,25,20400,816,2100,brc
2024-05-20,29,38000,1310.34,41,36100,880,1900,brc
2024-05-17,31,144800,4670.97,37,34000,919,110800,brc
2024-05-16,20,70300,3515.0,32,56400,1762,13900,brc
2024-05-15,14,26100,1864.29,18,34700,1928,-8600,brc
2024-05-14,23,43200,1878.26,18,46900,2606,-3700,brc
2024-05-13,40,54300,1357.5,22,56600,2573,-2300,brc
2024-05-10,26,24300,934.62,26,33700,1296,-9400,brc
2024-05-09,9,14600,1622.22,11,20500,1864,-5900,brc
2024-05-08,17,26800,1576.47,13,29400,2262,-2600,brc
2024-05-07,36,38100,1058.33,25,84100,3364,-46000,brc
2024-05-06,14,27900,1992.86,12,39500,3292,-11600,brc
2024-05-03,11,17000,1545.45,11,30100,2736,-13100,brc
2024-05-02,14,15400,1100.0,12,19600,1633,-4200,brc
2024-04-26,20,11700,585.0,23,10900,474,800,brc
2024-04-25,12,28400,2366.67,15,14700,980,13700,brc
2024-04-24,14,48300,3450.0,8,5600,700,42700,brc
2024-04-23,14,22100,1578.57,8,25500,3188,-3400,brc
2024-04-22,15,14400,960.0,14,12100,864,2300,brc
2024-04-19,44,32800,745.45,16,7500,469,25300,brc
2024-04-17,18,16000,888.89,8,13600,1700,2400,brc
2024-04-16,37,19600,529.73,22,40600,1845,-21000,brc
2024-04-15,12,7400,616.67,11,17300,1573,-9900,brc
2024-04-12,6,6300,1050.0,21,31800,1514,-25500,brc
2024-04-11,5,8900,1780.0,14,11600,829,-2700,brc
2024-04-10,6,6200,1033.33,22,22700,1032,-16500,brc
2024-04-09,11,14400,1309.09,44,33700,766,-19300,brc
2024-04-08,11,8400,763.64,20,9200,460,-800,brc
2024-04-05,14,11300,807.14,18,8700,483,2600,brc
2024-04-04,13,18100,1392.31,10,17700,1770,400,brc
2024-04-03,17,12400,729.41,19,11800,621,600,brc
2024-04-02,10,11900,1190.0,14,23600,1686,-11700,brc
2024-04-01,15,10200,680.0,14,51000,3643,-40800,brc
2024-03-29,14,6300,450.0,13,45200,3477,-38900,brc
2024-03-28,24,21600,900.0,16,50400,3150,-28800,brc
2024-03-27,10,13800,1380.0,23,51700,2248,-37900,brc
2024-03-26,14,13000,928.57,17,35000,2059,-22000,brc
2024-03-25,14,10800,771.43,17,30300,1782,-19500,brc
2024-03-22,11,12400,1127.27,12,32800,2733,-20400,brc
2024-03-21,18,9400,522.22,26,54700,2104,-45300,brc
2024-03-20,18,26700,1483.33,21,48200,2295,-21500,brc
2024-03-19,16,15900,993.75,12,28600,2383,-12700,brc
2024-03-18,22,20100,913.64,28,77200,2757,-57100,brc
2024-03-15,26,51700,1988.46,36,72200,2006,-20500,brc
2024-03-14,14,13900,992.86,23,26700,1161,-12800,brc
2024-03-13,12,13600,1133.33,27,30400,1126,-16800,brc
2024-03-12,9,8300,922.22,9,4900,544,3400,brc
2024-03-11,13,8700,669.23,22,25300,1150,-16600,brc
2024-03-08,9,6700,744.44,16,11400,712,-4700,brc
2024-03-07,20,10200,510.0,21,7100,338,3100,brc
2024-03-06,11,5300,481.82,13,10700,823,-5400,brc
2024-03-05,18,7300,405.56,18,11900,661,-4600,brc
2024-03-04,24,13300,554.17,20,21200,1060,-7900,brc
2024-03-01,25,14400,576.0,18,11900,661,2500,brc
2024-02-29,21,7300,347.62,12,10400,867,-3100,brc
2024-02-28,34,16200,476.47,13,23000,1769,-6800,brc
2024-02-27,15,10200,680.0,12,10800,900,-600,brc
2024-02-26,27,11000,407.41,23,45400,1974,-34400,brc
2024-02-23,36,23400,650.0,38,28200,742,-4800,brc
2024-02-22,25,12100,484.0,19,26600,1400,-14500,brc
2024-02-21,21,14400,685.71,21,29100,1386,-14700,brc
2024-02-20,21,14400,685.71,19,14800,779,-400,brc
2024-02-19,20,35500,1775.0,34,46800,1376,-11300,brc
2024-02-16,25,27700,1108.0,38,67100,1766,-39400,brc
2024-02-15,15,13100,873.33,16,11500,719,1600,brc
2024-02-07,0,0,0.0,0,0,0,0,brc
2024-02-06,15,6600,440.0,15,19000,1267,-12400,brc
2024-02-05,22,33500,1522.73,19,28500,1500,5000,brc
2024-02-02,13,11600,892.31,20,10200,510,1400,brc
2024-02-01,16,8000,500.0,22,20700,941,-12700,brc
2024-01-31,16,8600,537.5,21,24200,1152,-15600,brc
2024-01-30,18,14300,794.44,34,26000,765,-11700,brc
2024-01-29,19,21200,1115.79,22,19900,905,1300,brc
2024-01-26,25,41700,1668.0,39,29800,764,11900,brc
2024-01-25,25,34600,1384.0,28,30600,1093,4000,brc
2024-01-24,20,22400,1120.0,29,34100,1176,-11700,brc
2024-01-23,12,32200,2683.33,25,25400,1016,6800,brc
2024-01-22,19,17100,900.0,49,45500,929,-28400,brc
2024-01-19,23,33900,1473.91,48,52900,1102,-19000,brc
2024-01-18,31,48400,1561.29,44,58500,1330,-10100,brc
2024-01-17,21,14400,685.71,62,58100,937,-43700,brc
2024-01-16,22,28100,1277.27,57,53500,939,-25400,brc
2024-01-15,25,27900,1116.0,26,19600,754,8300,brc
2024-01-12,29,43200,1489.66,16,12600,788,30600,brc
2024-01-11,18,18100,1005.56,21,14400,686,3700,brc
2024-01-10,0,0,0.0,0,0,0,0,brc
2024-01-09,21,20300,966.67,35,19300,551,1000,brc
2024-01-08,28,48300,1725.0,19,46900,2468,1400,brc
2024-01-05,17,13100,770.59,29,16500,569,-3400,brc
2024-01-04,19,16400,863.16,18,9400,522,7000,brc
2024-01-03,11,6000,545.45,16,8000,500,-2000,brc
2024-01-02,15,14900,993.33,14,7100,507,7800,brc
2024-09-12,2,100,50.0,4,1600,400,-1500,brs
2024-09-11,2,100,50.0,5,1300,260,-1200,brs
2024-09-10,2,1000,500.0,6,1900,317,-900,brs
2024-09-09,3,200,66.67,6,1000,167,-800,brs
2024-09-06,3,300,100.0,2,1500,750,-1200,brs
2024-09-05,4,1000,250.0,2,400,200,600,brs
2024-09-04,5,4900,980.0,3,500,167,4400,brs
2024-08-30,11,14300,1300.0,4,500,125,13800,brs
2024-08-29,7,16000,2285.71,3,700,233,15300,brs
2024-08-28,3,9800,3266.67,3,1100,367,8700,brs
2024-08-27,6,2200,366.67,7,1700,243,500,brs
2024-08-26,7,200,28.57,5,1500,300,-1300,brs
2024-08-23,8,3800,475.0,5,1900,380,1900,brs
2024-08-22,10,3000,300.0,3,1700,567,1300,brs
2024-08-21,17,3600,211.76,8,2800,350,800,brs
2024-08-20,5,6400,1280.0,5,1500,300,4900,brs
2024-08-19,17,3600,211.76,3,1300,433,2300,brs
2024-08-16,16,15800,987.5,7,2200,314,13600,brs
2024-08-15,0,0,0.0,2,600,300,-600,brs
2024-08-14,4,1500,375.0,4,900,225,600,brs
2024-08-13,10,1200,120.0,6,1500,250,-300,brs
2024-08-12,5,6200,1240.0,9,1900,211,4300,brs
2024-08-09,11,10600,963.64,6,2200,367,8400,brs
2024-08-08,4,400,100.0,4,900,225,-500,brs
2024-08-07,8,12200,1525.0,5,1500,300,10700,brs
2024-08-06,5,10200,2040.0,4,1900,475,8300,brs
2024-08-05,15,8100,540.0,5,1900,380,6200,brs
2024-08-02,7,5500,785.71,6,1400,233,4100,brs
2024-08-01,9,2700,300.0,5,1300,260,1400,brs
2024-07-31,12,3500,291.67,6,1900,317,1600,brs
2024-07-30,7,700,100.0,5,1100,220,-400,brs
2024-07-29,6,600,100.0,5,1100,220,-500,brs
2024-07-26,8,7000,875.0,4,1000,250,6000,brs
2024-07-25,4,2100,525.0,5,1000,200,1100,brs
2024-07-24,2,200,100.0,6,1200,200,-1000,brs
2024-07-23,6,400,66.67,5,1300,260,-900,brs
2024-07-22,4,200,50.0,2,600,300,-400,brs
2024-07-19,14,2000,142.86,5,1100,220,900,brs
2024-07-18,13,3300,253.85,5,1500,300,1800,brs
2024-07-17,11,1700,154.55,6,1500,250,200,brs
2024-07-16,13,5800,446.15,5,900,180,4900,brs
2024-07-15,16,4400,275.0,8,1800,225,2600,brs
2024-07-12,12,8100,675.0,2,700,350,7400,brs
2024-07-11,11,3200,290.91,6,1000,167,2200,brs
2024-07-10,16,6100,381.25,3,1200,400,4900,brs
2024-07-09,17,4800,282.35,7,900,129,3900,brs
2024-07-08,15,16600,1106.67,5,800,160,15800,brs
2024-07-05,12,1000,83.33,1,1000,1000,0,brs
2024-07-04,15,2500,166.67,3,800,267,1700,brs
2024-07-03,7,1000,142.86,2,200,100,800,brs
2024-07-02,11,16300,1481.82,8,900,112,15400,brs
2024-07-01,4,700,175.0,5,1700,340,-1000,brs
2024-06-28,7,1500,214.29,3,400,133,1100,brs
2024-06-27,6,1100,183.33,3,700,233,400,brs
2024-06-26,9,1200,133.33,5,1400,280,-200,brs
2024-06-25,7,200,28.57,5,1400,280,-1200,brs
2024-06-24,11,23300,2118.18,3,600,200,22700,brs
2024-06-21,13,1200,92.31,6,700,117,500,brs
2024-06-20,5,1400,280.0,1,100,100,1300,brs
2024-06-19,11,900,81.82,3,400,133,500,brs
2024-06-18,29,8600,296.55,5,500,100,8100,brs
2024-06-17,14,5700,407.14,2,1700,850,4000,brs
2024-06-14,21,6500,309.52,4,1400,350,5100,brs
2024-06-13,11,1500,136.36,4,1000,250,500,brs
2024-06-12,7,1600,228.57,6,1800,300,-200,brs
2024-06-11,5,9600,1920.0,3,2500,833,7100,brs
2024-06-10,9,4000,444.44,4,800,200,3200,brs
2024-06-07,7,2000,285.71,2,500,250,1500,brs
2024-06-06,12,6800,566.67,6,1900,317,4900,brs
2024-06-05,14,3400,242.86,4,1400,350,2000,brs
2024-06-04,23,4600,200.0,3,1900,633,2700,brs
2024-06-03,9,2000,222.22,6,3100,517,-1100,brs
2024-05-31,9,4600,511.11,5,1200,240,3400,brs
2024-05-30,12,5300,441.67,5,1800,360,3500,brs
2024-05-29,5,3400,680.0,5,2500,500,900,brs
2024-05-28,13,1800,138.46,6,2600,433,-800,brs
2024-05-27,11,4200,381.82,10,3300,330,900,brs
2024-05-24,16,6600,412.5,9,4200,467,2400,brs
2024-05-23,29,3900,134.48,9,2800,311,1100,brs
2024-05-22,24,4800,200.0,6,3200,533,1600,brs
2024-05-21,6,700,116.67,2,1200,600,-500,brs
2024-05-20,12,2500,208.33,1,700,700,1800,brs
2024-05-17,9,0,0.0,1,700,700,-700,brs
2024-05-16,18,10300,572.22,1,700,700,9600,brs
2024-05-15,3,2200,733.33,2,700,350,1500,brs
2024-05-14,1,100,100.0,2,700,350,-600,brs
2024-05-13,0,0,0.0,2,1200,600,-1200,brs
2024-05-10,1,1800,1800.0,2,1200,600,600,brs
2024-05-09,3,2100,700.0,2,1100,550,1000,brs
2024-05-08,3,0,0.0,3,2100,700,-2100,brs
2024-05-07,6,900,150.0,2,700,350,200,brs
2024-05-06,7,5100,728.57,1,800,800,4300,brs
2024-05-03,4,20100,5025.0,1,800,800,19300,brs
2024-05-02,1,0,0.0,1,800,800,-800,brs
2024-04-26,3,500,166.67,2,900,450,-400,brs
2024-04-25,1,500,500.0,1,800,800,-300,brs
2024-04-24,0,0,0.0,1,800,800,-800,brs
2024-04-23,0,0,0.0,1,600,600,-600,brs
2024-04-22,1,0,0.0,0,0,0,0,brs
2024-04-19,5,0,0.0,1,600,600,-600,brs
2024-04-17,4,800,200.0,1,600,600,200,brs
2024-04-16,9,4400,488.89,2,2000,1000,2400,brs
2024-04-15,6,200,33.33,0,0,0,200,brs
2024-04-12,9,5900,655.56,2,1300,650,4600,brs
2024-04-11,7,1600,228.57,4,1000,250,600,brs
2024-04-10,10,900,90.0,5,2200,440,-1300,brs
2024-04-09,8,4700,587.5,4,2900,725,1800,brs
2024-04-08,5,1000,200.0,0,0,0,1000,brs
2024-04-05,13,2600,200.0,3,2000,667,600,brs
2024-04-04,7,6400,914.29,1,700,700,5700,brs
2024-04-03,14,2200,157.14,2,1200,600,1000,brs
2024-04-02,11,4000,363.64,3,1100,367,2900,brs
2024-04-01,4,3100,775.0,1,700,700,2400,brs
2024-03-29,5,2600,520.0,2,1700,850,900,brs
2024-03-28,6,3600,600.0,1,700,700,2900,brs
2024-03-27,3,800,266.67,2,800,400,0,brs
2024-03-26,2,2200,1100.0,1,700,700,1500,brs
2024-03-25,3,1100,366.67,1,100,100,1000,brs
2024-03-22,6,12100,2016.67,1,700,700,11400,brs
2024-03-21,8,3600,450.0,1,100,100,3500,brs
2024-03-20,5,600,120.0,1,0,0,600,brs
2024-03-19,14,3000,214.29,1,200,200,2800,brs
2024-03-18,7,1500,214.29,4,2300,575,-800,brs
2024-03-15,1,0,0.0,1,700,700,-700,brs
2024-03-14,10,2500,250.0,4,2400,600,100,brs
2024-03-13,8,7400,925.0,2,1500,750,5900,brs
2024-03-12,0,0,0.0,1,300,300,-300,brs
2024-03-11,2,100,50.0,1,300,300,-200,brs
2024-03-08,6,100,16.67,1,300,300,-200,brs
2024-03-07,2,100,50.0,1,300,300,-200,brs
2024-03-06,5,20900,4180.0,1,300,300,20600,brs
2024-03-05,5,1100,220.0,1,300,300,800,brs
2024-03-04,5,500,100.0,2,1000,500,-500,brs
2024-03-01,6,4600,766.67,2,1000,500,3600,brs
2024-02-29,3,200,66.67,1,300,300,-100,brs
2024-02-28,12,18500,1541.67,1,300,300,18200,brs
2024-02-27,7,2000,285.71,1,300,300,1700,brs
2024-02-26,3,1100,366.67,1,300,300,800,brs
2024-02-23,10,4800,480.0,2,800,400,4000,brs
2024-02-22,2,1100,550.0,1,300,300,800,brs
2024-02-21,6,4400,733.33,1,300,300,4100,brs
2024-02-20,12,6600,550.0,2,600,300,6000,brs
2024-02-19,6,100,16.67,2,600,300,-500,brs
2024-02-16,2,1300,650.0,3,600,200,700,brs
2024-02-15,3,0,0.0,1,500,500,-500,brs
2024-02-07,1,300,300.0,2,800,400,-500,brs
2024-02-06,1,100,100.0,0,0,0,100,brs
2024-02-05,3,300,100.0,1,400,400,-100,brs
2024-02-02,2,0,0.0,1,400,400,-400,brs
2024-02-01,1,100,100.0,2,500,250,-400,brs
2024-01-31,1,200,200.0,1,400,400,-200,brs
2024-01-30,9,14300,1588.89,1,400,400,13900,brs
2024-01-29,2,200,100.0,2,1000,500,-800,brs
2024-01-26,0,0,0.0,1,400,400,-400,brs
2024-01-25,2,300,150.0,3,1100,367,-800,brs
2024-01-24,1,300,300.0,1,400,400,-100,brs
2024-01-23,1,100,100.0,1,400,400,-300,brs
2024-01-22,2,1400,700.0,2,1000,500,400,brs
2024-01-19,2,1100,550.0,1,400,400,700,brs
2024-01-18,1,500,500.0,2,1000,500,-500,brs
2024-01-17,1,400,400.0,1,400,400,0,brs
2024-01-16,3,11000,3666.67,1,400,400,10600,brs
2024-01-15,3,5500,1833.33,1,400,400,5100,brs
2024-01-12,3,5800,1933.33,2,700,350,5100,brs
2024-01-11,2,800,400.0,4,1500,375,-700,brs
2024-01-10,6,10500,1750.0,1,500,500,10000,brs
2024-01-09,4,82500,20625.0,1,500,500,82000,brs
2024-01-08,1,400,400.0,0,0,0,400,brs
2024-01-05,6,4300,716.67,1,500,500,3800,brs
2024-01-04,2,2200,1100.0,1,400,400,1800,brs
2024-01-03,3,1000,333.33,3,800,267,200,brs
2024-01-02,2,100000,50000.0,1,400,400,99600,brs
2024-09-12,0,0,0.0,0,0,0,0,bsc
2024-09-11,0,0,0.0,0,0,0,0,bsc
2024-09-10,0,0,0.0,0,0,0,0,bsc
2024-09-09,0,0,0.0,0,0,0,0,bsc
2024-09-06,0,0,0.0,0,0,0,0,bsc
2024-09-05,0,0,0.0,0,0,0,0,bsc
2024-09-04,0,0,0.0,0,0,0,0,bsc
2024-08-30,1,100,100.0,0,0,0,100,bsc
2024-08-29,0,0,0.0,0,0,0,0,bsc
2024-08-28,0,0,0.0,0,0,0,0,bsc
2024-08-27,0,0,0.0,0,0,0,0,bsc
2024-08-26,0,0,0.0,0,0,0,0,bsc
2024-08-23,1,300,300.0,0,0,0,300,bsc
2024-08-22,0,0,0.0,0,0,0,0,bsc
2024-08-21,0,0,0.0,0,0,0,0,bsc
2024-08-20,0,0,0.0,0,0,0,0,bsc
2024-08-19,1,100,100.0,0,0,0,100,bsc
2024-08-16,0,0,0.0,0,0,0,0,bsc
2024-08-15,0,0,0.0,0,0,0,0,bsc
2024-08-14,0,0,0.0,0,0,0,0,bsc
2024-08-13,0,0,0.0,0,0,0,0,bsc
2024-08-12,0,0,0.0,1,200,200,-200,bsc
2024-08-09,0,0,0.0,0,0,0,0,bsc
2024-08-08,0,0,0.0,0,0,0,0,bsc
2024-08-07,0,0,0.0,0,0,0,0,bsc
2024-08-06,0,0,0.0,0,0,0,0,bsc
2024-08-05,0,0,0.0,0,0,0,0,bsc
2024-08-02,0,0,0.0,1,200,200,-200,bsc
2024-08-01,0,0,0.0,0,0,0,0,bsc
2024-07-31,0,0,0.0,1,200,200,-200,bsc
2024-07-30,0,0,0.0,0,0,0,0,bsc
2024-07-29,2,200,100.0,2,200,100,0,bsc
2024-07-26,0,0,0.0,0,0,0,0,bsc
2024-07-25,1,100,100.0,0,0,0,100,bsc
2024-07-24,0,0,0.0,0,0,0,0,bsc
2024-07-23,0,0,0.0,0,0,0,0,bsc
2024-07-22,0,0,0.0,0,0,0,0,bsc
2024-07-19,0,0,0.0,0,0,0,0,bsc
2024-07-18,1,100,100.0,0,0,0,100,bsc
2024-07-17,1,100,100.0,0,0,0,100,bsc
2024-07-16,1,100,100.0,0,0,0,100,bsc
2024-07-15,0,0,0.0,0,0,0,0,bsc
2024-07-12,0,0,0.0,0,0,0,0,bsc
2024-07-11,2,100,50.0,1,100,100,0,bsc
2024-07-10,1,0,0.0,0,0,0,0,bsc
2024-07-09,0,0,0.0,0,0,0,0,bsc
2024-07-08,0,0,0.0,0,0,0,0,bsc
2024-07-05,0,0,0.0,0,0,0,0,bsc
2024-07-04,0,0,0.0,0,0,0,0,bsc
2024-07-03,0,0,0.0,0,0,0,0,bsc
2024-07-02,0,0,0.0,0,0,0,0,bsc
2024-07-01,1,0,0.0,0,0,0,0,bsc
2024-06-28,1,1000,1000.0,0,0,0,1000,bsc
2024-06-27,1,1000,1000.0,0,0,0,1000,bsc
2024-06-26,1,1000,1000.0,0,0,0,1000,bsc
2024-06-25,1,1000,1000.0,0,0,0,1000,bsc
2024-06-24,1,1000,1000.0,0,0,0,1000,bsc
2024-06-21,1,1000,1000.0,0,0,0,1000,bsc
2024-06-20,1,1000,1000.0,0,0,0,1000,bsc
2024-06-19,0,0,0.0,0,0,0,0,bsc
2024-06-18,1,0,0.0,0,0,0,0,bsc
2024-06-17,0,0,0.0,0,0,0,0,bsc
2024-06-14,0,0,0.0,0,0,0,0,bsc
2024-06-13,0,0,0.0,0,0,0,0,bsc
2024-06-12,0,0,0.0,0,0,0,0,bsc
2024-06-11,1,0,0.0,0,0,0,0,bsc
2024-06-10,0,0,0.0,0,0,0,0,bsc
2024-06-07,0,0,0.0,0,0,0,0,bsc
2024-06-06,0,0,0.0,0,0,0,0,bsc
2024-06-05,0,0,0.0,0,0,0,0,bsc
2024-06-04,1,100,100.0,0,0,0,100,bsc
2024-06-03,1,100,100.0,0,0,0,100,bsc
2024-05-31,0,0,0.0,0,0,0,0,bsc
2024-05-30,2,200,100.0,1,100,100,100,bsc
2024-05-29,0,0,0.0,0,0,0,0,bsc
2024-05-28,2,500,250.0,1,100,100,400,bsc
2024-05-27,1,200,200.0,0,0,0,200,bsc
2024-05-24,1,100,100.0,1,100,100,0,bsc
2024-05-23,7,400,57.14,3,300,100,100,bsc
2024-05-22,1,200,200.0,0,0,0,200,bsc
2024-05-21,4,400,100.0,4,400,100,0,bsc
2024-05-20,1,100,100.0,0,0,0,100,bsc
2024-05-17,0,0,0.0,0,0,0,0,bsc
2024-05-16,0,0,0.0,0,0,0,0,bsc
2024-05-15,0,0,0.0,0,0,0,0,bsc
2024-05-14,0,0,0.0,0,0,0,0,bsc
2024-05-13,0,0,0.0,0,0,0,0,bsc
2024-05-10,0,0,0.0,0,0,0,0,bsc
2024-05-09,0,0,0.0,0,0,0,0,bsc
2024-05-08,1,0,0.0,0,0,0,0,bsc
2024-05-07,0,0,0.0,0,0,0,0,bsc
2024-05-06,1,0,0.0,0,0,0,0,bsc
2024-05-03,3,200,66.67,1,100,100,100,bsc
2024-05-02,0,0,0.0,0,0,0,0,bsc
2024-04-26,0,0,0.0,0,0,0,0,bsc
2024-04-25,0,0,0.0,1,100,100,-100,bsc
2024-04-24,0,0,0.0,0,0,0,0,bsc
2024-04-23,0,0,0.0,1,100,100,-100,bsc
2024-04-22,0,0,0.0,0,0,0,0,bsc
2024-04-19,0,0,0.0,1,100,100,-100,bsc
2024-04-17,0,0,0.0,1,100,100,-100,bsc
2024-04-16,0,0,0.0,0,0,0,0,bsc
2024-04-15,0,0,0.0,0,0,0,0,bsc
2024-04-12,1,0,0.0,0,0,0,0,bsc
2024-04-11,0,0,0.0,0,0,0,0,bsc
2024-04-10,0,0,0.0,0,0,0,0,bsc
2024-04-09,0,0,0.0,0,0,0,0,bsc
2024-04-08,0,0,0.0,0,0,0,0,bsc
2024-04-05,0,0,0.0,0,0,0,0,bsc
2024-04-04,1,100,100.0,1,100,100,0,bsc
2024-04-03,0,0,0.0,0,0,0,0,bsc
2024-04-02,0,0,0.0,0,0,0,0,bsc
2024-04-01,1,100,100.0,0,0,0,100,bsc
2024-03-29,4,1000,250.0,1,100,100,900,bsc
2024-03-28,0,0,0.0,0,0,0,0,bsc
2024-03-27,0,0,0.0,0,0,0,0,bsc
2024-03-26,0,0,0.0,0,0,0,0,bsc
2024-03-25,0,0,0.0,0,0,0,0,bsc
2024-03-22,1,0,0.0,0,0,0,0,bsc
2024-03-21,0,0,0.0,0,0,0,0,bsc
2024-03-20,0,0,0.0,1,100,100,-100,bsc
2024-03-19,0,0,0.0,0,0,0,0,bsc
2024-03-18,0,0,0.0,0,0,0,0,bsc
2024-03-15,0,0,0.0,0,0,0,0,bsc
2024-03-14,3,500,166.67,0,0,0,500,bsc
2024-03-13,0,0,0.0,0,0,0,0,bsc
2024-03-12,0,0,0.0,0,0,0,0,bsc
2024-03-11,0,0,0.0,0,0,0,0,bsc
2024-03-08,1,100,100.0,0,0,0,100,bsc
2024-03-07,0,0,0.0,0,0,0,0,bsc
2024-03-06,1,100,100.0,0,0,0,100,bsc
2024-03-05,0,0,0.0,0,0,0,0,bsc
2024-03-04,0,0,0.0,0,0,0,0,bsc
2024-03-01,0,0,0.0,0,0,0,0,bsc
2024-02-29,0,0,0.0,0,0,0,0,bsc
2024-02-28,0,0,0.0,0,0,0,0,bsc
2024-02-27,0,0,0.0,0,0,0,0,bsc
2024-02-26,0,0,0.0,0,0,0,0,bsc
2024-02-23,0,0,0.0,0,0,0,0,bsc
2024-02-22,0,0,0.0,0,0,0,0,bsc
2024-02-21,0,0,0.0,1,100,100,-100,bsc
2024-02-20,0,0,0.0,0,0,0,0,bsc
2024-02-19,0,0,0.0,0,0,0,0,bsc
2024-02-16,0,0,0.0,0,0,0,0,bsc
2024-02-15,0,0,0.0,0,0,0,0,bsc
2024-02-07,0,0,0.0,0,0,0,0,bsc
2024-02-06,0,0,0.0,0,0,0,0,bsc
2024-02-05,0,0,0.0,0,0,0,0,bsc
2024-02-02,0,0,0.0,0,0,0,0,bsc
2024-02-01,0,0,0.0,1,100,100,-100,bsc
2024-01-31,0,0,0.0,0,0,0,0,bsc
2024-01-30,0,0,0.0,0,0,0,0,bsc
2024-01-29,0,0,0.0,0,0,0,0,bsc
2024-01-26,0,0,0.0,0,0,0,0,bsc
2024-01-25,0,0,0.0,0,0,0,0,bsc
2024-01-24,0,0,0.0,0,0,0,0,bsc
2024-01-23,0,0,0.0,0,0,0,0,bsc
2024-01-22,0,0,0.0,0,0,0,0,bsc
2024-01-19,0,0,0.0,0,0,0,0,bsc
2024-01-18,0,0,0.0,0,0,0,0,bsc
2024-01-17,0,0,0.0,0,0,0,0,bsc
2024-01-16,0,0,0.0,0,0,0,0,bsc
2024-01-15,0,0,0.0,0,0,0,0,bsc
2024-01-12,0,0,0.0,0,0,0,0,bsc
2024-01-11,0,0,0.0,0,0,0,0,bsc
2024-01-10,0,0,0.0,0,0,0,0,bsc
2024-01-09,0,0,0.0,0,0,0,0,bsc
2024-01-08,0,0,0.0,0,0,0,0,bsc
2024-01-05,0,0,0.0,0,0,0,0,bsc
2024-01-04,0,0,0.0,0,0,0,0,bsc
2024-01-03,0,0,0.0,0,0,0,0,bsc
2024-01-02,0,0,0.0,0,0,0,0,bsc
2024-09-12,5,2500,500.0,11,13600,1236,-11100,bsg
2024-09-11,6,2800,466.67,12,2600,217,200,bsg
2024-09-10,6,3700,616.67,15,16200,1080,-12500,bsg
2024-09-09,7,3100,442.86,13,13500,1038,-10400,bsg
2024-09-06,15,8100,540.0,21,27800,1324,-19700,bsg
2024-09-05,5,1300,260.0,7,11900,1700,-10600,bsg
2024-09-04,4,1900,475.0,8,13000,1625,-11100,bsg
2024-08-30,4,1900,475.0,11,13100,1191,-11200,bsg
2024-08-29,7,4000,571.43,13,13500,1038,-9500,bsg
2024-08-28,5,2600,520.0,11,12300,1118,-9700,bsg
2024-08-27,8,4200,525.0,15,14300,953,-10100,bsg
2024-08-26,9,4800,533.33,18,16500,917,-11700,bsg
2024-08-23,12,8700,725.0,21,19700,938,-11000,bsg
2024-08-22,8,4800,600.0,9,12300,1367,-7500,bsg
2024-08-21,17,10000,588.24,17,19400,1141,-9400,bsg
2024-08-20,12,7900,658.33,14,13700,979,-5800,bsg
2024-08-19,7,3700,528.57,16,14300,894,-10600,bsg
2024-08-16,12,6300,525.0,21,20400,971,-14100,bsg
2024-08-15,12,7400,616.67,21,19700,938,-12300,bsg
2024-08-14,6,3100,516.67,21,16400,781,-13300,bsg
2024-08-13,12,7900,658.33,22,18000,818,-10100,bsg
2024-08-12,20,41100,2055.0,25,50300,2012,-9200,bsg
2024-08-09,15,49500,3300.0,24,61000,2542,-11500,bsg
2024-08-08,15,9300,620.0,22,20500,932,-11200,bsg
2024-08-07,17,7800,458.82,23,18500,804,-10700,bsg
2024-08-06,15,64800,4320.0,21,75200,3581,-10400,bsg
2024-08-05,13,7800,600.0,22,18500,841,-10700,bsg
2024-08-02,15,50000,3333.33,34,47200,1388,2800,bsg
2024-08-01,11,9300,845.45,35,21800,623,-12500,bsg
2024-07-31,12,3900,325.0,33,19200,582,-15300,bsg
2024-07-30,18,11700,650.0,41,23300,568,-11600,bsg
2024-07-29,13,6800,523.08,38,23500,618,-16700,bsg
2024-07-26,19,9400,494.74,36,27100,753,-17700,bsg
2024-07-25,6,2100,350.0,24,19100,796,-17000,bsg
2024-07-24,14,6000,428.57,21,20400,971,-14400,bsg
2024-07-23,9,9400,1044.44,23,23200,1009,-13800,bsg
2024-07-22,5,1900,380.0,18,14600,811,-12700,bsg
2024-07-19,11,5100,463.64,21,19700,938,-14600,bsg
2024-07-18,5,1500,300.0,21,15500,738,-14000,bsg
2024-07-17,6,1400,233.33,23,16700,726,-15300,bsg
2024-07-16,4,1100,275.0,26,16800,646,-15700,bsg
2024-07-15,6,1600,266.67,26,16600,638,-15000,bsg
2024-07-12,10,5200,520.0,23,16800,730,-11600,bsg
2024-07-11,6,1600,266.67,22,17000,773,-15400,bsg
2024-07-10,7,1600,228.57,25,16600,664,-15000,bsg
2024-07-09,13,5700,438.46,24,6200,258,-500,bsg
2024-07-08,9,2900,322.22,28,18400,657,-15500,bsg
2024-07-05,19,4000,210.53,32,19900,622,-15900,bsg
2024-07-04,11,6700,609.09,35,20200,577,-13500,bsg
2024-07-03,35,9800,280.0,17,15400,906,-5600,bsg
2024-07-02,38,11600,305.26,31,22800,735,-11200,bsg
2024-07-01,32,10900,340.62,36,23300,647,-12400,bsg
2024-06-28,31,7600,245.16,21,17500,833,-9900,bsg
2024-06-27,30,9600,320.0,21,22000,1048,-12400,bsg
2024-06-26,22,5500,250.0,32,19800,619,-14300,bsg
2024-06-25,17,4200,247.06,28,18000,643,-13800,bsg
2024-06-24,28,7300,260.71,26,18900,727,-11600,bsg
2024-06-21,24,6800,283.33,38,26500,697,-19700,bsg
2024-06-20,30,9600,320.0,42,26700,636,-17100,bsg
2024-06-19,29,9300,320.69,44,24300,552,-15000,bsg
2024-06-18,35,11900,340.0,10,19400,1940,-7500,bsg
2024-06-17,27,11100,411.11,5,18300,3660,-7200,bsg
2024-06-14,15,9600,640.0,29,25100,866,-15500,bsg
2024-06-13,13,8800,676.92,27,17400,644,-8600,bsg
2024-06-12,13,3100,238.46,26,16600,638,-13500,bsg
2024-06-11,14,3500,250.0,27,16900,626,-13400,bsg
2024-06-10,15,3800,253.33,17,16000,941,-12200,bsg
2024-06-07,19,6300,331.58,19,17100,900,-10800,bsg
2024-06-06,11,7400,672.73,26,21300,819,-13900,bsg
2024-06-05,32,15500,484.38,26,28000,1077,-12500,bsg
2024-06-04,14,8700,621.43,33,27300,827,-18600,bsg
2024-06-03,9,5200,577.78,28,27400,979,-22200,bsg
2024-05-31,22,20500,931.82,34,32800,965,-12300,bsg
2024-05-30,18,9200,511.11,4,12400,3100,-3200,bsg
2024-05-29,12,22400,1866.67,16,36200,2262,-13800,bsg
2024-05-28,8,1500,187.5,15,15000,1000,-13500,bsg
2024-05-27,8,1300,162.5,12,13600,1133,-12300,bsg
2024-05-24,5,900,180.0,14,15300,1093,-14400,bsg
2024-05-23,6,1800,300.0,13,13600,1046,-11800,bsg
2024-05-22,5,1100,220.0,14,15300,1093,-14200,bsg
2024-05-21,7,900,128.57,16,15100,944,-14200,bsg
2024-05-20,5,800,160.0,27,17000,630,-16200,bsg
2024-05-17,6,3700,616.67,28,17700,632,-14000,bsg
2024-05-16,6,6800,1133.33,17,15900,935,-9100,bsg
2024-05-15,23,14800,643.48,27,18500,685,-3700,bsg
2024-05-14,25,14600,584.0,36,20600,572,-6000,bsg
2024-05-13,27,29100,1077.78,59,42300,717,-13200,bsg
2024-05-10,27,13000,481.48,56,39300,702,-26300,bsg
2024-05-09,23,16200,704.35,47,37900,806,-21700,bsg
2024-05-08,14,11000,785.71,34,33500,985,-22500,bsg
2024-05-07,13,9500,730.77,13,22200,1708,-12700,bsg
2024-05-06,10,9200,920.0,19,24200,1274,-15000,bsg
2024-05-03,7,5400,771.43,13,19400,1492,-14000,bsg
2024-05-02,6,4000,666.67,17,20700,1218,-16700,bsg
2024-04-26,6,3000,500.0,12,16200,1350,-13200,bsg
2024-04-25,8,3400,425.0,7,23100,3300,-19700,bsg
2024-04-24,11,10300,936.36,16,23800,1488,-13500,bsg
2024-04-23,11,5100,463.64,12,22700,1892,-17600,bsg
2024-04-22,7,2700,385.71,15,20500,1367,-17800,bsg
2024-04-19,9,5300,588.89,16,19700,1231,-14400,bsg
2024-04-17,4,2000,500.0,16,10800,675,-8800,bsg
2024-04-16,4,1100,275.0,20,3900,195,-2800,bsg
2024-04-15,9,3700,411.11,22,18700,850,-15000,bsg
2024-04-12,8,5600,700.0,31,10800,348,-5200,bsg
2024-04-11,1,1000,1000.0,28,30600,1093,-29600,bsg
2024-04-10,4,1300,325.0,12,15100,1258,-13800,bsg
2024-04-09,2,800,400.0,12,15400,1283,-14600,bsg
2024-04-08,4,2100,525.0,17,16700,982,-14600,bsg
2024-04-05,5,2400,480.0,18,9600,533,-7200,bsg
2024-04-04,5,1800,360.0,19,25500,1342,-23700,bsg
2024-04-03,10,12000,1200.0,15,22500,1500,-10500,bsg
2024-04-02,11,9600,872.73,23,25700,1117,-16100,bsg
2024-04-01,16,6300,393.75,30,30200,1007,-23900,bsg
2024-03-29,22,26500,1204.55,21,24000,1143,2500,bsg
2024-03-28,15,2800,186.67,19,21000,1105,-18200,bsg
2024-03-27,19,6100,321.05,17,21100,1241,-15000,bsg
2024-03-26,12,6500,541.67,33,27000,818,-20500,bsg
2024-03-25,25,12300,492.0,49,40400,824,-28100,bsg
2024-03-22,29,7600,262.07,15,17900,1193,-10300,bsg
2024-03-21,11,6600,600.0,12,21900,1825,-15300,bsg
2024-03-20,25,8900,356.0,18,21300,1183,-12400,bsg
2024-03-19,46,18600,404.35,7,9300,1329,9300,bsg
2024-03-18,44,17100,388.64,18,30800,1711,-13700,bsg
2024-03-15,14,3000,214.29,21,10800,514,-7800,bsg
2024-03-14,11,2600,236.36,15,19300,1287,-16700,bsg
2024-03-13,5,1900,380.0,15,14300,953,-12400,bsg
2024-03-12,8,2500,312.5,18,15700,872,-13200,bsg
2024-03-11,10,1000,100.0,20,17900,895,-16900,bsg
2024-03-08,13,1600,123.08,21,25800,1229,-24200,bsg
2024-03-07,14,4100,292.86,25,23100,924,-19000,bsg
2024-03-06,21,14900,709.52,27,33100,1226,-18200,bsg
2024-03-05,12,2800,233.33,11,19700,1791,-16900,bsg
2024-03-04,13,1900,146.15,16,22500,1406,-20600,bsg
2024-03-01,19,11000,578.95,13,12400,954,-1400,bsg
2024-02-29,17,1800,105.88,17,24200,1424,-22400,bsg
2024-02-28,19,3100,163.16,29,28900,997,-25800,bsg
2024-02-27,25,3200,128.0,18,17100,950,-13900,bsg
2024-02-26,29,3700,127.59,21,17300,824,-13600,bsg
2024-02-23,36,13500,375.0,17,23000,1353,-9500,bsg
2024-02-22,42,19700,469.05,24,11200,467,8500,bsg
2024-02-21,27,3500,129.63,22,19400,882,-15900,bsg
2024-02-20,29,3400,117.24,26,20600,792,-17200,bsg
2024-02-19,32,3400,106.25,21,14600,695,-11200,bsg
2024-02-16,39,9600,246.15,23,16800,730,-7200,bsg
2024-02-15,38,10000,263.16,18,20200,1122,-10200,bsg
2024-02-07,32,5500,171.88,25,16600,664,-11100,bsg
2024-02-06,6,400,66.67,16,13700,856,-13300,bsg
2024-02-05,3,400,133.33,25,15700,628,-15300,bsg
2024-02-02,5,1200,240.0,25,21000,840,-19800,bsg
2024-02-01,7,1200,171.43,24,15000,625,-13800,bsg
2024-01-31,4,600,150.0,25,14400,576,-13800,bsg
2024-01-30,4,900,225.0,23,16000,696,-15100,bsg
2024-01-29,4,1000,250.0,19,14200,747,-13200,bsg
2024-01-26,17,9600,564.71,24,28700,1196,-19100,bsg
2024-01-25,21,12600,600.0,32,33400,1044,-20800,bsg
2024-01-24,16,2700,168.75,26,16200,623,-13500,bsg
2024-01-23,19,2900,152.63,27,15700,581,-12800,bsg
2024-01-22,26,3400,130.77,29,27100,934,-23700,bsg
2024-01-19,24,4400,183.33,24,14600,608,-10200,bsg
2024-01-18,33,5000,151.52,24,14000,583,-9000,bsg
2024-01-17,32,5900,184.38,31,18200,587,-12300,bsg
2024-01-16,36,6400,177.78,24,23000,958,-16600,bsg
2024-01-15,37,5500,148.65,25,16500,660,-11000,bsg
2024-01-12,40,6300,157.5,21,14800,705,-8500,bsg
2024-01-11,34,6100,179.41,13,14000,1077,-7900,bsg
2024-01-10,36,7200,200.0,13,4400,338,2800,bsg
2024-01-09,45,11200,248.89,18,19900,1106,-8700,bsg
2024-01-08,50,11700,234.0,11,15900,1445,-4200,bsg
2024-01-05,49,11200,228.57,17,23000,1353,-11800,bsg
2024-01-04,25,5000,200.0,9,12700,1411,-7700,bsg
2024-01-03,25,5700,228.0,13,15800,1215,-10100,bsg
2024-01-02,28,6800,242.86,22,5200,236,1600,bsg
2024-09-12,378,490900,1298.68,636,751400,1181,-260500,bsi
2024-09-11,1113,1108500,995.96,966,1155000,1196,-46500,bsi
2024-09-10,2106,1923700,913.44,1237,2169600,1754,-245900,bsi
2024-09-09,933,757000,811.36,688,1209200,1758,-452200,bsi
2024-09-06,1062,1001400,942.94,854,1220800,1430,-219400,bsi
2024-09-05,1500,1921700,1281.13,1610,2231700,1386,-310000,bsi
2024-09-04,1202,1372400,1141.76,803,1495000,1862,-122600,bsi
2024-08-30,713,1103300,1547.41,835,1524700,1826,-421400,bsi
2024-08-29,1151,1317000,1144.22,1028,1529600,1488,-212600,bsi
2024-08-28,1430,1764500,1233.92,1425,2194800,1540,-430300,bsi
2024-08-27,995,1158200,1164.02,936,1234500,1319,-76300,bsi
2024-08-26,1077,1458100,1353.85,1434,1870900,1305,-412800,bsi
2024-08-23,1477,2320500,1571.09,1854,2267600,1223,52900,bsi
2024-08-22,987,1514700,1534.65,1454,1727000,1188,-212300,bsi
2024-08-21,1211,1284400,1060.61,935,1356100,1450,-71700,bsi
2024-08-20,1877,2776500,1479.22,1689,2939200,1740,-162700,bsi
2024-08-19,1288,1539900,1195.57,1091,1519700,1393,20200,bsi
2024-08-16,1863,3737000,2005.9,1821,2821300,1549,915700,bsi
2024-08-15,1381,1834800,1328.6,1074,1934600,1801,-99800,bsi
2024-08-14,1349,1292600,958.19,894,1913900,2141,-621300,bsi
2024-08-13,1462,1474900,1008.82,957,1635700,1709,-160800,bsi
2024-08-12,1285,1377300,1071.83,1009,1480600,1467,-103300,bsi
2024-08-08,1400,1756800,1254.86,1428,2242900,1571,-486100,bsi
2024-08-07,1406,1936500,1377.31,1107,1585400,1432,351100,bsi
2024-08-06,1704,3376400,1981.46,1564,2228100,1425,1148300,bsi
2024-08-05,2344,3645300,1555.16,2013,2702300,1342,943000,bsi
2024-08-02,1290,2370900,1837.91,885,1083500,1224,1287400,bsi
2024-08-01,896,1001200,1117.41,659,1176000,1785,-174800,bsi
2024-07-31,403,506000,1255.58,653,734300,1125,-228300,bsi
2024-07-30,664,835400,1258.13,579,723700,1250,111700,bsi
2024-07-29,405,848600,2095.31,556,673600,1212,175000,bsi
2024-07-26,675,626500,928.15,592,805800,1361,-179300,bsi
2024-07-25,710,1043300,1469.44,504,535700,1063,507600,bsi
2024-07-24,1442,1725800,1196.81,998,1614800,1618,111000,bsi
2024-07-22,1330,1367500,1028.2,953,1522800,1598,-155300,bsi
2024-07-19,876,936600,1069.18,541,861100,1592,75500,bsi
2024-07-18,824,879100,1066.87,530,699000,1319,180100,bsi
2024-07-17,1041,1175600,1129.3,889,1319600,1484,-144000,bsi
2024-07-16,590,720600,1221.36,687,797100,1160,-76500,bsi
2024-07-15,469,446200,951.39,497,557900,1123,-111700,bsi
2024-07-12,605,698800,1155.04,534,694100,1300,4700,bsi
2024-07-11,881,944600,1072.19,804,1058200,1316,-113600,bsi
2024-07-10,935,774800,828.66,726,991800,1366,-217000,bsi
2024-07-09,1330,1438000,1081.2,1075,1518500,1413,-80500,bsi
2024-07-08,995,1226700,1232.86,854,1231700,1442,-5000,bsi
2024-07-05,914,905400,990.59,631,919000,1456,-13600,bsi
2024-07-04,804,815900,1014.8,803,1198800,1493,-382900,bsi
2024-07-03,533,548900,1029.83,703,825600,1174,-276700,bsi
2024-07-02,575,487200,847.3,713,774100,1086,-286900,bsi
2024-07-01,840,1091900,1299.88,535,616200,1152,475700,bsi
2024-06-28,1484,1441200,971.16,980,1283600,1310,157600,bsi
2024-06-27,840,603000,717.86,581,950900,1637,-347900,bsi
2024-06-26,1010,818200,810.1,720,961200,1335,-143000,bsi
2024-06-25,969,1115200,1150.88,766,909700,1188,205500,bsi
2024-06-24,2817,2799100,993.65,1867,3029900,1623,-230800,bsi
2024-06-21,1573,1359300,864.14,968,1262900,1305,96400,bsi
2024-06-20,1070,837000,782.24,769,1086200,1412,-249200,bsi
2024-06-19,1075,988300,919.35,917,1245300,1358,-257000,bsi
2024-06-18,961,904900,941.62,627,876500,1398,28400,bsi
2024-06-17,1588,1356700,854.35,778,1405000,1806,-48300,bsi
2024-06-14,2253,1819800,807.72,1563,2490300,1593,-670500,bsi
2024-06-13,1243,1089500,876.51,989,1485200,1502,-395700,bsi
2024-06-12,1364,1441300,1056.67,1992,2344900,1177,-903600,bsi
2024-06-11,1683,2546400,1513.01,2120,2567800,1211,-21400,bsi
2024-06-10,1174,1133500,965.5,1131,1483800,1312,-350300,bsi
2024-06-07,952,853000,896.01,765,1045400,1367,-192400,bsi
2024-06-06,1366,1252300,916.76,1036,1636200,1579,-383900,bsi
2024-06-05,1511,1757300,1163.0,1517,1890900,1246,-133600,bsi
2024-06-04,1601,1772500,1107.12,1781,2294900,1289,-522400,bsi
2024-06-03,1246,1634900,1312.12,1743,1962700,1126,-327800,bsi
2024-05-31,953,915000,960.13,1100,1246500,1133,-331500,bsi
2024-05-30,1884,1720200,913.06,1039,1578600,1519,141600,bsi
2024-05-29,1253,1498500,1195.93,1352,1782800,1319,-284300,bsi
2024-05-28,980,1111100,1133.78,1372,1363400,994,-252300,bsi
2024-05-27,1314,1135200,863.93,752,1264500,1682,-129300,bsi
2024-05-24,3449,3371400,977.5,1750,2897800,1656,473600,bsi
2024-05-23,1746,1737500,995.13,1380,1738300,1260,-800,bsi
2024-05-22,2188,2615300,1195.29,2186,2848600,1303,-233300,bsi
2024-05-21,1702,1687900,991.72,987,1569100,1590,118800,bsi
2024-05-20,1415,1615500,1141.7,1322,1982000,1499,-366500,bsi
2024-05-17,1608,1828300,1137.0,1530,2054400,1343,-226100,bsi
2024-05-16,1253,1718500,1371.51,1282,1998200,1559,-279700,bsi
2024-05-15,2069,3360600,1624.26,2529,3383300,1338,-22700,bsi
2024-05-14,1263,1480000,1171.81,992,1606700,1620,-126700,bsi
2024-05-13,1540,1960500,1273.05,1244,2178300,1751,-217800,bsi
2024-05-10,2192,2430800,1108.94,1248,2430600,1948,200,bsi
2024-05-09,1991,2211900,1110.95,1137,2776800,2442,-564900,bsi
2024-05-08,1856,2242100,1208.03,1397,2351200,1683,-109100,bsi
2024-05-07,1487,2359100,1586.48,1407,2189500,1556,169600,bsi
2024-05-06,1643,3623900,2205.66,1516,2229800,1471,1394100,bsi
2024-05-03,1237,1640300,1326.03,1581,2009200,1271,-368900,bsi
2024-05-02,1334,1425900,1068.89,922,1521800,1651,-95900,bsi
2024-04-26,2112,2235700,1058.57,1261,2259100,1792,-23400,bsi
2024-04-25,1551,1719500,1108.64,1107,1801400,1627,-81900,bsi
2024-04-24,1485,1959600,1319.6,1744,2367700,1358,-408100,bsi
2024-04-23,1832,1990500,1086.52,1649,2336100,1417,-345600,bsi
2024-04-22,1784,2428400,1361.21,1482,1649200,1113,779200,bsi
2024-04-19,4219,5014000,1188.43,2530,4569200,1806,444800,bsi
2024-04-17,2041,1730800,848.02,1192,1816100,1524,-85300,bsi
2024-04-16,3426,3639700,1062.38,2060,2867500,1392,772200,bsi
2024-04-15,1476,1332100,902.51,1273,2168900,1704,-836800,bsi
2024-04-12,913,1077400,1180.07,1109,1347000,1215,-269600,bsi
2024-04-11,1169,1052400,900.26,819,1206400,1473,-154000,bsi
2024-04-10,680,504700,742.21,566,822400,1453,-317700,bsi
2024-04-09,1487,1378500,927.03,895,1104500,1234,274000,bsi
2024-04-08,2066,1763400,853.53,1346,2073500,1540,-310100,bsi
2024-04-05,1637,1489300,909.77,864,1242500,1438,246800,bsi
2024-04-04,1012,1034000,1021.74,1010,1236500,1224,-202500,bsi
2024-04-03,1729,1855500,1073.16,1783,2313500,1298,-458000,bsi
2024-04-02,1027,867200,844.4,617,845100,1370,22100,bsi
2024-04-01,1225,1217200,993.63,772,855600,1108,361600,bsi
2024-03-29,909,651200,716.39,642,769600,1199,-118400,bsi
2024-03-28,1068,1180800,1105.62,1390,1662700,1196,-481900,bsi
2024-03-27,837,899300,1074.43,900,1188900,1321,-289600,bsi
2024-03-26,1060,1130900,1066.89,768,988900,1288,142000,bsi
2024-03-25,1297,1105500,852.35,1067,1191100,1116,-85600,bsi
2024-03-22,2609,3878000,1486.39,2930,3898500,1331,-20500,bsi
2024-03-21,1071,1146300,1070.31,1176,1548800,1317,-402500,bsi
2024-03-20,1047,1014300,968.77,1033,1138800,1102,-124500,bsi
2024-03-19,1310,1303700,995.19,769,1075600,1399,228100,bsi
2024-03-18,3157,3275400,1037.5,1937,3109600,1605,165800,bsi
2024-03-15,2025,2029900,1002.42,1253,2039500,1628,-9600,bsi
2024-03-14,1664,1479600,889.18,1350,1748400,1295,-268800,bsi
2024-03-13,1679,2054500,1223.65,1780,1956300,1099,98200,bsi
2024-03-12,1706,2103300,1232.88,1879,2156900,1148,-53600,bsi
2024-03-11,1578,1594800,1010.65,1299,1739800,1339,-145000,bsi
2024-03-08,2278,2147000,942.49,1629,2553200,1567,-406200,bsi
2024-03-07,1598,1894600,1185.61,1357,1875800,1382,18800,bsi
2024-03-06,2078,2008900,966.75,997,1696200,1701,312700,bsi
2024-03-05,2676,2925400,1093.2,1729,2434600,1408,490800,bsi
2024-03-04,1135,1263900,1113.57,1082,1350000,1248,-86100,bsi
2024-03-01,2727,4902900,1797.91,2567,3264600,1272,1638300,bsi
2024-02-29,1613,1824200,1130.94,1390,2604500,1874,-780300,bsi
2024-02-28,1284,1184200,922.27,1055,1459600,1384,-275400,bsi
2024-02-27,1059,1250100,1180.45,1514,1834000,1211,-583900,bsi
2024-02-26,1938,2323600,1198.97,1807,2185600,1210,138000,bsi
2024-02-23,1476,1660900,1125.27,1355,2058200,1519,-397300,bsi
2024-02-22,1802,1717200,952.94,1164,1545800,1328,171400,bsi
2024-02-21,2160,1937700,897.08,889,1531500,1723,406200,bsi
2024-02-20,1502,1756200,1169.24,1517,1980300,1305,-224100,bsi
2024-02-19,1948,2601200,1335.32,1574,2068400,1314,532800,bsi
2024-02-16,1298,1540500,1186.83,1136,1463400,1288,77100,bsi
2024-02-15,1169,1213500,1038.07,572,932400,1630,281100,bsi
2024-02-07,0,0,0.0,0,0,0,0,bsi
2024-02-06,812,961800,1184.48,1391,1209100,869,-247300,bsi
2024-02-05,1422,1527100,1073.91,1057,1627500,1540,-100400,bsi
2024-02-02,942,1113000,1181.53,1087,1521000,1399,-408000,bsi
2024-02-01,1050,955000,909.52,823,1104600,1342,-149600,bsi
2024-01-31,1670,2177500,1303.89,1954,2770000,1418,-592500,bsi
2024-01-30,1010,854000,845.54,917,946600,1032,-92600,bsi
2024-01-29,1051,1254000,1193.15,938,1280100,1365,-26100,bsi
2024-01-26,933,1081700,1159.38,681,856200,1257,225500,bsi
2024-01-25,1083,1091000,1007.39,721,968000,1343,123000,bsi
2024-01-24,1625,1797800,1106.34,1370,2033500,1484,-235700,bsi
2024-01-23,1068,1120000,1048.69,950,1204800,1268,-84800,bsi
2024-01-22,1844,2206000,1196.31,1479,1780600,1204,425400,bsi
2024-01-19,2265,2319900,1024.24,1337,2288000,1711,31900,bsi
2024-01-18,1843,2577300,1398.43,1610,2240400,1392,336900,bsi
2024-01-17,3585,5739700,1601.03,2259,3507600,1553,2232100,bsi
2024-01-16,1136,1380900,1215.58,788,1146900,1455,234000,bsi
2024-01-15,1195,1151600,963.68,1037,1623900,1566,-472300,bsi
2024-01-12,1517,1858700,1225.25,1485,2336500,1573,-477800,bsi
2024-01-11,986,1099800,1115.42,1056,1255600,1189,-155800,bsi
2024-01-10,0,0,0.0,0,0,0,0,bsi
2024-01-09,1113,1155700,1038.36,911,1510800,1658,-355100,bsi
2024-01-08,1055,1206000,1143.13,1134,1778900,1569,-572900,bsi
2024-01-05,910,1108600,1218.24,729,1170500,1606,-61900,bsi
2024-01-04,1553,2478900,1596.2,2430,2816600,1159,-337700,bsi
2024-01-03,1353,1308100,966.81,644,883300,1372,424800,bsi
2024-01-02,1476,1360300,921.61,798,1426600,1788,-66300,bsi
2024-09-12,13,3900,300.0,9,5800,644,-1900,bsp
2024-09-11,8,2700,337.5,11,15400,1400,-12700,bsp
2024-09-10,8,500,62.5,6,3800,633,-3300,bsp
2024-09-09,5,1700,340.0,7,3400,486,-1700,bsp
2024-09-06,10,1700,170.0,9,22900,2544,-21200,bsp
2024-09-05,15,7200,480.0,11,24900,2264,-17700,bsp
2024-09-04,9,1900,211.11,6,25300,4217,-23400,bsp
2024-08-30,9,1400,155.56,10,25400,2540,-24000,bsp
2024-08-29,11,6800,618.18,8,24600,3075,-17800,bsp
2024-08-28,14,2700,192.86,6,2500,417,200,bsp
2024-08-27,13,7300,561.54,12,12100,1008,-4800,bsp
2024-08-26,12,6600,550.0,10,5100,510,1500,bsp
2024-08-23,27,21500,796.3,6,17800,2967,3700,bsp
2024-08-22,9,5900,655.56,5,27600,5520,-21700,bsp
2024-08-21,10,9300,930.0,6,11300,1883,-2000,bsp
2024-08-20,12,5700,475.0,5,4300,860,1400,bsp
2024-08-19,7,4500,642.86,7,9000,1286,-4500,bsp
2024-08-16,10,7100,710.0,6,4800,800,2300,bsp
2024-08-15,6,3800,633.33,12,16700,1392,-12900,bsp
2024-08-14,4,500,125.0,10,14200,1420,-13700,bsp
2024-08-13,5,600,120.0,5,4100,820,-3500,bsp
2024-08-12,4,2300,575.0,9,9300,1033,-7000,bsp
2024-08-09,8,1400,175.0,8,2900,362,-1500,bsp
2024-08-08,11,4400,400.0,9,9900,1100,-5500,bsp
2024-08-07,15,6300,420.0,21,17500,833,-11200,bsp
2024-08-06,10,12500,1250.0,11,24100,2191,-11600,bsp
2024-08-05,10,14200,1420.0,8,11400,1425,2800,bsp
2024-08-02,6,400,66.67,9,11200,1244,-10800,bsp
2024-08-01,12,5500,458.33,11,14000,1273,-8500,bsp
2024-07-31,9,10700,1188.89,11,12500,1136,-1800,bsp
2024-07-30,19,2600,136.84,20,6000,300,-3400,bsp
2024-07-29,3,400,133.33,13,37600,2892,-37200,bsp
2024-07-26,8,2900,362.5,9,13500,1500,-10600,bsp
2024-07-25,12,500,41.67,8,4300,538,-3800,bsp
2024-07-24,8,1200,150.0,8,6500,812,-5300,bsp
2024-07-23,9,2400,266.67,7,6700,957,-4300,bsp
2024-07-22,9,10900,1211.11,7,5900,843,5000,bsp
2024-07-19,13,5000,384.62,9,3200,356,1800,bsp
2024-07-18,21,3600,171.43,14,4200,300,-600,bsp
2024-07-17,7,3100,442.86,16,13900,869,-10800,bsp
2024-07-16,21,9500,452.38,15,23700,1580,-14200,bsp
2024-07-15,8,3200,400.0,17,15000,882,-11800,bsp
2024-07-12,8,2800,350.0,13,10400,800,-7600,bsp
2024-07-11,11,5600,509.09,16,10800,675,-5200,bsp
2024-07-10,13,3400,261.54,17,16000,941,-12600,bsp
2024-07-09,14,7600,542.86,17,15300,900,-7700,bsp
2024-07-08,11,6900,627.27,15,16200,1080,-9300,bsp
2024-07-05,13,8900,684.62,12,15500,1292,-6600,bsp
2024-07-04,10,5500,550.0,11,14000,1273,-8500,bsp
2024-07-03,13,4900,376.92,14,17600,1257,-12700,bsp
2024-07-02,16,8300,518.75,10,5900,590,2400,bsp
2024-07-01,14,6400,457.14,14,14300,1021,-7900,bsp
2024-06-28,21,12200,580.95,22,25900,1177,-13700,bsp
2024-06-27,12,6200,516.67,14,18300,1307,-12100,bsp
2024-06-26,12,7900,658.33,13,13400,1031,-5500,bsp
2024-06-25,7,4300,614.29,18,18900,1050,-14600,bsp
2024-06-24,15,5400,360.0,15,12600,840,-7200,bsp
2024-06-21,13,7800,600.0,11,3200,291,4600,bsp
2024-06-20,27,23000,851.85,22,23300,1059,-300,bsp
2024-06-19,13,22800,1753.85,20,20800,1040,2000,bsp
2024-06-18,20,14500,725.0,17,11300,665,3200,bsp
2024-06-17,11,9300,845.45,22,12300,559,-3000,bsp
2024-06-14,8,4300,537.5,19,10800,568,-6500,bsp
2024-06-13,15,8200,546.67,20,11400,570,-3200,bsp
2024-06-12,20,10700,535.0,22,12200,555,-1500,bsp
2024-06-11,11,5100,463.64,14,9700,693,-4600,bsp
2024-06-10,25,11000,440.0,22,17600,800,-6600,bsp
2024-06-07,21,13200,628.57,22,14900,677,-1700,bsp
2024-06-06,10,5300,530.0,16,14200,888,-8900,bsp
2024-06-05,18,9700,538.89,16,13200,825,-3500,bsp
2024-06-04,9,2900,322.22,13,14300,1100,-11400,bsp
2024-06-03,20,3000,150.0,17,18300,1076,-15300,bsp
2024-05-31,18,3800,211.11,18,24400,1356,-20600,bsp
2024-05-30,12,3000,250.0,21,26600,1267,-23600,bsp
2024-05-29,31,20700,667.74,18,25000,1389,-4300,bsp
2024-05-28,14,12600,900.0,9,25400,2822,-12800,bsp
2024-05-27,16,3200,200.0,11,34000,3091,-30800,bsp
2024-05-24,14,15800,1128.57,16,41100,2569,-25300,bsp
2024-05-23,13,7300,561.54,7,27700,3957,-20400,bsp
2024-05-22,10,400,40.0,9,15800,1756,-15400,bsp
2024-05-21,9,5400,600.0,15,31400,2093,-26000,bsp
2024-05-20,9,15100,1677.78,14,23400,1671,-8300,bsp
2024-05-17,8,2500,312.5,7,13400,1914,-10900,bsp
2024-05-16,5,200,40.0,7,4800,686,-4600,bsp
2024-05-15,8,4900,612.5,6,10500,1750,-5600,bsp
2024-05-14,6,3700,616.67,6,17100,2850,-13400,bsp
2024-05-13,5,200,40.0,4,4000,1000,-3800,bsp
2024-05-10,4,800,200.0,4,1100,275,-300,bsp
2024-05-09,5,200,40.0,5,11100,2220,-10900,bsp
2024-05-08,5,700,140.0,5,11000,2200,-10300,bsp
2024-05-07,9,2000,222.22,6,11300,1883,-9300,bsp
2024-05-06,3,900,300.0,3,10300,3433,-9400,bsp
2024-05-03,4,1000,250.0,1,10000,10000,-9000,bsp
2024-05-02,3,500,166.67,0,0,0,500,bsp
2024-04-26,3,1100,366.67,0,0,0,1100,bsp
2024-04-25,3,300,100.0,1,100,100,200,bsp
2024-04-24,2,200,100.0,0,0,0,200,bsp
2024-04-23,3,300,100.0,0,0,0,300,bsp
2024-04-22,1,200,200.0,1,0,0,200,bsp
2024-04-19,2,200,100.0,1,300,300,-100,bsp
2024-04-17,2,0,0.0,1,300,300,-300,bsp
2024-04-16,3,2100,700.0,1,300,300,1800,bsp
2024-04-15,4,200,50.0,1,300,300,-100,bsp
2024-04-12,3,3100,1033.33,2,2300,1150,800,bsp
2024-04-11,4,5000,1250.0,3,2900,967,2100,bsp
2024-04-10,3,3100,1033.33,2,2300,1150,800,bsp
2024-04-09,4,5100,1275.0,2,1300,650,3800,bsp
2024-04-08,4,5100,1275.0,2,1300,650,3800,bsp
2024-04-05,9,8100,900.0,3,1800,600,6300,bsp
2024-04-04,3,5000,1666.67,1,300,300,4700,bsp
2024-04-03,5,5100,1020.0,2,1300,650,3800,bsp
2024-04-02,4,5100,1275.0,1,300,300,4800,bsp
2024-04-01,7,4900,700.0,1,300,300,4600,bsp
2024-03-29,5,6500,1300.0,1,200,200,6300,bsp
2024-03-28,11,8900,809.09,2,200,100,8700,bsp
2024-03-27,10,2900,290.0,3,1500,500,1400,bsp
2024-03-26,2,1400,700.0,3,2600,867,-1200,bsp
2024-03-25,2,200,100.0,7,4000,571,-3800,bsp
2024-03-22,3,500,166.67,1,500,500,0,bsp
2024-03-21,4,1000,250.0,3,2000,667,-1000,bsp
2024-03-20,8,8000,1000.0,6,14700,2450,-6700,bsp
2024-03-19,4,13400,3350.0,13,32400,2492,-19000,bsp
2024-03-18,2,13600,6800.0,8,18300,2288,-4700,bsp
2024-03-15,6,13900,2316.67,8,15900,1988,-2000,bsp
2024-03-14,2,200,100.0,4,1800,450,-1600,bsp
2024-03-13,2,200,100.0,5,1600,320,-1400,bsp
2024-03-12,3,1200,400.0,4,1800,450,-600,bsp
2024-03-11,3,1200,400.0,5,1700,340,-500,bsp
2024-03-08,6,2900,483.33,6,4100,683,-1200,bsp
2024-03-07,5,2800,560.0,4,1600,400,1200,bsp
2024-03-06,7,1100,157.14,3,1400,467,-300,bsp
2024-03-05,9,11700,1300.0,9,14700,1633,-3000,bsp
2024-03-04,6,11200,1866.67,4,5700,1425,5500,bsp
2024-03-01,3,200,66.67,3,1300,433,-1100,bsp
2024-02-29,8,4500,562.5,4,5500,1375,-1000,bsp
2024-02-28,8,3800,475.0,4,3000,750,800,bsp
2024-02-27,13,11200,861.54,10,18300,1830,-7100,bsp
2024-02-26,9,2800,311.11,3,6900,2300,-4100,bsp
2024-02-23,11,6000,545.45,4,3400,850,2600,bsp
2024-02-22,10,1000,100.0,2,1700,850,-700,bsp
2024-02-21,4,1700,425.0,2,4700,2350,-3000,bsp
2024-02-20,11,10300,936.36,5,12200,2440,-1900,bsp
2024-02-19,11,21000,1909.09,8,37900,4738,-16900,bsp
2024-02-16,3,200,66.67,3,3300,1100,-3100,bsp
2024-02-15,6,700,116.67,4,7900,1975,-7200,bsp
2024-02-07,7,700,100.0,1,800,800,-100,bsp
2024-02-06,4,400,100.0,3,12400,4133,-12000,bsp
2024-02-05,5,1100,220.0,1,800,800,300,bsp
2024-02-02,5,500,100.0,2,10800,5400,-10300,bsp
2024-02-01,6,3600,600.0,3,9900,3300,-6300,bsp
2024-01-31,2,400,200.0,4,7600,1900,-7200,bsp
2024-01-30,3,400,133.33,4,20000,5000,-19600,bsp
2024-01-29,4,800,200.0,2,6600,3300,-5800,bsp
2024-01-26,3,300,100.0,7,10400,1486,-10100,bsp
2024-01-25,1,100,100.0,4,4200,1050,-4100,bsp
2024-01-24,2,600,300.0,2,1100,550,-500,bsp
2024-01-23,3,600,200.0,3,5100,1700,-4500,bsp
2024-01-22,2,300,150.0,6,9000,1500,-8700,bsp
2024-01-19,1,100,100.0,5,6300,1260,-6200,bsp
2024-01-18,2,200,100.0,3,3800,1267,-3600,bsp
2024-01-17,2,200,100.0,2,2000,1000,-1800,bsp
2024-01-16,1,100,100.0,3,4100,1367,-4000,bsp
2024-01-15,1,300,300.0,6,2500,417,-2200,bsp
2024-01-12,2,400,200.0,3,4100,1367,-3700,bsp
2024-01-11,3,3400,1133.33,7,3700,529,-300,bsp
2024-01-10,3,1400,466.67,5,7300,1460,-5900,bsp
2024-01-09,2,3500,1750.0,3,5600,1867,-2100,bsp
2024-01-08,5,800,160.0,3,3500,1167,-2700,bsp
2024-01-05,3,1300,433.33,3,5600,1867,-4300,bsp
2024-01-04,1,1900,1900.0,7,9800,1400,-7900,bsp
2024-01-03,0,0,0.0,4,4700,1175,-4700,bsp
2024-01-02,5,1500,300.0,9,4300,478,-2800,bsp
2024-09-12,20,12300,615.0,7,9900,1414,2400,bsq
2024-09-11,10,7500,750.0,6,9900,1650,-2400,bsq
2024-09-10,7,10700,1528.57,7,21200,3029,-10500,bsq
2024-09-09,7,6900,985.71,7,14500,2071,-7600,bsq
2024-09-06,11,14500,1318.18,7,14700,2100,-200,bsq
2024-09-05,13,7500,576.92,13,15200,1169,-7700,bsq
2024-09-04,9,11000,1222.22,17,30800,1812,-19800,bsq
2024-08-30,7,10200,1457.14,8,11700,1462,-1500,bsq
2024-08-29,9,10500,1166.67,4,15200,3800,-4700,bsq
2024-08-28,6,10600,1766.67,5,10300,2060,300,bsq
2024-08-27,12,11900,991.67,10,10800,1080,1100,bsq
2024-08-26,9,21000,2333.33,8,9000,1125,12000,bsq
2024-08-23,14,21000,1500.0,12,21600,1800,-600,bsq
2024-08-22,8,14400,1800.0,10,21600,2160,-7200,bsq
2024-08-21,9,11500,1277.78,6,6600,1100,4900,bsq
2024-08-20,14,22900,1635.71,11,7900,718,15000,bsq
2024-08-19,7,26800,3828.57,10,20200,2020,6600,bsq
2024-08-16,13,35100,2700.0,8,8100,1012,27000,bsq
2024-08-15,5,19700,3940.0,6,5300,883,14400,bsq
2024-08-14,15,31100,2073.33,11,14000,1273,17100,bsq
2024-08-13,6,11500,1916.67,6,11800,1967,-300,bsq
2024-08-12,8,32500,4062.5,8,13800,1725,18700,bsq
2024-08-09,5,11800,2360.0,5,2300,460,9500,bsq
2024-08-08,7,10800,1542.86,5,3200,640,7600,bsq
2024-08-07,5,10800,2160.0,8,4000,500,6800,bsq
2024-08-06,11,45700,4154.55,17,18600,1094,27100,bsq
2024-08-05,10,23500,2350.0,25,20600,824,2900,bsq
2024-08-02,8,69700,8712.5,11,12500,1136,57200,bsq
2024-08-01,15,2600,173.33,12,10400,867,-7800,bsq
2024-07-31,8,53900,6737.5,10,9300,930,44600,bsq
2024-07-30,4,49100,12275.0,10,5100,510,44000,bsq
2024-07-29,4,49100,12275.0,10,10000,1000,39100,bsq
2024-07-26,9,11600,1288.89,15,12100,807,-500,bsq
2024-07-25,8,9200,1150.0,9,8500,944,700,bsq
2024-07-24,9,16400,1822.22,17,22600,1329,-6200,bsq
2024-07-23,21,21900,1042.86,28,27200,971,-5300,bsq
2024-07-22,15,15500,1033.33,16,17700,1106,-2200,bsq
2024-07-19,7,1100,157.14,15,14600,973,-13500,bsq
2024-07-18,9,2100,233.33,9,16800,1867,-14700,bsq
2024-07-17,12,2400,200.0,19,22500,1184,-20100,bsq
2024-07-16,13,14500,1115.38,19,32700,1721,-18200,bsq
2024-07-15,14,35400,2528.57,21,33900,1614,1500,bsq
2024-07-12,11,27000,2454.55,18,25700,1428,1300,bsq
2024-07-11,16,28600,1787.5,15,22900,1527,5700,bsq
2024-07-10,21,29900,1423.81,15,21700,1447,8200,bsq
2024-07-09,13,24500,1884.62,13,19800,1523,4700,bsq
2024-07-08,9,28500,3166.67,16,18300,1144,10200,bsq
2024-07-05,6,5400,900.0,12,14200,1183,-8800,bsq
2024-07-04,14,6000,428.57,16,23300,1456,-17300,bsq
2024-07-03,9,16000,1777.78,12,15800,1317,200,bsq
2024-07-02,8,8200,1025.0,13,22300,1715,-14100,bsq
2024-07-01,14,5500,392.86,22,35600,1618,-30100,bsq
2024-06-28,16,8600,537.5,23,23700,1030,-15100,bsq
2024-06-27,18,11400,633.33,29,28800,993,-17400,bsq
2024-06-26,15,15800,1053.33,25,25300,1012,-9500,bsq
2024-06-25,17,25600,1505.88,28,40700,1454,-15100,bsq
2024-06-24,16,5500,343.75,14,13700,979,-8200,bsq
2024-06-21,14,9100,650.0,19,14200,747,-5100,bsq
2024-06-20,17,18600,1094.12,21,22500,1071,-3900,bsq
2024-06-19,19,24000,1263.16,21,24700,1176,-700,bsq
2024-06-18,24,17400,725.0,25,20100,804,-2700,bsq
2024-06-17,35,31500,900.0,19,21100,1111,10400,bsq
2024-06-14,29,20000,689.66,32,28900,903,-8900,bsq
2024-06-13,23,14000,608.7,23,16600,722,-2600,bsq
2024-06-12,16,10200,637.5,21,18000,857,-7800,bsq
2024-06-11,19,22400,1178.95,23,16100,700,6300,bsq
2024-06-10,23,31800,1382.61,26,24100,927,7700,bsq
2024-06-07,33,39000,1181.82,20,19800,990,19200,bsq
2024-06-06,19,56300,2963.16,17,26200,1541,30100,bsq
2024-06-05,32,31500,984.38,37,26800,724,4700,bsq
2024-06-04,21,14200,676.19,23,18000,783,-3800,bsq
2024-06-03,29,28000,965.52,37,30800,832,-2800,bsq
2024-05-31,20,37200,1860.0,33,42700,1294,-5500,bsq
2024-05-30,11,9200,836.36,21,23000,1095,-13800,bsq
2024-05-29,23,26100,1134.78,34,33300,979,-7200,bsq
2024-05-28,24,45000,1875.0,32,53200,1662,-8200,bsq
2024-05-27,25,49800,1992.0,34,73900,2174,-24100,bsq
2024-05-24,25,36900,1476.0,24,84000,3500,-47100,bsq
2024-05-23,28,9000,321.43,16,30700,1919,-21700,bsq
2024-05-22,69,31400,455.07,46,38000,826,-6600,bsq
2024-05-21,43,22600,525.58,46,55100,1198,-32500,bsq
2024-05-20,43,18000,418.6,45,78900,1753,-60900,bsq
2024-05-17,47,55600,1182.98,56,62200,1111,-6600,bsq
2024-05-16,39,31200,800.0,33,36900,1118,-5700,bsq
2024-05-15,34,49500,1455.88,38,76300,2008,-26800,bsq
2024-05-14,58,68700,1184.48,45,93900,2087,-25200,bsq
2024-05-13,52,58200,1119.23,30,71400,2380,-13200,bsq
2024-05-10,78,71800,920.51,42,68300,1626,3500,bsq
2024-05-09,74,85400,1154.05,48,96200,2004,-10800,bsq
2024-05-08,33,45400,1375.76,27,55700,2063,-10300,bsq
2024-05-07,22,9200,418.18,17,22700,1335,-13500,bsq
2024-05-06,17,5100,300.0,18,26900,1494,-21800,bsq
2024-05-03,29,8600,296.55,22,31300,1423,-22700,bsq
2024-05-02,20,4000,200.0,14,22300,1593,-18300,bsq
2024-04-26,28,7500,267.86,13,20100,1546,-12600,bsq
2024-04-25,30,10200,340.0,17,26900,1582,-16700,bsq
2024-04-24,16,2400,150.0,13,13800,1062,-11400,bsq
2024-04-23,19,9000,473.68,16,21200,1325,-12200,bsq
2024-04-22,15,8300,553.33,24,30400,1267,-22100,bsq
2024-04-19,10,3300,330.0,20,33500,1675,-30200,bsq
2024-04-17,13,2800,215.38,15,22200,1480,-19400,bsq
2024-04-16,10,3600,360.0,17,17300,1018,-13700,bsq
2024-04-15,12,2200,183.33,15,14900,993,-12700,bsq
2024-04-12,11,2000,181.82,16,28300,1769,-26300,bsq
2024-04-11,21,8100,385.71,17,23100,1359,-15000,bsq
2024-04-10,12,3600,300.0,16,16900,1056,-13300,bsq
2024-04-09,18,7100,394.44,22,20100,914,-13000,bsq
2024-04-08,7,1700,242.86,19,21000,1105,-19300,bsq
2024-04-05,16,3800,237.5,18,19300,1072,-15500,bsq
2024-04-04,20,7800,390.0,15,18600,1240,-10800,bsq
2024-04-03,21,13300,633.33,31,23500,758,-10200,bsq
2024-04-02,14,4500,321.43,19,16700,879,-12200,bsq
2024-04-01,15,6400,426.67,29,16800,579,-10400,bsq
2024-03-29,15,12600,840.0,24,22000,917,-9400,bsq
2024-03-28,14,6400,457.14,18,15200,844,-8800,bsq
2024-03-27,10,7700,770.0,11,9800,891,-2100,bsq
2024-03-26,9,5000,555.56,11,13100,1191,-8100,bsq
2024-03-25,9,3600,400.0,7,12900,1843,-9300,bsq
2024-03-22,12,9700,808.33,19,19000,1000,-9300,bsq
2024-03-21,11,9800,890.91,12,8100,675,1700,bsq
2024-03-20,12,9300,775.0,16,12900,806,-3600,bsq
2024-03-19,21,12800,609.52,12,5900,492,6900,bsq
2024-03-18,21,10900,519.05,21,14800,705,-3900,bsq
2024-03-15,13,9100,700.0,23,13500,587,-4400,bsq
2024-03-14,14,12500,892.86,18,9200,511,3300,bsq
2024-03-13,11,8900,809.09,17,12900,759,-4000,bsq
2024-03-12,24,13300,554.17,19,12200,642,1100,bsq
2024-03-11,19,20300,1068.42,23,8400,365,11900,bsq
2024-03-08,22,25600,1163.64,23,11300,491,14300,bsq
2024-03-07,26,26400,1015.38,27,12800,474,13600,bsq
2024-03-06,16,17800,1112.5,22,10500,477,7300,bsq
2024-03-05,18,15000,833.33,26,10000,385,5000,bsq
2024-03-04,20,22100,1105.0,29,15700,541,6400,bsq
2024-03-01,24,18200,758.33,16,7600,475,10600,bsq
2024-02-29,48,33800,704.17,21,18400,876,15400,bsq
2024-02-28,41,15400,375.61,25,24800,992,-9400,bsq
2024-02-27,26,11200,430.77,18,18600,1033,-7400,bsq
2024-02-26,22,11500,522.73,22,16700,759,-5200,bsq
2024-02-23,18,10200,566.67,20,16700,835,-6500,bsq
2024-02-22,17,13100,770.59,13,19800,1523,-6700,bsq
2024-02-21,25,11300,452.0,22,15000,682,-3700,bsq
2024-02-20,21,9400,447.62,26,14200,546,-4800,bsq
2024-02-19,23,6400,278.26,29,16300,562,-9900,bsq
2024-02-16,14,6200,442.86,21,7800,371,-1600,bsq
2024-02-15,12,6400,533.33,19,14400,758,-8000,bsq
2024-02-07,14,5600,400.0,19,13600,716,-8000,bsq
2024-02-06,21,14300,680.95,21,14800,705,-500,bsq
2024-02-05,20,17600,880.0,23,15100,657,2500,bsq
2024-02-02,66,42200,639.39,25,43100,1724,-900,bsq
2024-02-01,50,25300,506.0,28,38200,1364,-12900,bsq
2024-01-31,15,12900,860.0,16,13800,862,-900,bsq
2024-01-30,18,16900,938.89,22,18300,832,-1400,bsq
2024-01-29,23,26300,1143.48,31,35500,1145,-9200,bsq
2024-01-26,12,11800,983.33,20,15500,775,-3700,bsq
2024-01-25,12,7900,658.33,15,6100,407,1800,bsq
2024-01-24,23,21700,943.48,25,19400,776,2300,bsq
2024-01-23,27,23100,855.56,16,14000,875,9100,bsq
2024-01-22,42,26500,630.95,25,21200,848,5300,bsq
2024-01-19,12,2400,200.0,12,7100,592,-4700,bsq
2024-01-18,30,11000,366.67,23,9800,426,1200,bsq
2024-01-17,6,2000,333.33,12,6600,550,-4600,bsq
2024-01-16,12,17500,1458.33,17,13700,806,3800,bsq
2024-01-15,9,2400,266.67,10,3900,390,-1500,bsq
2024-01-12,9,12100,1344.44,11,8500,773,3600,bsq
2024-01-11,10,3900,390.0,10,6200,620,-2300,bsq
2024-01-10,6,11600,1933.33,10,4700,470,6900,bsq
2024-01-09,12,12900,1075.0,14,5600,400,7300,bsq
2024-01-08,18,4800,266.67,14,7100,507,-2300,bsq
2024-01-05,16,3800,237.5,12,4900,408,-1100,bsq
2024-01-04,18,5100,283.33,13,5300,408,-200,bsq
2024-01-03,31,13200,425.81,17,11100,653,2100,bsq
2024-01-02,13,13200,1015.38,9,5600,622,7600,bsq
2024-09-12,1396,6390100,4577.44,2175,7708500,3544,-1318400,bsr
2024-09-11,2498,8809800,3526.74,1958,8126200,4150,683600,bsr
2024-09-10,2404,7896800,3284.86,2770,10521500,3798,-2624700,bsr
2024-09-09,2422,9275200,3829.56,2896,9816300,3390,-541100,bsr
2024-09-06,4196,12051600,2872.16,2201,7998400,3634,4053200,bsr
2024-09-05,4213,10878100,2582.03,2310,10851400,4698,26700,bsr
2024-09-04,5288,11726100,2217.49,2658,11761400,4425,-35300,bsr
2024-08-30,2818,8068600,2863.24,2606,8837500,3391,-768900,bsr
2024-08-29,2679,6648600,2481.75,2712,9238500,3407,-2589900,bsr
2024-08-28,2898,8433900,2910.25,4747,14204700,2992,-5770800,bsr
2024-08-27,3762,13382400,3557.26,4168,12193400,2925,1189000,bsr
2024-08-26,3688,9943400,2696.15,4225,15046200,3561,-5102800,bsr
2024-08-23,4672,11336200,2426.41,3690,12549200,3401,-1213000,bsr
2024-08-22,4125,9237400,2239.37,4590,12712300,2770,-3474900,bsr
2024-08-21,5157,18327400,3553.89,7792,23329500,2994,-5002100,bsr
2024-08-20,6249,17960000,2874.06,4607,17078200,3707,881800,bsr
2024-08-19,4696,12706600,2705.83,6269,18390700,2934,-5684100,bsr
2024-08-16,7375,23262500,3154.24,8745,23998900,2744,-736400,bsr
2024-08-15,3489,9575400,2744.45,2873,8920800,3105,654600,bsr
2024-08-14,4592,12472200,2716.07,4538,15366900,3386,-2894700,bsr
2024-08-13,5697,18392200,3228.4,7133,22451000,3147,-4058800,bsr
2024-08-12,3306,9855400,2981.06,5533,16068800,2904,-6213400,bsr
2024-08-09,3315,12363100,3729.44,4071,12452600,3059,-89500,bsr
2024-08-08,4351,15674700,3602.55,6488,18325600,2825,-2650900,bsr
2024-08-07,3467,15079700,4349.5,4251,14777500,3476,302200,bsr
2024-08-06,3274,11253200,3437.14,2887,9591800,3322,1661400,bsr
2024-08-05,6367,16599900,2607.18,4083,16541900,4051,58000,bsr
2024-08-02,5143,14912200,2899.51,2533,11973500,4727,2938700,bsr
2024-08-01,4259,13441000,3155.91,4809,14445400,3004,-1004400,bsr
2024-07-31,5887,23658300,4018.74,7411,22796400,3076,861900,bsr
2024-07-30,3399,12253600,3605.06,1868,9053900,4847,3199700,bsr
2024-07-29,1968,6270100,3186.03,2358,8024300,3403,-1754200,bsr
2024-07-26,2381,8275100,3475.47,2163,8088000,3739,187100,bsr
2024-07-25,3265,8842100,2708.15,2823,9138000,3237,-295900,bsr
2024-07-24,5262,14680700,2789.95,2965,9835400,3317,4845300,bsr
2024-07-23,5487,17033300,3104.3,3190,15677200,4914,1356100,bsr
2024-07-22,5367,14427200,2688.13,3288,12301200,3741,2126000,bsr
2024-07-19,4043,10221400,2528.17,3103,11358500,3660,-1137100,bsr
2024-07-18,5540,14147600,2553.72,2719,10713800,3940,3433800,bsr
2024-07-17,8858,20240700,2285.02,4443,21401300,4817,-1160600,bsr
2024-07-16,4541,11461300,2523.96,4047,15003500,3707,-3542200,bsr
2024-07-15,4224,13642600,3229.78,6622,16404400,2477,-2761800,bsr
2024-07-12,4893,14704300,3005.17,4371,14341200,3281,363100,bsr
2024-07-11,5327,10375100,1947.64,3760,13788100,3667,-3413000,bsr
2024-07-10,5493,11425800,2080.07,6453,19500600,3022,-8074800,bsr
2024-07-09,7227,19229800,2660.83,6709,19469300,2902,-239500,bsr
2024-07-08,4465,12192500,2730.68,4588,14848600,3236,-2656100,bsr
2024-07-05,3211,6775000,2109.93,3076,10047500,3266,-3272500,bsr
2024-07-04,3885,14082800,3624.92,4353,16604700,3815,-2521900,bsr
2024-07-03,3395,8302200,2445.42,1894,10327900,5453,-2025700,bsr
2024-07-02,3502,8718600,2489.61,2098,11556900,5509,-2838300,bsr
2024-07-01,4744,13039300,2748.59,2128,9621600,4521,3417700,bsr
2024-06-28,6824,16420600,2406.3,3346,17329200,5179,-908600,bsr
2024-06-27,5006,10334800,2064.48,2027,12159500,5999,-1824700,bsr
2024-06-26,3590,10842400,3020.17,2779,10528200,3788,314200,bsr
2024-06-25,6762,14876500,2200.01,2884,14036200,4867,840300,bsr
2024-06-24,8625,21578700,2501.88,4641,21339900,4598,238800,bsr
2024-06-21,6030,15943900,2644.1,4556,19158200,4205,-3214300,bsr
2024-06-20,5006,13996600,2795.96,5921,17353500,2931,-3356900,bsr
2024-06-19,5018,14588700,2907.27,4577,15268300,3336,-679600,bsr
2024-06-18,7610,25468700,3346.74,9330,27207100,2916,-1738400,bsr
2024-06-17,4342,12681800,2920.73,3549,11970700,3373,711100,bsr
2024-06-14,5187,14671900,2828.59,4472,17460700,3904,-2788800,bsr
2024-06-13,3195,8025800,2511.99,2757,10517100,3815,-2491300,bsr
2024-06-12,5579,12066900,2162.91,2312,10998800,4757,1068100,bsr
2024-06-11,5497,14484200,2634.93,2720,15010900,5519,-526700,bsr
2024-06-10,2977,8086500,2716.33,3362,10395800,3092,-2309300,bsr
2024-06-07,2901,8735300,3011.13,3033,10510900,3466,-1775600,bsr
2024-06-06,3963,16721700,4219.45,7244,20801000,2871,-4079300,bsr
2024-06-05,4392,12452800,2835.34,4132,14307500,3463,-1854700,bsr
2024-06-04,4514,16305300,3612.16,5437,18682500,3436,-2377200,bsr
2024-06-03,2042,8468400,4147.11,3989,12764800,3200,-4296400,bsr
2024-05-31,3051,8758300,2870.63,2835,8983900,3169,-225600,bsr
2024-05-30,6259,20469500,3270.41,5558,20636600,3713,-167100,bsr
2024-05-29,3433,16086500,4685.84,7239,20962800,2896,-4876300,bsr
2024-05-28,3686,14679800,3982.58,6622,16592900,2506,-1913100,bsr
2024-05-27,4041,12479100,3088.12,4977,13185300,2649,-706200,bsr
2024-05-24,8384,25182900,3003.69,10276,28742600,2797,-3559700,bsr
2024-05-23,7733,23464300,3034.31,10471,25790600,2463,-2326300,bsr
2024-05-22,8858,36556000,4126.89,15687,34985100,2230,1570900,bsr
2024-05-21,2783,9971500,3583.0,4643,11793900,2540,-1822400,bsr
2024-05-20,3020,10596000,3508.61,6968,17880900,2566,-7284900,bsr
2024-05-17,2870,9603000,3345.99,5445,14434500,2651,-4831500,bsr
2024-05-16,4181,14945400,3574.6,6579,18503700,2813,-3558300,bsr
2024-05-15,2097,5143900,2452.98,2546,7286800,2862,-2142900,bsr
2024-05-14,1697,5441000,3206.25,2555,8636600,3380,-3195600,bsr
2024-05-13,2090,8377000,4008.13,2085,8128500,3899,248500,bsr
2024-05-10,3086,8355900,2707.68,2557,9160100,3582,-804200,bsr
2024-05-09,2164,5685500,2627.31,3566,9854600,2763,-4169100,bsr
2024-05-08,3371,11232600,3332.13,5603,13453700,2401,-2221100,bsr
2024-05-07,2516,8347400,3317.73,4119,11395600,2767,-3048200,bsr
2024-05-06,3167,13256400,4185.79,4144,12782000,3084,474400,bsr
2024-05-03,3177,7192000,2263.77,2004,7496600,3741,-304600,bsr
2024-05-02,2891,4582500,1585.09,1526,5437600,3563,-855100,bsr
2024-04-26,2819,4989200,1769.85,1829,6075000,3321,-1085800,bsr
2024-04-25,2833,5934900,2094.92,2024,8905000,4400,-2970100,bsr
2024-04-24,2880,6725800,2335.35,2321,7405100,3190,-679300,bsr
2024-04-23,2904,4748600,1635.19,2243,7028300,3133,-2279700,bsr
2024-04-22,3506,9707800,2768.91,2094,8309800,3968,1398000,bsr
2024-04-19,6257,14373000,2297.11,3150,12928000,4104,1445000,bsr
2024-04-17,4690,12247000,2611.3,2613,12477400,4775,-230400,bsr
2024-04-16,6024,15190500,2521.66,3292,11522200,3500,3668300,bsr
2024-04-15,7230,17894600,2475.05,6471,24814300,3835,-6919700,bsr
2024-04-12,3313,7848700,2369.06,2570,9097300,3540,-1248600,bsr
2024-04-11,3830,9736400,2542.14,2505,8739700,3489,996700,bsr
2024-04-10,4563,9831000,2154.5,3060,11903200,3890,-2072200,bsr
2024-04-09,3775,10908600,2889.7,3112,12772400,4104,-1863800,bsr
2024-04-08,3779,9470100,2505.98,3425,11542100,3370,-2072000,bsr
2024-04-05,8589,27903300,3248.73,10987,31501800,2867,-3598500,bsr
2024-04-04,4663,10162300,2179.35,4064,13961100,3435,-3798800,bsr
2024-04-03,6363,16236500,2551.71,8698,23028900,2648,-6792400,bsr
2024-04-02,5573,13847500,2484.75,5369,15089400,2810,-1241900,bsr
2024-04-01,3458,7347000,2124.64,3361,10752300,3199,-3405300,bsr
2024-03-29,2942,7581100,2576.85,3978,12706400,3194,-5125300,bsr
2024-03-28,3542,6657300,1879.53,3034,9575300,3156,-2918000,bsr
2024-03-27,3662,7170500,1958.08,3652,11944700,3271,-4774200,bsr
2024-03-26,2972,7283500,2450.71,2734,8548000,3127,-1264500,bsr
2024-03-25,3725,7542200,2024.75,3728,12475100,3346,-4932900,bsr
2024-03-22,4628,9913300,2142.03,3924,11902200,3033,-1988900,bsr
2024-03-21,3020,7112600,2355.17,3656,10434500,2854,-3321900,bsr
2024-03-20,3388,9589300,2830.37,3002,9205700,3067,383600,bsr
2024-03-19,3863,7143200,1849.13,2411,8359300,3467,-1216100,bsr
2024-03-18,8159,13880000,1701.19,3624,13921900,3842,-41900,bsr
2024-03-15,4312,8059500,1869.09,3674,11344800,3088,-3285300,bsr
2024-03-14,4655,10226400,2196.86,4666,14323500,3070,-4097100,bsr
2024-03-13,5326,9388100,1762.69,2275,8523800,3747,864300,bsr
2024-03-12,4294,7443100,1733.37,2272,9311300,4098,-1868200,bsr
2024-03-11,4170,6312000,1513.67,2261,7849200,3472,-1537200,bsr
2024-03-08,4456,9145600,2052.42,3284,11703900,3564,-2558300,bsr
2024-03-07,2845,8829400,3103.48,3064,9210000,3006,-380600,bsr
2024-03-06,5641,9624300,1706.13,3275,11259200,3438,-1634900,bsr
2024-03-05,4868,8158100,1675.86,2917,9266400,3177,-1108300,bsr
2024-03-04,3554,8500400,2391.78,4422,12242600,2769,-3742200,bsr
2024-03-01,3990,10116700,2535.51,3060,9349300,3055,767400,bsr
2024-02-29,4908,9177400,1869.89,4571,12235000,2677,-3057600,bsr
2024-02-28,5656,17351500,3067.8,8574,22297900,2601,-4946400,bsr
2024-02-27,4453,15786500,3545.14,5698,15931000,2796,-144500,bsr
2024-02-26,4048,8696300,2148.3,2207,9913900,4492,-1217600,bsr
2024-02-23,4761,9323200,1958.24,3289,12104000,3680,-2780800,bsr
2024-02-22,3375,9017900,2671.97,4095,12073800,2948,-3055900,bsr
2024-02-21,4369,9109900,2085.12,3211,10587400,3297,-1477500,bsr
2024-02-20,3499,8374000,2393.26,4821,12566900,2607,-4192900,bsr
2024-02-19,6139,27165300,4425.04,9537,25161900,2638,2003400,bsr
2024-02-16,2171,5554300,2558.41,2958,8180400,2766,-2626100,bsr
2024-02-15,2085,8062700,3867.0,3159,9267300,2934,-1204600,bsr
2024-02-07,2340,5491000,2346.58,1707,7012200,4108,-1521200,bsr
2024-02-06,2716,5870300,2161.38,1563,6225800,3983,-355500,bsr
2024-02-05,3391,6585200,1941.96,1748,8132000,4652,-1546800,bsr
2024-02-02,3343,5429500,1624.14,1637,6449800,3940,-1020300,bsr
2024-02-01,2666,6606700,2478.13,1529,8236100,5387,-1629400,bsr
2024-01-31,2304,5410200,2348.18,2457,9449800,3846,-4039600,bsr
2024-01-30,1517,5382700,3548.25,2648,8098900,3058,-2716200,bsr
2024-01-29,1406,5082200,3614.65,3833,10764800,2808,-5682600,bsr
2024-01-26,1718,9068000,5278.23,4899,13694600,2795,-4626600,bsr
2024-01-25,1250,3409900,2727.92,2956,8132500,2751,-4722600,bsr
2024-01-24,1721,9035400,5250.09,4000,10912900,2728,-1877500,bsr
2024-01-23,1561,4272200,2736.84,2984,8639400,2895,-4367200,bsr
2024-01-22,1598,6683800,4182.6,2897,8805000,3039,-2121200,bsr
2024-01-19,1907,7421200,3891.56,4242,12099300,2852,-4678100,bsr
2024-01-18,2139,7655900,3579.2,2700,8650700,3204,-994800,bsr
2024-01-17,2145,5333000,2486.25,2501,8185300,3273,-2852300,bsr
2024-01-16,2507,5016700,2001.08,1692,6306700,3727,-1290000,bsr
2024-01-15,1842,3945900,2142.18,1826,6962000,3813,-3016100,bsr
2024-01-12,3367,7883000,2341.25,2382,11088900,4655,-3205900,bsr
2024-01-11,3768,8151200,2163.27,2284,8261800,3617,-110600,bsr
2024-01-10,4357,8377100,1922.68,2462,9439400,3834,-1062300,bsr
2024-01-09,6265,12873100,2054.76,2867,14697600,5126,-1824500,bsr
2024-01-08,2570,6022000,2343.19,3492,11256100,3223,-5234100,bsr
2024-01-05,2077,6684500,3218.34,3624,10231800,2823,-3547300,bsr
2024-01-04,3489,13081400,3749.33,4362,15839900,3631,-2758500,bsr
2024-01-03,2486,5608300,2255.95,2194,8255000,3763,-2646700,bsr
2024-01-02,2498,6462300,2586.99,3647,11479000,3148,-5016700,bsr
2024-09-12,9,2000,222.22,10,3000,300,-1000,bst
2024-09-11,5,1100,220.0,7,2000,286,-900,bst
2024-09-10,5,400,80.0,9,1500,167,-1100,bst
2024-09-09,10,3400,340.0,6,3200,533,200,bst
2024-09-06,12,3400,283.33,10,4800,480,-1400,bst
2024-09-05,6,2700,450.0,5,1700,340,1000,bst
2024-09-04,7,3700,528.57,5,3600,720,100,bst
2024-08-30,4,1700,425.0,4,2900,725,-1200,bst
2024-08-29,4,1800,450.0,6,4500,750,-2700,bst
2024-08-28,7,1900,271.43,8,2700,338,-800,bst
2024-08-27,7,1900,271.43,5,1700,340,200,bst
2024-08-26,4,1700,425.0,5,3900,780,-2200,bst
2024-08-23,4,900,225.0,9,3500,389,-2600,bst
2024-08-22,3,800,266.67,7,6000,857,-5200,bst
2024-08-21,6,1400,233.33,6,1500,250,-100,bst
2024-08-20,3,900,300.0,5,9600,1920,-8700,bst
2024-08-19,3,1000,333.33,4,1600,400,-600,bst
2024-08-16,3,1000,333.33,4,1500,375,-500,bst
2024-08-15,3,1000,333.33,3,1000,333,0,bst
2024-08-14,2,200,100.0,7,2400,343,-2200,bst
2024-08-13,2,100,50.0,7,2000,286,-1900,bst
2024-08-12,1,100,100.0,5,1900,380,-1800,bst
2024-08-09,1,100,100.0,6,1700,283,-1600,bst
2024-08-08,1,100,100.0,5,1300,260,-1200,bst
2024-08-07,1,100,100.0,6,2000,333,-1900,bst
2024-08-06,3,300,100.0,7,3000,429,-2700,bst
2024-08-05,3,500,166.67,7,5900,843,-5400,bst
2024-08-02,3,700,233.33,7,2500,357,-1800,bst
2024-08-01,2,200,100.0,7,3900,557,-3700,bst
2024-07-31,3,600,200.0,8,2500,312,-1900,bst
2024-07-30,4,500,125.0,13,2700,208,-2200,bst
2024-07-29,2,100,50.0,10,3100,310,-3000,bst
2024-07-26,2,1000,500.0,11,4000,364,-3000,bst
2024-07-25,3,500,166.67,8,2100,262,-1600,bst
2024-07-24,2,400,200.0,9,2400,267,-2000,bst
2024-07-23,1,100,100.0,11,3400,309,-3300,bst
2024-07-22,5,1100,220.0,4,1100,275,0,bst
2024-07-19,4,1800,450.0,5,3200,640,-1400,bst
2024-07-18,4,1200,300.0,4,1200,300,0,bst
2024-07-17,5,1100,220.0,4,2900,725,-1800,bst
2024-07-16,7,1600,228.57,4,3000,750,-1400,bst
2024-07-15,6,1200,200.0,5,2300,460,-1100,bst
2024-07-12,4,1100,275.0,4,2100,525,-1000,bst
2024-07-11,1,100,100.0,11,3800,345,-3700,bst
2024-07-10,6,1300,216.67,7,4000,571,-2700,bst
2024-07-09,6,5100,850.0,6,5400,900,-300,bst
2024-07-08,5,40600,8120.0,13,44700,3438,-4100,bst
2024-07-05,0,0,0.0,9,4200,467,-4200,bst
2024-07-04,0,0,0.0,12,5700,475,-5700,bst
2024-07-03,1,1000,1000.0,13,5800,446,-4800,bst
2024-07-02,3,800,266.67,13,7500,577,-6700,bst
2024-07-01,2,500,250.0,10,6200,620,-5700,bst
2024-06-28,2,500,250.0,8,2900,362,-2400,bst
2024-06-27,2,900,450.0,10,3200,320,-2300,bst
2024-06-26,5,1000,200.0,8,3000,375,-2000,bst
2024-06-25,9,4600,511.11,12,5900,492,-1300,bst
2024-06-24,4,3300,825.0,6,2100,350,1200,bst
2024-06-21,8,3700,462.5,6,3000,500,700,bst
2024-06-20,8,5400,675.0,6,3000,500,2400,bst
2024-06-19,17,4500,264.71,2,1000,500,3500,bst
2024-06-18,25,10300,412.0,7,2900,414,7400,bst
2024-06-17,5,2600,520.0,4,1300,325,1300,bst
2024-06-14,8,2700,337.5,6,2100,350,600,bst
2024-06-13,22,5200,236.36,8,3300,412,1900,bst
2024-06-12,7,2300,328.57,16,9400,588,-7100,bst
2024-06-11,1,500,500.0,12,5700,475,-5200,bst
2024-06-10,5,1500,300.0,11,4500,409,-3000,bst
2024-06-07,5,1000,200.0,10,3400,340,-2400,bst
2024-06-06,6,800,133.33,12,4800,400,-4000,bst
2024-06-05,21,5100,242.86,10,2800,280,2300,bst
2024-06-04,19,3200,168.42,4,1300,325,1900,bst
2024-06-03,21,5100,242.86,7,4600,657,500,bst
2024-05-31,9,4100,455.56,11,5900,536,-1800,bst
2024-05-30,7,2000,285.71,15,12500,833,-10500,bst
2024-05-29,0,0,0.0,11,5600,509,-5600,bst
2024-05-28,0,0,0.0,6,4700,783,-4700,bst
2024-05-27,0,0,0.0,13,8300,638,-8300,bst
2024-05-24,0,0,0.0,8,4700,588,-4700,bst
2024-05-23,0,0,0.0,13,9200,708,-9200,bst
2024-05-22,0,0,0.0,16,9000,562,-9000,bst
2024-05-21,1,100,100.0,14,11200,800,-11100,bst
2024-05-20,1,200,200.0,11,7900,718,-7700,bst
2024-05-17,2,300,150.0,7,4200,600,-3900,bst
2024-05-16,6,2400,400.0,15,4800,320,-2400,bst
2024-05-15,8,2300,287.5,12,3500,292,-1200,bst
2024-05-14,7,2200,314.29,6,4100,683,-1900,bst
2024-05-13,14,3500,250.0,9,2900,322,600,bst
2024-05-10,7,1100,157.14,13,5100,392,-4000,bst
2024-05-09,1,100,100.0,13,4500,346,-4400,bst
2024-05-08,6,1500,250.0,27,7300,270,-5800,bst
2024-05-07,7,1100,157.14,15,7400,493,-6300,bst
2024-05-06,6,700,116.67,18,8400,467,-7700,bst
2024-05-03,10,2700,270.0,9,2300,256,400,bst
2024-05-02,11,4300,390.91,9,2100,233,2200,bst
2024-04-26,9,1200,133.33,5,1400,280,-200,bst
2024-04-25,7,1000,142.86,4,1600,400,-600,bst
2024-04-24,6,1300,216.67,10,3900,390,-2600,bst
2024-04-23,6,700,116.67,8,3100,388,-2400,bst
2024-04-22,3,500,166.67,5,2200,440,-1700,bst
2024-04-19,6,1300,216.67,4,1200,300,100,bst
2024-04-17,14,2500,178.57,12,2100,175,400,bst
2024-04-16,7,2100,300.0,6,1800,300,300,bst
2024-04-15,13,3800,292.31,13,2600,200,1200,bst
2024-04-12,10,2100,210.0,12,2900,242,-800,bst
2024-04-11,9,5400,600.0,12,5300,442,100,bst
2024-04-10,4,1100,275.0,11,5100,464,-4000,bst
2024-04-09,3,1100,366.67,6,1900,317,-800,bst
2024-04-08,3,1400,466.67,9,4500,500,-3100,bst
2024-04-05,6,3300,550.0,7,3400,486,-100,bst
2024-04-04,14,8000,571.43,11,5300,482,2700,bst
2024-04-03,8,9200,1150.0,8,3800,475,5400,bst
2024-04-02,8,12000,1500.0,11,5800,527,6200,bst
2024-04-01,9,3900,433.33,12,6200,517,-2300,bst
2024-03-29,10,5000,500.0,14,5500,393,-500,bst
2024-03-28,11,3600,327.27,8,3200,400,400,bst
2024-03-27,16,2500,156.25,18,7700,428,-5200,bst
2024-03-26,11,1600,145.45,13,4300,331,-2700,bst
2024-03-25,10,1800,180.0,7,5800,829,-4000,bst
2024-03-22,18,18300,1016.67,19,17000,895,1300,bst
2024-03-21,6,1000,166.67,10,6100,610,-5100,bst
2024-03-20,3,500,166.67,5,1900,380,-1400,bst
2024-03-19,3,400,133.33,8,6600,825,-6200,bst
2024-03-18,3,400,133.33,5,4400,880,-4000,bst
2024-03-15,3,500,166.67,8,11000,1375,-10500,bst
2024-03-14,5,800,160.0,4,1400,350,-600,bst
2024-03-13,4,1500,375.0,6,2600,433,-1100,bst
2024-03-12,4,700,175.0,7,6900,986,-6200,bst
2024-03-11,8,1300,162.5,4,1700,425,-400,bst
2024-03-08,4,900,225.0,9,7200,800,-6300,bst
2024-03-07,11,800,72.73,15,7700,513,-6900,bst
2024-03-06,7,5800,828.57,12,4000,333,1800,bst
2024-03-05,3,700,233.33,6,4000,667,-3300,bst
2024-03-04,7,2400,342.86,11,3400,309,-1000,bst
2024-03-01,6,2000,333.33,4,1800,450,200,bst
2024-02-29,8,1200,150.0,3,500,167,700,bst
2024-02-28,6,2200,366.67,8,5400,675,-3200,bst
2024-02-27,4,1600,400.0,8,8100,1012,-6500,bst
2024-02-26,4,1700,425.0,5,3300,660,-1600,bst
2024-02-23,4,600,150.0,5,2300,460,-1700,bst
2024-02-22,9,1200,133.33,11,4100,373,-2900,bst
2024-02-21,2,400,200.0,6,1300,217,-900,bst
2024-02-20,1,200,200.0,11,3400,309,-3200,bst
2024-02-19,3,1500,500.0,9,2400,267,-900,bst
2024-02-16,9,4700,522.22,9,6200,689,-1500,bst
2024-02-15,9,7000,777.78,7,1200,171,5800,bst
2024-02-07,12,5400,450.0,8,7900,988,-2500,bst
2024-02-06,15,14000,933.33,14,2300,164,11700,bst
2024-02-05,15,15200,1013.33,17,6700,394,8500,bst
2024-02-02,8,7500,937.5,13,9500,731,-2000,bst
2024-02-01,3,1500,500.0,7,15700,2243,-14200,bst
2024-01-31,9,4900,544.44,11,14900,1355,-10000,bst
2024-01-30,22,12300,559.09,27,17700,656,-5400,bst
2024-01-29,9,2100,233.33,15,15700,1047,-13600,bst
2024-01-26,5,2600,520.0,12,15000,1250,-12400,bst
2024-01-25,11,4000,363.64,15,18600,1240,-14600,bst
2024-01-24,12,1900,158.33,17,7500,441,-5600,bst
2024-01-23,17,22000,1294.12,25,17100,684,4900,bst
2024-01-22,6,4700,783.33,14,4400,314,300,bst
2024-01-19,13,2900,223.08,10,2800,280,100,bst
2024-01-18,10,2500,250.0,14,4500,321,-2000,bst
2024-01-17,14,1800,128.57,33,14300,433,-12500,bst
2024-01-16,10,2500,250.0,23,7400,322,-4900,bst
2024-01-15,16,8200,512.5,19,10900,574,-2700,bst
2024-01-12,40,9900,247.5,24,14600,608,-4700,bst
2024-01-11,20,6100,305.0,21,6100,290,0,bst
2024-01-10,15,5800,386.67,12,5800,483,0,bst
2024-01-09,16,3800,237.5,13,6200,477,-2400,bst
2024-01-08,27,13600,503.7,23,17900,778,-4300,bst
2024-01-05,16,2700,168.75,15,16000,1067,-13300,bst
2024-01-04,14,2700,192.86,13,6000,462,-3300,bst
2024-01-03,17,6300,370.59,4,12500,3125,-6200,bst
2024-01-02,11,5300,481.82,10,11600,1160,-6300,bst
2024-09-12,4,100,25.0,3,500,167,-400,bt1
2024-09-11,7,30800,4400.0,3,30400,10133,400,bt1
2024-09-10,4,600,150.0,2,400,200,200,bt1
2024-09-09,3,500,166.67,2,400,200,100,bt1
2024-09-06,3,400,133.33,3,600,200,-200,bt1
2024-09-05,2,500,250.0,5,1600,320,-1100,bt1
2024-09-04,1,100,100.0,3,2100,700,-2000,bt1
2024-08-30,3,500,166.67,2,300,150,200,bt1
2024-08-29,2,300,150.0,3,2100,700,-1800,bt1
2024-08-28,1,100,100.0,2,300,150,-200,bt1
2024-08-27,3,500,166.67,3,500,167,0,bt1
2024-08-26,1,100,100.0,1,100,100,0,bt1
2024-08-23,1,100,100.0,1,100,100,0,bt1
2024-08-22,1,100,100.0,1,100,100,0,bt1
2024-08-21,1,100,100.0,3,2100,700,-2000,bt1
2024-08-20,1,100,100.0,2,300,150,-200,bt1
2024-08-19,2,200,100.0,2,200,100,0,bt1
2024-08-16,1,100,100.0,2,2000,1000,-1900,bt1
2024-08-15,2,200,100.0,2,200,100,0,bt1
2024-08-14,2,200,100.0,4,2200,550,-2000,bt1
2024-08-13,2,600,300.0,1,100,100,500,bt1
2024-08-12,2,600,300.0,2,2000,1000,-1400,bt1
2024-08-09,2,200,100.0,1,100,100,100,bt1
2024-08-08,2,600,300.0,1,100,100,500,bt1
2024-08-07,5,900,180.0,3,2200,733,-1300,bt1
2024-08-06,4,700,175.0,4,1000,250,-300,bt1
2024-08-05,2,200,100.0,4,4400,1100,-4200,bt1
2024-08-02,2,600,300.0,3,4300,1433,-3700,bt1
2024-08-01,3,1100,366.67,5,5300,1060,-4200,bt1
2024-07-31,2,600,300.0,3,3800,1267,-3200,bt1
2024-07-30,1,100,100.0,2,300,150,-200,bt1
2024-07-29,2,600,300.0,4,9800,2450,-9200,bt1
2024-07-26,2,600,300.0,4,10300,2575,-9700,bt1
2024-07-25,2,200,100.0,3,3800,1267,-3600,bt1
2024-07-24,2,600,300.0,3,3800,1267,-3200,bt1
2024-07-23,3,700,233.33,2,700,350,0,bt1
2024-07-22,1,100,100.0,3,10700,3567,-10600,bt1
2024-07-19,4,1100,275.0,2,1100,550,0,bt1
2024-07-18,3,600,200.0,2,600,300,0,bt1
2024-07-17,2,600,300.0,3,1700,567,-1100,bt1
2024-07-16,2,600,300.0,3,700,233,-100,bt1
2024-07-15,2,600,300.0,3,4700,1567,-4100,bt1
2024-07-12,2,600,300.0,2,2100,1050,-1500,bt1
2024-07-11,3,700,233.33,2,400,200,300,bt1
2024-07-10,2,600,300.0,2,2100,1050,-1500,bt1
2024-07-09,4,1100,275.0,4,6700,1675,-5600,bt1
2024-07-08,4,1600,400.0,3,5600,1867,-4000,bt1
2024-07-05,2,1100,550.0,1,100,100,1000,bt1
2024-07-04,1,100,100.0,1,100,100,0,bt1
2024-07-03,1,100,100.0,1,100,100,0,bt1
2024-07-02,1,100,100.0,2,200,100,-100,bt1
2024-07-01,2,200,100.0,2,10100,5050,-9900,bt1
2024-06-28,4,500,125.0,2,10100,5050,-9600,bt1
2024-06-27,3,300,100.0,4,300,75,0,bt1
2024-06-26,3,300,100.0,1,100,100,200,bt1
2024-06-25,2,200,100.0,1,100,100,100,bt1
2024-06-24,2,200,100.0,1,100,100,100,bt1
2024-06-21,2,200,100.0,1,100,100,100,bt1
2024-06-20,2,200,100.0,2,10100,5050,-9900,bt1
2024-06-19,2,200,100.0,3,4200,1400,-4000,bt1
2024-06-18,2,200,100.0,2,4100,2050,-3900,bt1
2024-06-17,4,400,100.0,2,300,150,100,bt1
2024-06-14,2,3100,1550.0,1,100,100,3000,bt1
2024-06-13,1,100,100.0,1,100,100,0,bt1
2024-06-12,3,300,100.0,2,200,100,100,bt1
2024-06-11,3,300,100.0,2,200,100,100,bt1
2024-06-10,7,1500,214.29,4,1200,300,300,bt1
2024-06-07,3,1100,366.67,2,200,100,900,bt1
2024-06-06,3,300,100.0,3,800,267,-500,bt1
2024-06-05,3,2100,700.0,3,300,100,1800,bt1
2024-06-04,4,600,150.0,4,1000,250,-400,bt1
2024-06-03,5,2400,480.0,5,1100,220,1300,bt1
2024-05-31,7,600,85.71,5,1100,220,-500,bt1
2024-05-30,3,300,100.0,5,2000,400,-1700,bt1
2024-05-29,4,400,100.0,4,800,200,-400,bt1
2024-05-28,4,200,50.0,1,100,100,100,bt1
2024-05-27,5,1800,360.0,4,1400,350,400,bt1
2024-05-24,4,400,100.0,5,1200,240,-800,bt1
2024-05-23,1,100,100.0,4,700,175,-600,bt1
2024-05-22,3,300,100.0,3,900,300,-600,bt1
2024-05-21,4,1300,325.0,6,800,133,500,bt1
2024-05-20,2,200,100.0,1,100,100,100,bt1
2024-05-17,2,200,100.0,0,0,0,200,bt1
2024-05-16,2,200,100.0,1,100,100,100,bt1
2024-05-15,1,100,100.0,0,0,0,100,bt1
2024-05-14,2,200,100.0,1,100,100,100,bt1
2024-05-13,1,100,100.0,1,100,100,0,bt1
2024-05-10,1,100,100.0,1,100,100,0,bt1
2024-05-09,2,200,100.0,0,0,0,200,bt1
2024-05-08,1,100,100.0,0,0,0,100,bt1
2024-05-07,1,100,100.0,0,0,0,100,bt1
2024-05-06,3,600,200.0,4,700,175,-100,bt1
2024-05-03,1,100,100.0,1,100,100,0,bt1
2024-05-02,1,100,100.0,1,100,100,0,bt1
2024-04-26,1,100,100.0,2,700,350,-600,bt1
2024-04-25,1,100,100.0,2,200,100,-100,bt1
2024-04-24,1,100,100.0,5,900,180,-800,bt1
2024-04-23,1,100,100.0,1,100,100,0,bt1
2024-04-22,1,100,100.0,1,100,100,0,bt1
2024-04-19,1,100,100.0,2,200,100,-100,bt1
2024-04-17,1,100,100.0,1,100,100,0,bt1
2024-04-16,1,100,100.0,2,200,100,-100,bt1
2024-04-15,3,200,66.67,1,100,100,100,bt1
2024-04-12,1,100,100.0,2,4700,2350,-4600,bt1
2024-04-11,1,100,100.0,1,100,100,0,bt1
2024-04-10,2,200,100.0,1,100,100,100,bt1
2024-04-09,1,100,100.0,2,200,100,-100,bt1
2024-04-08,6,17800,2966.67,6,16000,2667,1800,bt1
2024-04-05,1,0,0.0,5,400,80,-400,bt1
2024-04-04,1,100,100.0,5,5100,1020,-5000,bt1
2024-04-03,2,200,100.0,5,2000,400,-1800,bt1
2024-04-02,3,500,166.67,3,300,100,200,bt1
2024-04-01,1,100,100.0,3,1800,600,-1700,bt1
2024-03-29,1,100,100.0,3,300,100,-200,bt1
2024-03-28,2,200,100.0,3,1800,600,-1600,bt1
2024-03-27,2,200,100.0,2,200,100,0,bt1
2024-03-26,1,100,100.0,2,200,100,-100,bt1
2024-03-25,3,200,66.67,2,200,100,0,bt1
2024-03-22,2,600,300.0,3,1600,533,-1000,bt1
2024-03-21,2,200,100.0,4,1800,450,-1600,bt1
2024-03-20,5,22800,4560.0,10,25300,2530,-2500,bt1
2024-03-19,3,300,100.0,2,200,100,100,bt1
2024-03-18,5,30600,6120.0,1,100,100,30500,bt1
2024-03-15,9,37800,4200.0,2,100,50,37700,bt1
2024-03-14,11,3200,290.91,7,16400,2343,-13200,bt1
2024-03-13,5,400,80.0,7,15700,2243,-15300,bt1
2024-03-12,5,1000,200.0,11,16300,1482,-15300,bt1
2024-03-11,1,100,100.0,5,16300,3260,-16200,bt1
2024-03-08,2,200,100.0,4,16300,4075,-16100,bt1
2024-03-07,5,500,100.0,5,800,160,-300,bt1
2024-03-06,1,100,100.0,3,300,100,-200,bt1
2024-03-05,1,100,100.0,4,300,75,-200,bt1
2024-03-04,1,100,100.0,3,200,67,-100,bt1
2024-03-01,3,200,66.67,2,200,100,0,bt1
2024-02-29,6,2000,333.33,4,16300,4075,-14300,bt1
2024-02-28,2,200,100.0,3,600,200,-400,bt1
2024-02-27,3,300,100.0,2,200,100,100,bt1
2024-02-26,3,300,100.0,3,600,200,-300,bt1
2024-02-23,4,300,75.0,8,800,100,-500,bt1
2024-02-22,2,200,100.0,4,1900,475,-1700,bt1
2024-02-21,2,200,100.0,4,300,75,-100,bt1
2024-02-20,2,200,100.0,4,300,75,-100,bt1
2024-02-19,2,200,100.0,4,300,75,-100,bt1
2024-02-16,2,200,100.0,6,500,83,-300,bt1
2024-02-15,2,200,100.0,5,900,180,-700,bt1
2024-02-07,1,100,100.0,2,200,100,-100,bt1
2024-02-06,1,100,100.0,3,9800,3267,-9700,bt1
2024-02-05,1,100,100.0,3,300,100,-200,bt1
2024-02-02,2,200,100.0,3,300,100,-100,bt1
2024-02-01,6,900,150.0,4,1200,300,-300,bt1
2024-01-31,5,1000,200.0,6,1000,167,0,bt1
2024-01-30,2,200,100.0,2,200,100,0,bt1
2024-01-29,3,400,133.33,5,500,100,-100,bt1
2024-01-26,1,200,200.0,5,2000,400,-1800,bt1
2024-01-25,3,300,100.0,8,2300,288,-2000,bt1
2024-01-24,2,200,100.0,7,2300,329,-2100,bt1
2024-01-23,1,100,100.0,3,1800,600,-1700,bt1
2024-01-22,1,100,100.0,7,2700,386,-2600,bt1
2024-01-19,2,300,150.0,5,1000,200,-700,bt1
2024-01-18,3,300,100.0,3,300,100,0,bt1
2024-01-17,0,0,0.0,7,2900,414,-2900,bt1
2024-01-16,2,200,100.0,4,2000,500,-1800,bt1
2024-01-15,1,200,200.0,4,400,100,-200,bt1
2024-01-12,2,300,150.0,3,300,100,0,bt1
2024-01-11,2,300,150.0,4,600,150,-300,bt1
2024-01-10,4,400,100.0,4,400,100,0,bt1
2024-01-09,1,100,100.0,3,300,100,-200,bt1
2024-01-08,2,1000,500.0,3,1100,367,-100,bt1
2024-01-05,1,100,100.0,1,100,100,0,bt1
2024-01-04,1,100,100.0,1,100,100,0,bt1
2024-01-03,1,100,100.0,1,100,100,0,bt1
2024-01-02,1,100,100.0,1,100,100,0,bt1
2024-09-12,0,0,0.0,0,0,0,0,bt6
2024-09-11,0,0,0.0,0,0,0,0,bt6
2024-09-10,0,0,0.0,0,0,0,0,bt6
2024-09-09,0,0,0.0,0,0,0,0,bt6
2024-09-06,0,0,0.0,0,0,0,0,bt6
2024-09-05,0,0,0.0,0,0,0,0,bt6
2024-09-04,0,0,0.0,0,0,0,0,bt6
2024-08-30,0,0,0.0,0,0,0,0,bt6
2024-08-29,0,0,0.0,0,0,0,0,bt6
2024-08-28,0,0,0.0,0,0,0,0,bt6
2024-08-27,0,0,0.0,0,0,0,0,bt6
2024-08-26,0,0,0.0,0,0,0,0,bt6
2024-08-23,0,0,0.0,0,0,0,0,bt6
2024-08-22,0,0,0.0,0,0,0,0,bt6
2024-08-21,0,0,0.0,0,0,0,0,bt6
2024-08-20,0,0,0.0,0,0,0,0,bt6
2024-08-19,0,0,0.0,0,0,0,0,bt6
2024-08-16,0,0,0.0,0,0,0,0,bt6
2024-08-15,0,0,0.0,0,0,0,0,bt6
2024-08-14,0,0,0.0,0,0,0,0,bt6
2024-08-13,0,0,0.0,0,0,0,0,bt6
2024-08-12,0,0,0.0,0,0,0,0,bt6
2024-08-09,0,0,0.0,0,0,0,0,bt6
2024-08-08,0,0,0.0,0,0,0,0,bt6
2024-08-07,0,0,0.0,0,0,0,0,bt6
2024-08-06,0,0,0.0,0,0,0,0,bt6
2024-08-05,0,0,0.0,0,0,0,0,bt6
2024-08-02,0,0,0.0,0,0,0,0,bt6
2024-08-01,0,0,0.0,0,0,0,0,bt6
2024-07-31,0,0,0.0,0,0,0,0,bt6
2024-07-30,0,0,0.0,0,0,0,0,bt6
2024-07-29,0,0,0.0,0,0,0,0,bt6
2024-07-26,0,0,0.0,0,0,0,0,bt6
2024-07-25,0,0,0.0,0,0,0,0,bt6
2024-07-24,0,0,0.0,0,0,0,0,bt6
2024-07-23,0,0,0.0,0,0,0,0,bt6
2024-07-22,0,0,0.0,0,0,0,0,bt6
2024-07-19,0,0,0.0,0,0,0,0,bt6
2024-07-18,0,0,0.0,0,0,0,0,bt6
2024-07-17,0,0,0.0,0,0,0,0,bt6
2024-07-16,0,0,0.0,0,0,0,0,bt6
2024-07-15,0,0,0.0,0,0,0,0,bt6
2024-07-12,0,0,0.0,0,0,0,0,bt6
2024-07-11,0,0,0.0,0,0,0,0,bt6
2024-07-10,0,0,0.0,0,0,0,0,bt6
2024-07-09,0,0,0.0,0,0,0,0,bt6
2024-07-08,0,0,0.0,0,0,0,0,bt6
2024-07-05,0,0,0.0,0,0,0,0,bt6
2024-07-04,0,0,0.0,0,0,0,0,bt6
2024-07-03,0,0,0.0,0,0,0,0,bt6
2024-07-02,0,0,0.0,0,0,0,0,bt6
2024-07-01,0,0,0.0,0,0,0,0,bt6
2024-06-28,0,0,0.0,0,0,0,0,bt6
2024-06-27,0,0,0.0,0,0,0,0,bt6
2024-06-26,0,0,0.0,0,0,0,0,bt6
2024-06-25,0,0,0.0,0,0,0,0,bt6
2024-06-24,0,0,0.0,0,0,0,0,bt6
2024-06-21,0,0,0.0,0,0,0,0,bt6
2024-06-20,0,0,0.0,0,0,0,0,bt6
2024-06-19,0,0,0.0,0,0,0,0,bt6
2024-06-18,0,0,0.0,0,0,0,0,bt6
2024-06-17,0,0,0.0,0,0,0,0,bt6
2024-06-14,0,0,0.0,0,0,0,0,bt6
2024-06-13,0,0,0.0,0,0,0,0,bt6
2024-06-12,0,0,0.0,0,0,0,0,bt6
2024-06-11,0,0,0.0,0,0,0,0,bt6
2024-06-10,0,0,0.0,0,0,0,0,bt6
2024-06-07,0,0,0.0,0,0,0,0,bt6
2024-06-06,0,0,0.0,0,0,0,0,bt6
2024-06-05,0,0,0.0,0,0,0,0,bt6
2024-06-04,0,0,0.0,0,0,0,0,bt6
2024-06-03,0,0,0.0,0,0,0,0,bt6
2024-05-31,0,0,0.0,0,0,0,0,bt6
2024-05-30,0,0,0.0,0,0,0,0,bt6
2024-05-29,0,0,0.0,0,0,0,0,bt6
2024-05-28,0,0,0.0,0,0,0,0,bt6
2024-05-27,0,0,0.0,0,0,0,0,bt6
2024-05-24,0,0,0.0,0,0,0,0,bt6
2024-05-23,0,0,0.0,0,0,0,0,bt6
2024-05-22,0,0,0.0,0,0,0,0,bt6
2024-05-21,0,0,0.0,0,0,0,0,bt6
2024-05-20,0,0,0.0,0,0,0,0,bt6
2024-05-17,0,0,0.0,0,0,0,0,bt6
2024-05-16,0,0,0.0,0,0,0,0,bt6
2024-05-15,0,0,0.0,0,0,0,0,bt6
2024-05-14,0,0,0.0,0,0,0,0,bt6
2024-05-13,0,0,0.0,0,0,0,0,bt6
2024-05-10,0,0,0.0,0,0,0,0,bt6
2024-05-09,0,0,0.0,0,0,0,0,bt6
2024-05-08,0,0,0.0,0,0,0,0,bt6
2024-05-07,0,0,0.0,0,0,0,0,bt6
2024-05-06,0,0,0.0,0,0,0,0,bt6
2024-05-03,0,0,0.0,0,0,0,0,bt6
2024-05-02,0,0,0.0,0,0,0,0,bt6
2024-04-26,0,0,0.0,0,0,0,0,bt6
2024-04-25,0,0,0.0,0,0,0,0,bt6
2024-04-24,0,0,0.0,0,0,0,0,bt6
2024-04-23,0,0,0.0,0,0,0,0,bt6
2024-04-22,0,0,0.0,0,0,0,0,bt6
2024-04-19,0,0,0.0,0,0,0,0,bt6
2024-04-17,0,0,0.0,0,0,0,0,bt6
2024-04-16,0,0,0.0,0,0,0,0,bt6
2024-04-15,0,0,0.0,0,0,0,0,bt6
2024-04-12,0,0,0.0,0,0,0,0,bt6
2024-04-11,0,0,0.0,0,0,0,0,bt6
2024-04-10,0,0,0.0,0,0,0,0,bt6
2024-04-09,0,0,0.0,0,0,0,0,bt6
2024-04-08,0,0,0.0,0,0,0,0,bt6
2024-04-05,0,0,0.0,0,0,0,0,bt6
2024-04-04,0,0,0.0,0,0,0,0,bt6
2024-04-03,0,0,0.0,0,0,0,0,bt6
2024-04-02,0,0,0.0,0,0,0,0,bt6
2024-04-01,0,0,0.0,0,0,0,0,bt6
2024-03-29,0,0,0.0,0,0,0,0,bt6
2024-03-28,0,0,0.0,0,0,0,0,bt6
2024-03-27,0,0,0.0,0,0,0,0,bt6
2024-03-26,0,0,0.0,0,0,0,0,bt6
2024-03-25,0,0,0.0,0,0,0,0,bt6
2024-03-22,0,0,0.0,0,0,0,0,bt6
2024-03-21,0,0,0.0,0,0,0,0,bt6
2024-03-20,0,0,0.0,0,0,0,0,bt6
2024-03-19,0,0,0.0,0,0,0,0,bt6
2024-03-18,0,0,0.0,0,0,0,0,bt6
2024-03-15,0,0,0.0,0,0,0,0,bt6
2024-03-14,0,0,0.0,0,0,0,0,bt6
2024-03-13,0,0,0.0,0,0,0,0,bt6
2024-03-12,0,0,0.0,0,0,0,0,bt6
2024-03-11,0,0,0.0,0,0,0,0,bt6
2024-03-08,0,0,0.0,0,0,0,0,bt6
2024-03-07,0,0,0.0,0,0,0,0,bt6
2024-03-06,0,0,0.0,0,0,0,0,bt6
2024-03-05,0,0,0.0,0,0,0,0,bt6
2024-03-04,0,0,0.0,0,0,0,0,bt6
2024-03-01,0,0,0.0,0,0,0,0,bt6
2024-02-29,0,0,0.0,0,0,0,0,bt6
2024-02-28,0,0,0.0,0,0,0,0,bt6
2024-02-27,0,0,0.0,0,0,0,0,bt6
2024-02-26,0,0,0.0,0,0,0,0,bt6
2024-02-23,0,0,0.0,0,0,0,0,bt6
2024-02-22,0,0,0.0,0,0,0,0,bt6
2024-02-21,0,0,0.0,0,0,0,0,bt6
2024-02-20,0,0,0.0,0,0,0,0,bt6
2024-02-19,0,0,0.0,0,0,0,0,bt6
2024-02-16,0,0,0.0,0,0,0,0,bt6
2024-02-15,0,0,0.0,0,0,0,0,bt6
2024-02-07,0,0,0.0,0,0,0,0,bt6
2024-02-06,0,0,0.0,0,0,0,0,bt6
2024-02-05,0,0,0.0,0,0,0,0,bt6
2024-02-02,0,0,0.0,0,0,0,0,bt6
2024-02-01,0,0,0.0,0,0,0,0,bt6
2024-01-31,0,0,0.0,0,0,0,0,bt6
2024-01-30,0,0,0.0,0,0,0,0,bt6
2024-01-29,0,0,0.0,0,0,0,0,bt6
2024-01-26,0,0,0.0,0,0,0,0,bt6
2024-01-25,0,0,0.0,0,0,0,0,bt6
2024-01-24,0,0,0.0,0,0,0,0,bt6
2024-01-23,0,0,0.0,0,0,0,0,bt6
2024-01-22,0,0,0.0,0,0,0,0,bt6
2024-01-19,0,0,0.0,0,0,0,0,bt6
2024-01-18,0,0,0.0,0,0,0,0,bt6
2024-01-17,0,0,0.0,0,0,0,0,bt6
2024-01-16,0,0,0.0,0,0,0,0,bt6
2024-01-15,0,0,0.0,0,0,0,0,bt6
2024-01-12,0,0,0.0,0,0,0,0,bt6
2024-01-11,0,0,0.0,0,0,0,0,bt6
2024-01-10,0,0,0.0,0,0,0,0,bt6
2024-01-09,0,0,0.0,0,0,0,0,bt6
2024-01-08,0,0,0.0,0,0,0,0,bt6
2024-01-05,0,0,0.0,0,0,0,0,bt6
2024-01-04,0,0,0.0,0,0,0,0,bt6
2024-01-03,0,0,0.0,0,0,0,0,bt6
2024-01-02,0,0,0.0,0,0,0,0,bt6
2024-09-12,1,100,100.0,3,5100,1700,-5000,btb
2024-09-11,1,100,100.0,3,7000,2333,-6900,btb
2024-09-10,1,100,100.0,3,5200,1733,-5100,btb
2024-09-09,1,100,100.0,3,7100,2367,-7000,btb
2024-09-06,2,200,100.0,3,7100,2367,-6900,btb
2024-09-05,3,200,66.67,4,7200,1800,-7000,btb
2024-09-04,4,600,150.0,3,7100,2367,-6500,btb
2024-08-30,2,200,100.0,3,6100,2033,-5900,btb
2024-08-29,3,300,100.0,5,6500,1300,-6200,btb
2024-08-28,4,700,175.0,6,6700,1117,-6000,btb
2024-08-27,3,500,166.67,6,5600,933,-5100,btb
2024-08-26,2,200,100.0,5,7600,1520,-7400,btb
2024-08-23,2,200,100.0,6,5600,933,-5400,btb
2024-08-22,2,200,100.0,6,7600,1267,-7400,btb
2024-08-21,3,300,100.0,8,7200,900,-6900,btb
2024-08-20,1,100,100.0,8,8400,1050,-8300,btb
2024-08-19,2,200,100.0,7,9100,1300,-8900,btb
2024-08-16,1,100,100.0,7,25200,3600,-25100,btb
2024-08-15,1,100,100.0,7,6700,957,-6600,btb
2024-08-14,1,100,100.0,8,8200,1025,-8100,btb
2024-08-13,2,200,100.0,6,8600,1433,-8400,btb
2024-08-12,1,100,100.0,7,6300,900,-6200,btb
2024-08-09,1,100,100.0,6,6700,1117,-6600,btb
2024-08-08,0,0,0.0,6,8700,1450,-8700,btb
2024-08-07,3,500,166.67,4,6100,1525,-5600,btb
2024-08-06,1,100,100.0,3,7300,2433,-7200,btb
2024-08-05,3,400,133.33,5,5900,1180,-5500,btb
2024-08-02,4,500,125.0,11,8100,736,-7600,btb
2024-08-01,1,0,0.0,10,8700,870,-8700,btb
2024-07-31,1,100,100.0,9,8300,922,-8200,btb
2024-07-30,2,200,100.0,10,8600,860,-8400,btb
2024-07-29,1,100,100.0,7,6700,957,-6600,btb
2024-07-26,4,500,125.0,8,5900,738,-5400,btb
2024-07-25,3,400,133.33,7,9000,1286,-8600,btb
2024-07-24,3,500,166.67,12,11000,917,-10500,btb
2024-07-23,5,900,180.0,2,1400,700,-500,btb
2024-07-22,4,1600,400.0,2,1400,700,200,btb
2024-07-19,3,800,266.67,3,3400,1133,-2600,btb
2024-07-18,4,900,225.0,2,6000,3000,-5100,btb
2024-07-17,5,1000,200.0,2,1400,700,-400,btb
2024-07-16,6,1600,266.67,4,6500,1625,-4900,btb
2024-07-15,3,300,100.0,4,6700,1675,-6400,btb
2024-07-12,6,1900,316.67,7,11400,1629,-9500,btb
2024-07-11,3,300,100.0,2,2100,1050,-1800,btb
2024-07-10,9,2900,322.22,1,1000,1000,1900,btb
2024-07-09,2,400,200.0,7,4100,586,-3700,btb
2024-07-08,8,2400,300.0,6,6200,1033,-3800,btb
2024-07-05,4,3100,775.0,3,3900,1300,-800,btb
2024-07-04,3,3200,1066.67,3,1600,533,1600,btb
2024-07-03,5,8400,1680.0,4,3400,850,5000,btb
2024-07-02,4,8700,2175.0,2,500,250,8200,btb
2024-07-01,9,52000,5777.78,2,8000,4000,44000,btb
2024-06-28,5,800,160.0,6,5200,867,-4400,btb
2024-06-27,2,200,100.0,7,4500,643,-4300,btb
2024-06-26,4,500,125.0,5,4500,900,-4000,btb
2024-06-25,6,1800,300.0,8,8000,1000,-6200,btb
2024-06-24,2,900,450.0,10,10300,1030,-9400,btb
2024-06-21,1,800,800.0,10,8800,880,-8000,btb
2024-06-20,3,200,66.67,6,6400,1067,-6200,btb
2024-06-19,2,800,400.0,3,2100,700,-1300,btb
2024-06-18,3,1700,566.67,5,7100,1420,-5400,btb
2024-06-17,6,1900,316.67,6,3500,583,-1600,btb
2024-06-14,2,800,400.0,3,19000,6333,-18200,btb
2024-06-13,2,800,400.0,6,3400,567,-2600,btb
2024-06-12,1,700,700.0,3,19000,6333,-18300,btb
2024-06-11,1,700,700.0,2,1500,750,-800,btb
2024-06-10,2,100,50.0,5,6900,1380,-6800,btb
2024-06-07,2,800,400.0,2,1500,750,-700,btb
2024-06-06,1,700,700.0,3,1900,633,-1200,btb
2024-06-05,2,800,400.0,5,3400,680,-2600,btb
2024-06-04,1,100,100.0,6,6900,1150,-6800,btb
2024-06-03,2,800,400.0,7,4800,686,-4000,btb
2024-05-31,1,100,100.0,6,8600,1433,-8500,btb
2024-05-30,1,100,100.0,7,5400,771,-5300,btb
2024-05-29,3,1800,600.0,9,10000,1111,-8200,btb
2024-05-28,5,1300,260.0,5,7400,1480,-6100,btb
2024-05-27,1,700,700.0,7,8900,1271,-8200,btb
2024-05-24,3,900,300.0,4,2800,700,-1900,btb
2024-05-23,2,100,50.0,5,5200,1040,-5100,btb
2024-05-22,9,1200,133.33,4,12400,3100,-11200,btb
2024-05-21,3,500,166.67,9,8700,967,-8200,btb
2024-05-20,1,500,500.0,9,7500,833,-7000,btb
2024-05-17,0,0,0.0,8,8500,1062,-8500,btb
2024-05-16,4,2200,550.0,6,5100,850,-2900,btb
2024-05-15,5,2300,460.0,4,3500,875,-1200,btb
2024-05-14,8,64000,8000.0,1,2000,2000,62000,btb
2024-05-13,6,8800,1466.67,0,0,0,8800,btb
2024-05-10,1,3000,3000.0,0,0,0,3000,btb
2024-05-09,5,2200,440.0,0,0,0,2200,btb
2024-05-08,8,8300,1037.5,2,4500,2250,3800,btb
2024-05-07,4,2200,550.0,1,3600,3600,-1400,btb
2024-05-06,6,2400,400.0,3,3700,1233,-1300,btb
2024-05-03,3,3100,1033.33,3,2700,900,400,btb
2024-05-02,3,2200,733.33,2,4800,2400,-2600,btb
2024-04-26,8,8800,1100.0,7,12400,1771,-3600,btb
2024-04-25,4,3000,750.0,6,8600,1433,-5600,btb
2024-04-24,2,2100,1050.0,4,2500,625,-400,btb
2024-04-23,7,2400,342.86,1,2000,2000,400,btb
2024-04-22,5,8100,1620.0,7,16600,2371,-8500,btb
2024-04-19,2,100,50.0,6,6800,1133,-6700,btb
2024-04-17,1,100,100.0,3,10400,3467,-10300,btb
2024-04-16,4,1600,400.0,3,2100,700,-500,btb
2024-04-15,2,600,300.0,5,10000,2000,-9400,btb
2024-04-12,5,1500,300.0,6,17400,2900,-15900,btb
2024-04-11,1,200,200.0,5,11100,2220,-10900,btb
2024-04-10,3,1700,566.67,8,29900,3738,-28200,btb
2024-04-09,1,300,300.0,4,9900,2475,-9600,btb
2024-04-08,3,900,300.0,5,10800,2160,-9900,btb
2024-04-05,2,1800,900.0,8,15300,1912,-13500,btb
2024-04-04,0,0,0.0,8,12800,1600,-12800,btb
2024-04-03,0,0,0.0,10,18000,1800,-18000,btb
2024-04-02,0,0,0.0,13,23700,1823,-23700,btb
2024-04-01,6,1200,200.0,8,14200,1775,-13000,btb
2024-03-29,3,1600,533.33,0,0,0,1600,btb
2024-03-28,5,900,180.0,3,200,67,700,btb
2024-03-27,3,200,66.67,5,3400,680,-3200,btb
2024-03-26,2,100,50.0,2,1000,500,-900,btb
2024-03-25,2,100,50.0,1,100,100,0,btb
2024-03-22,4,800,200.0,1,3400,3400,-2600,btb
2024-03-21,4,900,225.0,3,8500,2833,-7600,btb
2024-03-20,4,1000,250.0,3,9900,3300,-8900,btb
2024-03-19,4,700,175.0,2,8400,4200,-7700,btb
2024-03-18,3,100,33.33,2,4900,2450,-4800,btb
2024-03-15,4,100,25.0,4,18300,4575,-18200,btb
2024-03-14,6,1500,250.0,9,18100,2011,-16600,btb
2024-03-13,4,1400,350.0,10,13700,1370,-12300,btb
2024-03-12,4,2900,725.0,3,10400,3467,-7500,btb
2024-03-11,3,17600,5866.67,14,35500,2536,-17900,btb
2024-03-08,2,2100,1050.0,7,9600,1371,-7500,btb
2024-03-07,2,3600,1800.0,9,16600,1844,-13000,btb
2024-03-06,4,4400,1100.0,10,16700,1670,-12300,btb
2024-03-05,3,2200,733.33,9,16600,1844,-14400,btb
2024-03-04,8,24600,3075.0,3,10000,3333,14600,btb
2024-03-01,4,3400,850.0,0,0,0,3400,btb
2024-02-29,7,1800,257.14,4,7200,1800,-5400,btb
2024-02-28,5,3700,740.0,1,100,100,3600,btb
2024-02-27,6,1800,300.0,1,4700,4700,-2900,btb
2024-02-26,6,1800,300.0,1,200,200,1600,btb
2024-02-23,5,1700,340.0,2,4300,2150,-2600,btb
2024-02-22,5,1700,340.0,1,3500,3500,-1800,btb
2024-02-21,5,1700,340.0,2,13200,6600,-11500,btb
2024-02-20,6,1800,300.0,1,3500,3500,-1700,btb
2024-02-19,5,1700,340.0,2,4100,2050,-2400,btb
2024-02-16,4,1200,300.0,2,3600,1800,-2400,btb
2024-02-15,6,3300,550.0,4,10400,2600,-7100,btb
2024-02-07,6,2300,383.33,1,400,400,1900,btb
2024-02-06,5,5100,1020.0,2,4500,2250,600,btb
2024-02-05,6,1600,266.67,1,1000,1000,600,btb
2024-02-02,4,400,100.0,1,0,0,400,btb
2024-02-01,4,1400,350.0,2,1100,550,300,btb
2024-01-31,5,4400,880.0,3,10700,3567,-6300,btb
2024-01-30,4,1200,300.0,11,29400,2673,-28200,btb
2024-01-29,5,3900,780.0,10,24700,2470,-20800,btb
2024-01-26,2,600,300.0,4,5200,1300,-4600,btb
2024-01-25,3,1000,333.33,2,1100,550,-100,btb
2024-01-24,5,3400,680.0,3,1100,367,2300,btb
2024-01-23,3,1100,366.67,2,1100,550,0,btb
2024-01-22,1,100,100.0,3,10800,3600,-10700,btb
2024-01-19,2,2100,1050.0,3,1700,567,400,btb
2024-01-18,1,100,100.0,5,11400,2280,-11300,btb
2024-01-17,2,2100,1050.0,2,1100,550,1000,btb
2024-01-16,1,100,100.0,3,1700,567,-1600,btb
2024-01-15,2,1200,600.0,2,1100,550,100,btb
2024-01-12,3,2600,866.67,9,8500,944,-5900,btb
2024-01-11,3,2500,833.33,9,16000,1778,-13500,btb
2024-01-10,9,4100,455.56,1,100,100,4000,btb
2024-01-09,5,1600,320.0,10,11700,1170,-10100,btb
2024-01-08,7,10300,1471.43,8,14900,1862,-4600,btb
2024-01-05,5,5600,1120.0,2,2100,1050,3500,btb
2024-01-04,4,2100,525.0,3,11200,3733,-9100,btb
2024-01-03,4,1800,450.0,4,5000,1250,-3200,btb
2024-01-02,9,3100,344.44,2,3600,1800,-500,btb
2024-09-12,1,100,100.0,4,1000,250,-900,btd
2024-09-11,2,200,100.0,5,1400,280,-1200,btd
2024-09-10,2,200,100.0,5,2100,420,-1900,btd
2024-09-09,3,2200,733.33,5,3100,620,-900,btd
2024-09-06,2,200,100.0,7,2600,371,-2400,btd
2024-09-05,2,200,100.0,5,2100,420,-1900,btd
2024-09-04,3,400,133.33,4,1100,275,-700,btd
2024-08-30,4,500,125.0,6,1500,250,-1000,btd
2024-08-29,2,300,150.0,3,900,300,-600,btd
2024-08-28,2,200,100.0,6,2700,450,-2500,btd
2024-08-27,2,200,100.0,5,2900,580,-2700,btd
2024-08-26,5,600,120.0,8,2500,312,-1900,btd
2024-08-23,4,500,125.0,4,1300,325,-800,btd
2024-08-22,5,500,100.0,5,1400,280,-900,btd
2024-08-21,6,2100,350.0,6,2500,417,-400,btd
2024-08-20,5,3400,680.0,5,3300,660,100,btd
2024-08-19,2,200,100.0,4,2200,550,-2000,btd
2024-08-16,2,200,100.0,7,2700,386,-2500,btd
2024-08-15,2,200,100.0,8,2700,338,-2500,btd
2024-08-14,3,300,100.0,10,3700,370,-3400,btd
2024-08-13,2,200,100.0,5,1400,280,-1200,btd
2024-08-12,4,400,100.0,9,2600,289,-2200,btd
2024-08-09,4,400,100.0,10,4500,450,-4100,btd
2024-08-08,5,900,180.0,9,1800,200,-900,btd
2024-08-07,6,1600,266.67,4,1900,475,-300,btd
2024-08-06,9,2000,222.22,12,2100,175,-100,btd
2024-08-05,3,800,266.67,11,2700,245,-1900,btd
2024-08-02,1,100,100.0,6,1300,217,-1200,btd
2024-08-01,2,200,100.0,7,2000,286,-1800,btd
2024-07-31,7,900,128.57,11,3100,282,-2200,btd
2024-07-30,3,300,100.0,7,3900,557,-3600,btd
2024-07-29,1,100,100.0,7,1900,271,-1800,btd
2024-07-26,5,500,100.0,11,3900,355,-3400,btd
2024-07-25,3,700,233.33,4,4700,1175,-4000,btd
2024-07-24,2,200,100.0,7,5200,743,-5000,btd
2024-07-23,5,1400,280.0,6,4300,717,-2900,btd
2024-07-22,5,600,120.0,9,7200,800,-6600,btd
2024-07-19,2,1100,550.0,11,9100,827,-8000,btd
2024-07-18,2,1100,550.0,11,12000,1091,-10900,btd
2024-07-17,9,1400,155.56,17,9400,553,-8000,btd
2024-07-16,9,3900,433.33,7,4900,700,-1000,btd
2024-07-15,11,3600,327.27,6,1800,300,1800,btd
2024-07-12,5,1400,280.0,6,5200,867,-3800,btd
2024-07-11,5,1700,340.0,8,5800,725,-4100,btd
2024-07-10,9,1300,144.44,9,5600,622,-4300,btd
2024-07-09,8,2200,275.0,7,5800,829,-3600,btd
2024-07-08,6,1200,200.0,5,1400,280,-200,btd
2024-07-05,4,800,200.0,7,1800,257,-1000,btd
2024-07-04,9,3100,344.44,11,2800,255,300,btd
2024-07-03,3,700,233.33,6,1500,250,-800,btd
2024-07-02,3,800,266.67,10,2400,240,-1600,btd
2024-07-01,6,3300,550.0,4,500,125,2800,btd
2024-06-28,14,3400,242.86,11,1800,164,1600,btd
2024-06-27,4,1300,325.0,6,3000,500,-1700,btd
2024-06-26,10,3000,300.0,10,4500,450,-1500,btd
2024-06-25,11,900,81.82,6,1600,267,-700,btd
2024-06-24,15,10000,666.67,4,900,225,9100,btd
2024-06-21,14,11200,800.0,9,1800,200,9400,btd
2024-06-20,3,800,266.67,10,2000,200,-1200,btd
2024-06-19,5,10800,2160.0,8,1800,225,9000,btd
2024-06-18,3,600,200.0,10,6400,640,-5800,btd
2024-06-17,5,1200,240.0,5,1100,220,100,btd
2024-06-14,7,1000,142.86,9,2600,289,-1600,btd
2024-06-13,7,7200,1028.57,7,2300,329,4900,btd
2024-06-12,5,1300,260.0,10,3200,320,-1900,btd
2024-06-11,9,2100,233.33,12,3000,250,-900,btd
2024-06-10,4,900,225.0,8,3800,475,-2900,btd
2024-06-07,4,1300,325.0,6,7100,1183,-5800,btd
2024-06-06,6,1300,216.67,6,5800,967,-4500,btd
2024-06-05,2,600,300.0,4,600,150,0,btd
2024-06-04,4,1300,325.0,5,7000,1400,-5700,btd
2024-06-03,3,700,233.33,7,7600,1086,-6900,btd
2024-05-31,4,800,200.0,7,7900,1129,-7100,btd
2024-05-30,4,700,175.0,7,7800,1114,-7100,btd
2024-05-29,4,800,200.0,4,7700,1925,-6900,btd
2024-05-28,9,2100,233.33,4,1700,425,400,btd
2024-05-27,6,1200,200.0,5,6300,1260,-5100,btd
2024-05-24,5,900,180.0,8,1400,175,-500,btd
2024-05-23,4,700,175.0,3,5000,1667,-4300,btd
2024-05-22,5,1400,280.0,3,900,300,500,btd
2024-05-21,3,800,266.67,5,6700,1340,-5900,btd
2024-05-20,4,700,175.0,7,7200,1029,-6500,btd
2024-05-17,8,1100,137.5,4,1000,250,100,btd
2024-05-16,4,800,200.0,4,1400,350,-600,btd
2024-05-15,11,2000,181.82,6,5600,933,-3600,btd
2024-05-14,8,1900,237.5,5,5300,1060,-3400,btd
2024-05-13,4,1400,350.0,6,6700,1117,-5300,btd
2024-05-10,4,800,200.0,6,7500,1250,-6700,btd
2024-05-09,8,2200,275.0,5,2600,520,-400,btd
2024-05-08,8,2600,325.0,7,7700,1100,-5100,btd
2024-05-07,11,7100,645.45,10,11700,1170,-4600,btd
2024-05-06,10,3100,310.0,9,10800,1200,-7700,btd
2024-05-03,7,2900,414.29,12,9900,825,-7000,btd
2024-05-02,4,500,125.0,11,9800,891,-9300,btd
2024-04-26,10,5400,540.0,13,16000,1231,-10600,btd
2024-04-25,24,16800,700.0,13,12200,938,4600,btd
2024-04-24,4,1400,350.0,11,5300,482,-3900,btd
2024-04-23,2,100,50.0,10,5100,510,-5000,btd
2024-04-22,5,1700,340.0,8,6300,788,-4600,btd
2024-04-19,1,200,200.0,11,3400,309,-3200,btd
2024-04-17,2,200,100.0,7,2500,357,-2300,btd
2024-04-16,1,100,100.0,15,3700,247,-3600,btd
2024-04-15,4,1200,300.0,10,4600,460,-3400,btd
2024-04-12,6,1300,216.67,10,3300,330,-2000,btd
2024-04-11,10,5200,520.0,12,4000,333,1200,btd
2024-04-10,6,2700,450.0,7,3800,543,-1100,btd
2024-04-09,6,1700,283.33,7,4300,614,-2600,btd
2024-04-08,3,300,100.0,8,2000,250,-1700,btd
2024-04-05,17,2500,147.06,14,5600,400,-3100,btd
2024-04-04,3,400,133.33,8,3100,388,-2700,btd
2024-04-03,3,300,100.0,6,4100,683,-3800,btd
2024-04-02,8,1200,150.0,5,2700,540,-1500,btd
2024-04-01,4,600,150.0,6,3100,517,-2500,btd
2024-03-29,5,1300,260.0,5,2600,520,-1300,btd
2024-03-28,7,1600,228.57,7,3500,500,-1900,btd
2024-03-27,7,2400,342.86,5,1500,300,900,btd
2024-03-26,10,1800,180.0,11,2200,200,-400,btd
2024-03-25,4,900,225.0,5,1200,240,-300,btd
2024-03-22,8,2900,362.5,16,6800,425,-3900,btd
2024-03-21,6,1700,283.33,15,3600,240,-1900,btd
2024-03-20,6,2400,400.0,9,2100,233,300,btd
2024-03-19,6,1400,233.33,6,1600,267,-200,btd
2024-03-18,5,1300,260.0,7,1300,186,0,btd
2024-03-15,7,2600,371.43,6,1700,283,900,btd
2024-03-14,14,3700,264.29,9,2800,311,900,btd
2024-03-13,11,3700,336.36,10,1800,180,1900,btd
2024-03-12,15,6800,453.33,12,4000,333,2800,btd
2024-03-11,4,1500,375.0,11,4200,382,-2700,btd
2024-03-08,10,3400,340.0,13,4600,354,-1200,btd
2024-03-07,6,4100,683.33,10,4100,410,0,btd
2024-03-06,17,10100,594.12,8,10500,1312,-400,btd
2024-03-05,14,9300,664.29,4,14300,3575,-5000,btd
2024-03-04,11,5300,481.82,14,19200,1371,-13900,btd
2024-03-01,5,3000,600.0,15,11100,740,-8100,btd
2024-02-29,4,900,225.0,8,5700,712,-4800,btd
2024-02-28,3,700,233.33,10,8000,800,-7300,btd
2024-02-27,5,600,120.0,3,1800,600,-1200,btd
2024-02-26,6,800,133.33,6,13700,2283,-12900,btd
2024-02-23,6,1900,316.67,3,900,300,1000,btd
2024-02-22,5,900,180.0,4,1900,475,-1000,btd
2024-02-21,6,5300,883.33,5,13300,2660,-8000,btd
2024-02-20,8,3600,450.0,8,16500,2062,-12900,btd
2024-02-19,9,3400,377.78,10,5400,540,-2000,btd
2024-02-16,5,2600,520.0,7,3800,543,-1200,btd
2024-02-15,2,1000,500.0,6,3200,533,-2200,btd
2024-02-07,3,700,233.33,7,4200,600,-3500,btd
2024-02-06,5,1200,240.0,6,3400,567,-2200,btd
2024-02-05,5,2600,520.0,6,3400,567,-800,btd
2024-02-02,4,3100,775.0,7,4700,671,-1600,btd
2024-02-01,4,1800,450.0,5,15600,3120,-13800,btd
2024-01-31,8,7000,875.0,8,18400,2300,-11400,btd
2024-01-30,6,2700,450.0,4,16600,4150,-13900,btd
2024-01-29,6,6500,1083.33,6,21700,3617,-15200,btd
2024-01-26,3,1200,400.0,5,4700,940,-3500,btd
2024-01-25,4,1700,425.0,6,4600,767,-2900,btd
2024-01-24,1,200,200.0,6,4200,700,-4000,btd
2024-01-23,3,800,266.67,3,3700,1233,-2900,btd
2024-01-22,7,1000,142.86,7,6300,900,-5300,btd
2024-01-19,3,800,266.67,4,4700,1175,-3900,btd
2024-01-18,1,200,200.0,4,3800,950,-3600,btd
2024-01-17,3,800,266.67,5,4000,800,-3200,btd
2024-01-16,8,2200,275.0,8,5900,738,-3700,btd
2024-01-15,3,800,266.67,4,800,200,0,btd
2024-01-12,4,2000,500.0,5,1400,280,600,btd
2024-01-11,6,2100,350.0,4,1800,450,300,btd
2024-01-10,2,200,100.0,4,4000,1000,-3800,btd
2024-01-09,2,300,150.0,6,2400,400,-2100,btd
2024-01-08,4,1400,350.0,4,3800,950,-2400,btd
2024-01-05,7,2500,357.14,7,1400,200,1100,btd
2024-01-04,4,1500,375.0,5,2000,400,-500,btd
2024-01-03,5,1900,380.0,3,700,233,1200,btd
2024-01-02,3,1400,466.67,2,600,300,800,btd
2024-09-12,3,1100,366.67,3,3400,1133,-2300,btg
2024-09-11,4,5500,1375.0,3,7200,2400,-1700,btg
2024-09-10,6,4200,700.0,1,1000,1000,3200,btg
2024-09-09,7,4100,585.71,3,3500,1167,600,btg
2024-09-06,5,1600,320.0,3,7200,2400,-5600,btg
2024-09-05,6,2200,366.67,5,9000,1800,-6800,btg
2024-09-04,9,8900,988.89,4,6700,1675,2200,btg
2024-08-30,9,5800,644.44,5,3200,640,2600,btg
2024-08-29,12,14500,1208.33,5,7600,1520,6900,btg
2024-08-28,5,1800,360.0,3,2200,733,-400,btg
2024-08-27,3,400,133.33,1,500,500,-100,btg
2024-08-26,6,800,133.33,1,300,300,500,btg
2024-08-23,11,11400,1036.36,1,200,200,11200,btg
2024-08-22,10,1600,160.0,1,200,200,1400,btg
2024-08-21,7,2300,328.57,1,500,500,1800,btg
2024-08-20,1,1000,1000.0,2,2500,1250,-1500,btg
2024-08-19,0,0,0.0,0,0,0,0,btg
2024-08-16,0,0,0.0,0,0,0,0,btg
2024-08-15,0,0,0.0,0,0,0,0,btg
2024-08-14,0,0,0.0,0,0,0,0,btg
2024-08-13,0,0,0.0,0,0,0,0,btg
2024-08-12,0,0,0.0,0,0,0,0,btg
2024-08-09,1,100,100.0,0,0,0,100,btg
2024-08-08,3,0,0.0,0,0,0,0,btg
2024-08-07,0,0,0.0,0,0,0,0,btg
2024-08-06,0,0,0.0,0,0,0,0,btg
2024-08-05,0,0,0.0,0,0,0,0,btg
2024-08-02,0,0,0.0,0,0,0,0,btg
2024-08-01,1,0,0.0,0,0,0,0,btg
2024-07-31,0,0,0.0,0,0,0,0,btg
2024-07-30,0,0,0.0,0,0,0,0,btg
2024-07-29,1,0,0.0,0,0,0,0,btg
2024-07-26,0,0,0.0,0,0,0,0,btg
2024-07-25,1,100,100.0,0,0,0,100,btg
2024-07-24,1,100,100.0,0,0,0,100,btg
2024-07-23,2,200,100.0,0,0,0,200,btg
2024-07-22,1,1000,1000.0,0,0,0,1000,btg
2024-07-19,1,100,100.0,0,0,0,100,btg
2024-07-18,2,200,100.0,0,0,0,200,btg
2024-07-17,2,100,50.0,0,0,0,100,btg
2024-07-16,2,200,100.0,0,0,0,200,btg
2024-07-15,2,200,100.0,0,0,0,200,btg
2024-07-12,2,600,300.0,0,0,0,600,btg
2024-07-11,5,900,180.0,0,0,0,900,btg
2024-07-10,1,100,100.0,0,0,0,100,btg
2024-07-09,1,100,100.0,0,0,0,100,btg
2024-07-08,1,100,100.0,0,0,0,100,btg
2024-07-05,3,200,66.67,0,0,0,200,btg
2024-07-04,5,300,60.0,0,0,0,300,btg
2024-07-03,2,200,100.0,0,0,0,200,btg
2024-07-02,2,300,150.0,0,0,0,300,btg
2024-07-01,0,0,0.0,0,0,0,0,btg
2024-06-28,1,1400,1400.0,0,0,0,1400,btg
2024-06-27,1,500,500.0,1,500,500,0,btg
2024-06-26,0,0,0.0,0,0,0,0,btg
2024-06-25,1,0,0.0,1,500,500,-500,btg
2024-06-24,0,0,0.0,1,200,200,-200,btg
2024-06-21,2,100,50.0,0,0,0,100,btg
2024-06-20,1,4000,4000.0,2,9500,4750,-5500,btg
2024-06-19,0,0,0.0,0,0,0,0,btg
2024-06-18,0,0,0.0,1,5100,5100,-5100,btg
2024-06-17,0,0,0.0,1,5500,5500,-5500,btg
2024-06-14,0,0,0.0,1,100,100,-100,btg
2024-06-13,1,5000,5000.0,2,5100,2550,-100,btg
2024-06-12,0,0,0.0,0,0,0,0,btg
2024-06-11,0,0,0.0,0,0,0,0,btg
2024-06-10,0,0,0.0,1,5800,5800,-5800,btg
2024-06-07,0,0,0.0,0,0,0,0,btg
2024-06-06,0,0,0.0,0,0,0,0,btg
2024-06-05,0,0,0.0,0,0,0,0,btg
2024-06-04,0,0,0.0,1,5100,5100,-5100,btg
2024-06-03,0,0,0.0,1,5900,5900,-5900,btg
2024-05-31,0,0,0.0,1,5800,5800,-5800,btg
2024-05-30,0,0,0.0,0,0,0,0,btg
2024-05-29,0,0,0.0,1,5600,5600,-5600,btg
2024-05-28,2,10000,5000.0,1,5200,5200,4800,btg
2024-05-27,1,6000,6000.0,1,5700,5700,300,btg
2024-05-24,1,5000,5000.0,1,5000,5000,0,btg
2024-05-23,1,1900,1900.0,1,5000,5000,-3100,btg
2024-05-22,7,62000,8857.14,6,50100,8350,11900,btg
2024-05-21,0,0,0.0,0,0,0,0,btg
2024-05-20,0,0,0.0,0,0,0,0,btg
2024-05-17,0,0,0.0,0,0,0,0,btg
2024-05-16,0,0,0.0,0,0,0,0,btg
2024-05-15,0,0,0.0,0,0,0,0,btg
2024-05-14,0,0,0.0,0,0,0,0,btg
2024-05-13,1,10000,10000.0,1,8500,8500,1500,btg
2024-05-10,0,0,0.0,0,0,0,0,btg
2024-05-09,0,0,0.0,0,0,0,0,btg
2024-05-08,0,0,0.0,0,0,0,0,btg
2024-05-07,0,0,0.0,0,0,0,0,btg
2024-05-06,0,0,0.0,0,0,0,0,btg
2024-05-03,0,0,0.0,0,0,0,0,btg
2024-05-02,1,15000,15000.0,1,10100,10100,4900,btg
2024-04-26,0,0,0.0,0,0,0,0,btg
2024-04-25,0,0,0.0,0,0,0,0,btg
2024-04-24,0,0,0.0,0,0,0,0,btg
2024-04-23,0,0,0.0,0,0,0,0,btg
2024-04-22,0,0,0.0,0,0,0,0,btg
2024-04-19,0,0,0.0,0,0,0,0,btg
2024-04-17,0,0,0.0,0,0,0,0,btg
2024-04-16,0,0,0.0,0,0,0,0,btg
2024-04-15,2,11000,5500.0,3,9600,3200,1400,btg
2024-04-12,0,0,0.0,0,0,0,0,btg
2024-04-11,0,0,0.0,0,0,0,0,btg
2024-04-10,0,0,0.0,0,0,0,0,btg
2024-04-09,0,0,0.0,0,0,0,0,btg
2024-04-08,0,0,0.0,0,0,0,0,btg
2024-04-05,0,0,0.0,0,0,0,0,btg
2024-04-04,1,10000,10000.0,2,8100,4050,1900,btg
2024-04-03,0,0,0.0,1,8000,8000,-8000,btg
2024-04-02,0,0,0.0,0,0,0,0,btg
2024-04-01,0,0,0.0,0,0,0,0,btg
2024-03-29,0,0,0.0,0,0,0,0,btg
2024-03-28,0,0,0.0,0,0,0,0,btg
2024-03-27,0,0,0.0,0,0,0,0,btg
2024-03-26,0,0,0.0,0,0,0,0,btg
2024-03-25,0,0,0.0,0,0,0,0,btg
2024-03-22,0,0,0.0,1,7600,7600,-7600,btg
2024-03-21,0,0,0.0,0,0,0,0,btg
2024-03-20,0,0,0.0,0,0,0,0,btg
2024-03-19,0,0,0.0,0,0,0,0,btg
2024-03-18,0,0,0.0,0,0,0,0,btg
2024-03-15,0,0,0.0,1,5000,5000,-5000,btg
2024-03-14,1,9000,9000.0,1,9000,9000,0,btg
2024-03-13,0,0,0.0,0,0,0,0,btg
2024-03-12,2,8100,4050.0,1,8000,8000,100,btg
2024-03-11,0,0,0.0,0,0,0,0,btg
2024-03-08,2,12000,6000.0,1,10000,10000,2000,btg
2024-03-07,2,200,100.0,1,200,200,0,btg
2024-03-06,1,1000,1000.0,1,200,200,800,btg
2024-03-05,0,0,0.0,0,0,0,0,btg
2024-03-04,1,1000,1000.0,1,200,200,800,btg
2024-03-01,1,1000,1000.0,3,400,133,600,btg
2024-02-29,3,3300,1100.0,2,3400,1700,-100,btg
2024-02-28,2,500,250.0,0,0,0,500,btg
2024-02-27,3,600,200.0,0,0,0,600,btg
2024-02-26,3,2100,700.0,1,300,300,1800,btg
2024-02-23,3,2000,666.67,0,0,0,2000,btg
2024-02-22,1,100,100.0,0,0,0,100,btg
2024-02-21,0,0,0.0,0,0,0,0,btg
2024-02-20,1,300,300.0,0,0,0,300,btg
2024-02-19,2,1600,800.0,1,200,200,1400,btg
2024-02-16,2,2200,1100.0,1,200,200,2000,btg
2024-02-15,1,3000,3000.0,3,600,200,2400,btg
2024-02-07,2,3100,1550.0,0,0,0,3100,btg
2024-02-06,1,3000,3000.0,0,0,0,3000,btg
2024-02-05,0,0,0.0,0,0,0,0,btg
2024-02-02,5,11200,2240.0,6,6900,1150,4300,btg
2024-02-01,4,3400,850.0,3,300,100,3100,btg
2024-01-31,2,2100,1050.0,2,700,350,1400,btg
2024-01-30,2,3100,1550.0,1,1300,1300,1800,btg
2024-01-29,7,4200,600.0,5,3000,600,1200,btg
2024-01-26,3,2400,800.0,0,0,0,2400,btg
2024-01-25,3,1200,400.0,2,500,250,700,btg
2024-01-24,2,2100,1050.0,2,500,250,1600,btg
2024-01-23,9,6000,666.67,1,500,500,5500,btg
2024-01-22,6,3100,516.67,5,2500,500,600,btg
2024-01-19,2,1100,550.0,4,1500,375,-400,btg
2024-01-18,3,1300,433.33,6,2500,417,-1200,btg
2024-01-17,1,1000,1000.0,3,800,267,200,btg
2024-01-16,2,2100,1050.0,4,2400,600,-300,btg
2024-01-15,3,2000,666.67,3,700,233,1300,btg
2024-01-12,13,3700,284.62,9,5000,556,-1300,btg
2024-01-11,4,1300,325.0,1,500,500,800,btg
2024-01-10,4,2300,575.0,0,0,0,2300,btg
2024-01-09,22,10000,454.55,12,7500,625,2500,btg
2024-01-08,4,1100,275.0,5,8200,1640,-7100,btg
2024-01-05,0,0,0.0,2,6100,3050,-6100,btg
2024-01-04,0,0,0.0,2,13200,6600,-13200,btg
2024-01-03,0,0,0.0,1,8100,8100,-8100,btg
2024-01-02,0,0,0.0,2,9200,4600,-9200,btg
2024-09-12,8,2100,262.5,9,4500,500,-2400,bth
2024-09-11,5,1900,380.0,10,4000,400,-2100,bth
2024-09-10,13,3300,253.85,9,1800,200,1500,bth
2024-09-09,8,3100,387.5,11,3200,291,-100,bth
2024-09-06,7,2700,385.71,10,2700,270,0,bth
2024-09-05,3,500,166.67,8,2300,288,-1800,bth
2024-09-04,9,1000,111.11,18,7900,439,-6900,bth
2024-08-30,4,600,150.0,11,18600,1691,-18000,bth
2024-08-29,10,1600,160.0,7,3600,514,-2000,bth
2024-08-28,25,5000,200.0,17,29900,1759,-24900,bth
2024-08-27,19,4500,236.84,10,3300,330,1200,bth
2024-08-26,9,2300,255.56,9,1000,111,1300,bth
2024-08-23,9,3900,433.33,6,700,117,3200,bth
2024-08-22,16,4400,275.0,10,2200,220,2200,bth
2024-08-21,36,9600,266.67,17,3300,194,6300,bth
2024-08-20,19,5100,268.42,12,2300,192,2800,bth
2024-08-19,10,3400,340.0,8,1200,150,2200,bth
2024-08-16,12,5900,491.67,13,3700,285,2200,bth
2024-08-15,13,8700,669.23,9,2600,289,6100,bth
2024-08-14,15,4600,306.67,11,2200,200,2400,bth
2024-08-13,19,6900,363.16,17,2200,129,4700,bth
2024-08-12,10,1700,170.0,14,2500,179,-800,bth
2024-08-09,22,13800,627.27,11,2900,264,10900,bth
2024-08-08,26,9300,357.69,17,5400,318,3900,bth
2024-08-07,30,12000,400.0,18,8600,478,3400,bth
2024-08-06,13,6800,523.08,9,4200,467,2600,bth
2024-08-05,7,3200,457.14,14,5500,393,-2300,bth
2024-08-02,12,3600,300.0,7,1100,157,2500,bth
2024-08-01,19,4100,215.79,10,4100,410,0,bth
2024-07-31,20,11700,585.0,31,8900,287,2800,bth
2024-07-30,16,3800,237.5,25,3400,136,400,bth
2024-07-29,33,6700,203.03,47,8400,179,-1700,bth
2024-07-26,61,15100,247.54,8,3600,450,11500,bth
2024-07-25,64,49400,771.88,10,38900,3890,10500,bth
2024-07-24,19,15300,805.26,4,7000,1750,8300,bth
2024-07-23,12,23200,1933.33,1,2000,2000,21200,bth
2024-07-22,8,22000,2750.0,1,7800,7800,14200,bth
2024-07-19,1,500,500.0,0,0,0,500,bth
2024-07-18,1,100,100.0,1,2000,2000,-1900,bth
2024-07-17,0,0,0.0,0,0,0,0,bth
2024-07-16,1,100,100.0,0,0,0,100,bth
2024-07-15,2,2000,1000.0,0,0,0,2000,bth
2024-07-12,0,0,0.0,0,0,0,0,bth
2024-07-11,0,0,0.0,0,0,0,0,bth
2024-07-10,1,1000,1000.0,0,0,0,1000,bth
2024-07-09,0,0,0.0,0,0,0,0,bth
2024-07-08,1,2000,2000.0,0,0,0,2000,bth
2024-07-05,1,1000,1000.0,1,2000,2000,-1000,bth
2024-07-04,2,3000,1500.0,1,2000,2000,1000,bth
2024-07-03,0,0,0.0,0,0,0,0,bth
2024-07-02,0,0,0.0,0,0,0,0,bth
2024-07-01,0,0,0.0,0,0,0,0,bth
2024-06-28,0,0,0.0,0,0,0,0,bth
2024-06-27,0,0,0.0,0,0,0,0,bth
2024-06-26,0,0,0.0,0,0,0,0,bth
2024-06-25,0,0,0.0,0,0,0,0,bth
2024-06-24,0,0,0.0,0,0,0,0,bth
2024-06-21,0,0,0.0,0,0,0,0,bth
2024-06-20,0,0,0.0,0,0,0,0,bth
2024-06-19,0,0,0.0,0,0,0,0,bth
2024-06-18,1,1000,1000.0,0,0,0,1000,bth
2024-06-17,0,0,0.0,0,0,0,0,bth
2024-06-14,2,3600,1800.0,1,1800,1800,1800,bth
2024-06-13,1,1000,1000.0,0,0,0,1000,bth
2024-06-12,0,0,0.0,0,0,0,0,bth
2024-06-11,1,1000,1000.0,0,0,0,1000,bth
2024-06-10,3,2500,833.33,2,1300,650,1200,bth
2024-06-07,1,2500,2500.0,0,0,0,2500,bth
2024-06-06,2,4900,2450.0,1,2000,2000,2900,bth
2024-06-05,1,4300,4300.0,2,4300,2150,0,bth
2024-06-04,1,4300,4300.0,2,4300,2150,0,bth
2024-06-03,1,2000,2000.0,1,2000,2000,0,bth
2024-05-31,1,2300,2300.0,2,4300,2150,-2000,bth
2024-05-30,5,4000,800.0,2,2000,1000,2000,bth
2024-05-29,1,1000,1000.0,1,1000,1000,0,bth
2024-05-28,1,2000,2000.0,1,1000,1000,1000,bth
2024-05-27,1,2000,2000.0,1,1000,1000,1000,bth
2024-05-24,1,1000,1000.0,0,0,0,1000,bth
2024-05-23,2,2000,1000.0,0,0,0,2000,bth
2024-05-22,1,1000,1000.0,0,0,0,1000,bth
2024-05-21,1,1000,1000.0,0,0,0,1000,bth
2024-05-20,4,2000,500.0,3,900,300,1100,bth
2024-05-17,0,0,0.0,1,300,300,-300,bth
2024-05-16,1,1000,1000.0,0,0,0,1000,bth
2024-05-15,0,0,0.0,0,0,0,0,bth
2024-05-14,2,1100,550.0,1,100,100,1000,bth
2024-05-13,1,100,100.0,1,100,100,0,bth
2024-05-10,2,1100,550.0,1,100,100,1000,bth
2024-05-09,1,100,100.0,1,100,100,0,bth
2024-05-08,1,100,100.0,1,100,100,0,bth
2024-05-07,1,100,100.0,1,100,100,0,bth
2024-05-06,2,1100,550.0,1,100,100,1000,bth
2024-05-03,2,1100,550.0,1,100,100,1000,bth
2024-05-02,1,100,100.0,1,100,100,0,bth
2024-04-26,1,100,100.0,1,100,100,0,bth
2024-04-25,2,1100,550.0,0,0,0,1100,bth
2024-04-24,0,0,0.0,1,100,100,-100,bth
2024-04-23,2,2000,1000.0,2,100,50,1900,bth
2024-04-22,0,0,0.0,1,100,100,-100,bth
2024-04-19,1,1000,1000.0,0,0,0,1000,bth
2024-04-17,1,1000,1000.0,0,0,0,1000,bth
2024-04-16,2,4000,2000.0,1,3000,3000,1000,bth
2024-04-15,0,0,0.0,1,500,500,-500,bth
2024-04-12,1,1000,1000.0,0,0,0,1000,bth
2024-04-11,2,2000,1000.0,1,1000,1000,1000,bth
2024-04-10,1,1000,1000.0,0,0,0,1000,bth
2024-04-09,1,1000,1000.0,0,0,0,1000,bth
2024-04-08,2,3000,1500.0,1,100,100,2900,bth
2024-04-05,1,2000,2000.0,2,100,50,1900,bth
2024-04-04,1,1000,1000.0,2,800,400,200,bth
2024-04-03,3,400,133.33,4,1500,375,-1100,bth
2024-04-02,0,0,0.0,5,3100,620,-3100,bth
2024-04-01,2,1100,550.0,3,900,300,200,bth
2024-03-29,4,4100,1025.0,1,100,100,4000,bth
2024-03-28,5,3400,680.0,8,4200,525,-800,bth
2024-03-27,4,3600,900.0,6,4300,717,-700,bth
2024-03-26,2,1400,700.0,2,1100,550,300,bth
2024-03-25,1,5000,5000.0,1,5000,5000,0,bth
2024-03-22,1,2000,2000.0,1,5000,5000,-3000,bth
2024-03-21,4,5100,1275.0,2,5100,2550,0,bth
2024-03-20,0,0,0.0,0,0,0,0,bth
2024-03-19,0,0,0.0,0,0,0,0,bth
2024-03-18,1,1000,1000.0,0,0,0,1000,bth
2024-03-15,2,6000,3000.0,1,100,100,5900,bth
2024-03-14,1,5000,5000.0,0,0,0,5000,bth
2024-03-13,1,5000,5000.0,0,0,0,5000,bth
2024-03-12,1,5000,5000.0,0,0,0,5000,bth
2024-03-11,1,10000,10000.0,0,0,0,10000,bth
2024-03-08,0,0,0.0,1,5000,5000,-5000,bth
2024-03-07,1,1000,1000.0,0,0,0,1000,bth
2024-03-06,0,0,0.0,0,0,0,0,bth
2024-03-05,1,1000,1000.0,0,0,0,1000,bth
2024-03-04,1,1000,1000.0,0,0,0,1000,bth
2024-03-01,2,6000,3000.0,0,0,0,6000,bth
2024-02-29,0,0,0.0,0,0,0,0,bth
2024-02-28,0,0,0.0,0,0,0,0,bth
2024-02-27,1,1000,1000.0,0,0,0,1000,bth
2024-02-26,1,1000,1000.0,0,0,0,1000,bth
2024-02-23,1,1000,1000.0,0,0,0,1000,bth
2024-02-22,1,1000,1000.0,0,0,0,1000,bth
2024-02-21,0,0,0.0,0,0,0,0,bth
2024-02-20,1,1000,1000.0,0,0,0,1000,bth
2024-02-19,1,1000,1000.0,0,0,0,1000,bth
2024-02-16,1,1000,1000.0,0,0,0,1000,bth
2024-02-15,2,3100,1550.0,0,0,0,3100,bth
2024-02-07,3,3100,1033.33,1,100,100,3000,bth
2024-02-06,1,1000,1000.0,0,0,0,1000,bth
2024-02-05,1,1000,1000.0,0,0,0,1000,bth
2024-02-02,1,1000,1000.0,0,0,0,1000,bth
2024-02-01,2,3000,1500.0,0,0,0,3000,bth
2024-01-31,1,1000,1000.0,0,0,0,1000,bth
2024-01-30,0,0,0.0,0,0,0,0,bth
2024-01-29,1,1000,1000.0,0,0,0,1000,bth
2024-01-26,0,0,0.0,0,0,0,0,bth
2024-01-25,1,5000,5000.0,0,0,0,5000,bth
2024-01-24,0,0,0.0,0,0,0,0,bth
2024-01-23,1,1000,1000.0,0,0,0,1000,bth
2024-01-22,1,1000,1000.0,0,0,0,1000,bth
2024-01-19,1,5000,5000.0,0,0,0,5000,bth
2024-01-18,2,3000,1500.0,0,0,0,3000,bth
2024-01-17,1,1000,1000.0,0,0,0,1000,bth
2024-01-16,1,1000,1000.0,0,0,0,1000,bth
2024-01-15,2,3000,1500.0,0,0,0,3000,bth
2024-01-12,0,0,0.0,0,0,0,0,bth
2024-01-11,0,0,0.0,0,0,0,0,bth
2024-01-10,1,1000,1000.0,0,0,0,1000,bth
2024-01-09,1,1000,1000.0,0,0,0,1000,bth
2024-01-08,0,0,0.0,0,0,0,0,bth
2024-01-05,5,4800,960.0,1,100,100,4700,bth
2024-01-04,2,600,300.0,0,0,0,600,bth
2024-01-03,2,700,350.0,0,0,0,700,bth
2024-01-02,3,1500,500.0,0,0,0,1500,bth
2024-09-12,24,10500,437.5,28,14500,518,-4000,btp
2024-09-11,33,18100,548.48,47,20400,434,-2300,btp
2024-09-10,28,21200,757.14,30,7500,250,13700,btp
2024-09-09,39,25000,641.03,49,17300,353,7700,btp
2024-09-06,43,36900,858.14,40,21800,545,15100,btp
2024-09-05,24,8100,337.5,33,16600,503,-8500,btp
2024-09-04,55,27300,496.36,35,23900,683,3400,btp
2024-08-30,35,28100,802.86,22,16100,732,12000,btp
2024-08-29,34,14100,414.71,21,20000,952,-5900,btp
2024-08-28,65,35600,547.69,43,38400,893,-2800,btp
2024-08-27,52,35300,678.85,43,25500,593,9800,btp
2024-08-26,61,24400,400.0,46,23900,520,500,btp
2024-08-23,61,26800,439.34,44,33400,759,-6600,btp
2024-08-22,59,33400,566.1,40,18500,462,14900,btp
2024-08-21,43,20900,486.05,30,17500,583,3400,btp
2024-08-20,72,40200,558.33,64,28400,444,11800,btp
2024-08-19,63,49300,782.54,58,31800,548,17500,btp
2024-08-16,96,51700,538.54,54,42200,781,9500,btp
2024-08-15,84,45800,545.24,38,79900,2103,-34100,btp
2024-08-14,86,50900,591.86,44,104500,2375,-53600,btp
2024-08-13,56,28900,516.07,45,56200,1249,-27300,btp
2024-08-12,64,17800,278.12,31,48100,1552,-30300,btp
2024-08-08,68,18800,276.47,32,52400,1638,-33600,btp
2024-08-07,55,39100,710.91,40,42400,1060,-3300,btp
2024-08-06,88,93300,1060.23,57,144200,2530,-50900,btp
2024-08-05,93,40900,439.78,70,152800,2183,-111900,btp
2024-08-02,68,32500,477.94,50,68400,1368,-35900,btp
2024-08-01,89,42900,482.02,82,82100,1001,-39200,btp
2024-07-31,68,47400,697.06,41,72400,1766,-25000,btp
2024-07-30,64,31700,495.31,43,52800,1228,-21100,btp
2024-07-29,61,27300,447.54,41,49800,1215,-22500,btp
2024-07-26,75,72300,964.0,44,182800,4155,-110500,btp
2024-07-25,85,27900,328.24,43,77900,1812,-50000,btp
2024-07-24,112,74900,668.75,72,137500,1910,-62600,btp
2024-07-22,161,83100,516.15,86,201800,2347,-118700,btp
2024-07-19,246,153900,625.61,137,203100,1482,-49200,btp
2024-07-18,103,60200,584.47,77,130900,1700,-70700,btp
2024-07-17,106,114300,1078.3,95,160300,1687,-46000,btp
2024-07-16,79,61100,773.42,85,86300,1015,-25200,btp
2024-07-15,130,107300,825.38,84,124200,1479,-16900,btp
2024-07-12,72,74500,1034.72,76,85100,1120,-10600,btp
2024-07-11,151,92700,613.91,87,80500,925,12200,btp
2024-07-10,91,94800,1041.76,98,101700,1038,-6900,btp
2024-07-09,133,123700,930.08,68,103000,1515,20700,btp
2024-07-08,78,71100,911.54,116,131100,1130,-60000,btp
2024-07-05,93,51400,552.69,68,95000,1397,-43600,btp
2024-07-04,122,72000,590.16,83,127700,1539,-55700,btp
2024-07-03,144,92400,641.67,99,125900,1272,-33500,btp
2024-07-02,72,41400,575.0,67,84400,1260,-43000,btp
2024-07-01,80,69000,862.5,57,67700,1188,1300,btp
2024-06-28,103,84500,820.39,108,128900,1194,-44400,btp
2024-06-27,98,105000,1071.43,90,85700,952,19300,btp
2024-06-26,200,178700,893.5,126,235300,1867,-56600,btp
2024-06-25,92,56400,613.04,102,93800,920,-37400,btp
2024-06-24,295,404200,1370.17,233,423700,1818,-19500,btp
2024-06-21,135,125900,932.59,88,165100,1876,-39200,btp
2024-06-20,95,101200,1065.26,93,129200,1389,-28000,btp
2024-06-19,107,78000,728.97,81,135100,1668,-57100,btp
2024-06-18,126,161300,1280.16,80,137400,1718,23900,btp
2024-06-17,149,183300,1230.2,72,227000,3153,-43700,btp
2024-06-14,142,168500,1186.62,106,193600,1826,-25100,btp
2024-06-13,115,119100,1035.65,92,135700,1475,-16600,btp
2024-06-12,118,134800,1142.37,101,107900,1068,26900,btp
2024-06-11,156,218700,1401.92,133,158400,1191,60300,btp
2024-06-10,161,198000,1229.81,83,105700,1273,92300,btp
2024-06-07,165,193200,1170.91,93,183700,1975,9500,btp
2024-06-06,114,65100,571.05,113,204000,1805,-138900,btp
2024-06-05,122,104800,859.02,106,173000,1632,-68200,btp
2024-06-04,164,209400,1276.83,175,286700,1638,-77300,btp
2024-06-03,155,293300,1892.26,96,247300,2576,46000,btp
2024-05-31,102,223000,2186.27,60,237800,3963,-14800,btp
2024-05-30,121,148600,1228.1,79,209700,2654,-61100,btp
2024-05-29,89,90400,1015.73,97,121200,1249,-30800,btp
2024-05-28,82,64800,790.24,86,131700,1531,-66900,btp
2024-05-27,120,143500,1195.83,88,143500,1631,0,btp
2024-05-24,104,87700,843.27,86,137800,1602,-50100,btp
2024-05-23,125,154300,1234.4,99,164300,1660,-10000,btp
2024-05-22,149,126300,847.65,68,177200,2606,-50900,btp
2024-05-21,94,114900,1222.34,111,222800,2007,-107900,btp
2024-05-20,156,175300,1123.72,127,199500,1571,-24200,btp
2024-05-17,140,176300,1259.29,70,141300,2019,35000,btp
2024-05-16,106,166600,1571.7,98,127300,1299,39300,btp
2024-05-15,216,137200,635.19,101,225600,2234,-88400,btp
2024-05-14,122,72300,592.62,91,183400,2015,-111100,btp
2024-05-13,92,61600,669.57,75,146700,1956,-85100,btp
2024-05-10,126,79200,628.57,75,130600,1741,-51400,btp
2024-05-09,99,184500,1863.64,47,105400,2243,79100,btp
2024-05-08,150,304200,2028.0,89,181200,2036,123000,btp
2024-05-07,167,173900,1041.32,127,327500,2579,-153600,btp
2024-05-06,121,137900,1139.67,134,278900,2081,-141000,btp
2024-05-03,69,123100,1784.06,162,179600,1109,-56500,btp
2024-05-02,141,239100,1695.74,123,134600,1094,104500,btp
2024-04-26,86,176600,2053.49,62,105200,1697,71400,btp
2024-04-25,79,40500,512.66,46,101400,2204,-60900,btp
2024-04-24,57,28900,507.02,72,91100,1265,-62200,btp
2024-04-23,63,28200,447.62,60,83400,1390,-55200,btp
2024-04-22,90,75400,837.78,69,66200,959,9200,btp
2024-04-19,92,34100,370.65,58,69000,1190,-34900,btp
2024-04-17,66,95100,1440.91,83,117000,1410,-21900,btp
2024-04-16,157,127500,812.1,114,139600,1225,-12100,btp
2024-04-15,96,86900,905.21,134,200300,1495,-113400,btp
2024-04-12,113,98700,873.45,65,120900,1860,-22200,btp
2024-04-11,96,72100,751.04,67,58200,869,13900,btp
2024-04-10,82,84300,1028.05,92,94900,1032,-10600,btp
2024-04-09,107,111700,1043.93,81,66300,819,45400,btp
2024-04-08,183,110300,602.73,94,166900,1776,-56600,btp
2024-04-05,131,100100,764.12,102,144800,1420,-44700,btp
2024-04-04,169,82000,485.21,93,104800,1127,-22800,btp
2024-04-03,145,93800,646.9,106,117400,1108,-23600,btp
2024-04-02,219,180400,823.74,110,220800,2007,-40400,btp
2024-04-01,198,111300,562.12,111,129500,1167,-18200,btp
2024-03-29,201,119200,593.03,102,172500,1691,-53300,btp
2024-03-28,212,145000,683.96,115,141600,1231,3400,btp
2024-03-27,150,240100,1600.67,116,124900,1077,115200,btp
2024-03-26,177,154800,874.58,106,171200,1615,-16400,btp
2024-03-25,260,160300,616.54,108,203000,1880,-42700,btp
2024-03-22,315,241300,766.03,186,234800,1262,6500,btp
2024-03-21,156,146500,939.1,150,150600,1004,-4100,btp
2024-03-20,165,146900,890.3,126,149200,1184,-2300,btp
2024-03-19,205,519100,2532.2,198,474200,2395,44900,btp
2024-03-18,465,414500,891.4,293,673800,2300,-259300,btp
2024-03-15,244,266100,1090.57,242,442500,1829,-176400,btp
2024-03-14,569,888000,1560.63,360,839300,2331,48700,btp
2024-03-13,608,673200,1107.24,358,964600,2694,-291400,btp
2024-03-12,509,504700,991.55,403,762800,1893,-258100,btp
2024-03-11,615,1087000,1767.48,451,1656600,3673,-569600,btp
2024-03-08,344,689900,2005.52,272,640400,2354,49500,btp
2024-03-07,378,604800,1600.0,290,379100,1307,225700,btp
2024-03-06,312,400800,1284.62,310,533600,1721,-132800,btp
2024-03-05,484,848500,1753.1,323,627600,1943,220900,btp
2024-03-04,619,1453900,2348.79,342,853400,2495,600500,btp
2024-03-01,200,963500,4817.5,250,711800,2847,251700,btp
2024-02-29,382,444700,1164.14,248,774600,3123,-329900,btp
2024-02-28,466,753200,1616.31,326,792200,2430,-39000,btp
2024-02-27,373,788300,2113.4,271,701500,2589,86800,btp
2024-02-26,77,172500,2240.26,69,166300,2410,6200,btp
2024-02-23,118,184300,1561.86,79,130000,1646,54300,btp
2024-02-22,82,162100,1976.83,62,107300,1731,54800,btp
2024-02-21,87,153200,1760.92,59,157200,2664,-4000,btp
2024-02-20,131,358800,2738.93,104,226700,2180,132100,btp
2024-02-19,115,204400,1777.39,89,147400,1656,57000,btp
2024-02-16,88,143300,1628.41,80,85500,1069,57800,btp
2024-02-15,97,186800,1925.77,80,117400,1468,69400,btp
2024-02-07,0,0,0.0,0,0,0,0,btp
2024-02-06,77,157000,2038.96,61,81500,1336,75500,btp
2024-02-05,131,207800,1586.26,88,138400,1573,69400,btp
2024-02-02,98,95500,974.49,56,65800,1175,29700,btp
2024-02-01,49,79600,1624.49,78,62900,806,16700,btp
2024-01-31,51,92800,1819.61,62,80500,1298,12300,btp
2024-01-30,32,59600,1862.5,39,65500,1679,-5900,btp
2024-01-29,73,177100,2426.03,54,102000,1889,75100,btp
2024-01-26,56,137900,2462.5,45,109900,2442,28000,btp
2024-01-25,54,90900,1683.33,39,98000,2513,-7100,btp
2024-01-24,114,252400,2214.04,54,173500,3213,78900,btp
2024-01-23,108,145300,1345.37,38,73100,1924,72200,btp
2024-01-22,83,100700,1213.25,45,91100,2024,9600,btp
2024-01-19,86,198600,2309.3,59,163500,2771,35100,btp
2024-01-18,78,237500,3044.87,79,116900,1480,120600,btp
2024-01-17,61,121500,1991.8,41,75000,1829,46500,btp
2024-01-16,44,127100,2888.64,39,159100,4079,-32000,btp
2024-01-15,56,64300,1148.21,37,63100,1705,1200,btp
2024-01-12,78,222500,2852.56,60,107900,1798,114600,btp
2024-01-11,57,182000,3192.98,52,106300,2044,75700,btp
2024-01-10,0,0,0.0,0,0,0,0,btp
2024-01-09,84,115300,1372.62,47,100400,2136,14900,btp
2024-01-08,113,116100,1027.43,62,231300,3731,-115200,btp
2024-01-05,100,195300,1953.0,61,132300,2169,63000,btp
2024-01-04,67,86000,1283.58,64,176900,2764,-90900,btp
2024-01-03,66,103100,1562.12,64,192400,3006,-89300,btp
2024-01-02,133,268900,2021.8,113,249000,2204,19900,btp
2024-09-12,17,38700,2276.47,24,91600,3817,-52900,bts
2024-09-11,17,33300,1958.82,21,42600,2029,-9300,bts
2024-09-10,19,9000,473.68,25,53100,2124,-44100,bts
2024-09-09,25,49800,1992.0,30,63600,2120,-13800,bts
2024-09-06,33,64900,1966.67,33,63100,1912,1800,bts
2024-09-05,29,48900,1686.21,27,70700,2619,-21800,bts
2024-09-04,20,20500,1025.0,37,111400,3011,-90900,bts
2024-08-30,43,43400,1009.3,58,110000,1897,-66600,bts
2024-08-29,24,19200,800.0,38,98200,2584,-79000,bts
2024-08-28,21,20500,976.19,42,128800,3067,-108300,bts
2024-08-27,25,34600,1384.0,44,108100,2457,-73500,bts
2024-08-26,27,22100,818.52,43,105000,2442,-82900,bts
2024-08-23,22,31000,1409.09,29,117800,4062,-86800,bts
2024-08-22,29,29100,1003.45,40,185100,4628,-156000,bts
2024-08-21,32,39600,1237.5,41,65500,1598,-25900,bts
2024-08-20,45,84300,1873.33,48,97700,2035,-13400,bts
2024-08-19,48,26500,552.08,46,84200,1830,-57700,bts
2024-08-16,33,26500,803.03,42,139800,3329,-113300,bts
2024-08-15,17,15200,894.12,33,85400,2588,-70200,bts
2024-08-14,23,12100,526.09,35,59400,1697,-47300,bts
2024-08-13,29,19200,662.07,53,93300,1760,-74100,bts
2024-08-12,19,13000,684.21,32,89200,2788,-76200,bts
2024-08-09,36,18800,522.22,32,70600,2206,-51800,bts
2024-08-08,28,17300,617.86,34,87800,2582,-70500,bts
2024-08-07,29,26000,896.55,28,55500,1982,-29500,bts
2024-08-06,39,22300,571.79,20,55800,2790,-33500,bts
2024-08-05,37,40900,1105.41,36,98500,2736,-57600,bts
2024-08-02,50,91600,1832.0,37,115400,3119,-23800,bts
2024-08-01,44,27800,631.82,41,63600,1551,-35800,bts
2024-07-31,46,33700,732.61,36,90000,2500,-56300,bts
2024-07-30,32,32200,1006.25,36,120700,3353,-88500,bts
2024-07-29,54,50500,935.19,31,130100,4197,-79600,bts
2024-07-26,33,28100,851.52,34,102600,3018,-74500,bts
2024-07-25,32,41000,1281.25,29,104800,3614,-63800,bts
2024-07-24,28,10800,385.71,33,71200,2158,-60400,bts
2024-07-23,31,47000,1516.13,30,103300,3443,-56300,bts
2024-07-22,44,51500,1170.45,26,76700,2950,-25200,bts
2024-07-19,49,64500,1316.33,49,121000,2469,-56500,bts
2024-07-18,37,34500,932.43,48,100800,2100,-66300,bts
2024-07-17,55,57800,1050.91,51,125300,2457,-67500,bts
2024-07-16,63,119600,1898.41,96,186500,1943,-66900,bts
2024-07-15,54,68200,1262.96,50,86400,1728,-18200,bts
2024-07-12,69,110100,1595.65,68,176400,2594,-66300,bts
2024-07-11,73,105500,1445.21,75,158900,2119,-53400,bts
2024-07-10,98,180900,1845.92,93,153400,1649,27500,bts
2024-07-09,112,172500,1540.18,87,134200,1543,38300,bts
2024-07-08,116,197000,1698.28,97,227400,2344,-30400,bts
2024-07-05,66,135600,2054.55,61,147200,2413,-11600,bts
2024-07-04,74,101500,1371.62,81,159800,1973,-58300,bts
2024-07-03,62,108000,1741.94,60,159100,2652,-51100,bts
2024-07-02,51,80800,1584.31,71,209600,2952,-128800,bts
2024-07-01,101,148000,1465.35,85,173500,2041,-25500,bts
2024-06-28,39,68400,1753.85,61,137600,2256,-69200,bts
2024-06-27,50,72000,1440.0,72,171100,2376,-99100,bts
2024-06-26,76,114300,1503.95,69,144300,2091,-30000,bts
2024-06-25,53,79600,1501.89,77,140400,1823,-60800,bts
2024-06-24,108,183900,1702.78,120,257300,2144,-73400,bts
2024-06-21,136,156500,1150.74,111,234800,2115,-78300,bts
2024-06-20,160,294000,1837.5,126,361500,2869,-67500,bts
2024-06-19,145,543800,3750.34,101,213000,2109,330800,bts
2024-06-18,210,596500,2840.48,169,575500,3405,21000,bts
2024-06-17,82,126400,1541.46,116,236300,2037,-109900,bts
2024-06-14,374,1538000,4112.3,281,1017900,3622,520100,bts
2024-06-13,37,73300,1981.08,38,130000,3421,-56700,bts
2024-06-12,66,83300,1262.12,54,86700,1606,-3400,bts
2024-06-11,51,66000,1294.12,57,81100,1423,-15100,bts
2024-06-10,44,69500,1579.55,43,52900,1230,16600,bts
2024-06-07,34,44300,1302.94,46,54500,1185,-10200,bts
2024-06-06,40,68500,1712.5,48,72200,1504,-3700,bts
2024-06-05,28,55700,1989.29,36,51700,1436,4000,bts
2024-06-04,112,165100,1474.11,61,151500,2484,13600,bts
2024-06-03,40,88400,2210.0,35,104200,2977,-15800,bts
2024-05-31,34,37500,1102.94,37,46200,1249,-8700,bts
2024-05-30,36,54800,1522.22,44,71800,1632,-17000,bts
2024-05-29,87,176700,2031.03,54,154500,2861,22200,bts
2024-05-28,28,29500,1053.57,48,41000,854,-11500,bts
2024-05-27,27,26100,966.67,29,204500,7052,-178400,bts
2024-05-24,27,14100,522.22,33,33100,1003,-19000,bts
2024-05-23,29,25900,893.1,35,106200,3034,-80300,bts
2024-05-22,44,34400,781.82,47,58900,1253,-24500,bts
2024-05-21,34,21700,638.24,42,47300,1126,-25600,bts
2024-05-20,49,65800,1342.86,48,87500,1823,-21700,bts
2024-05-17,30,17300,576.67,40,63700,1592,-46400,bts
2024-05-16,32,35300,1103.12,35,60100,1717,-24800,bts
2024-05-15,32,39300,1228.12,32,39900,1247,-600,bts
2024-05-14,34,84800,2494.12,34,92700,2726,-7900,bts
2024-05-13,30,15100,503.33,30,45200,1507,-30100,bts
2024-05-10,26,53300,2050.0,35,79200,2263,-25900,bts
2024-05-09,33,45000,1363.64,35,62800,1794,-17800,bts
2024-05-08,20,18600,930.0,24,56400,2350,-37800,bts
2024-05-07,24,28300,1179.17,27,58400,2163,-30100,bts
2024-05-06,24,54700,2279.17,30,111300,3710,-56600,bts
2024-05-03,39,52800,1353.85,35,97300,2780,-44500,bts
2024-05-02,17,10600,623.53,20,95800,4790,-85200,bts
2024-04-26,33,20200,612.12,29,36300,1252,-16100,bts
2024-04-25,10,5200,520.0,18,21200,1178,-16000,bts
2024-04-24,30,18200,606.67,25,37400,1496,-19200,bts
2024-04-23,16,5100,318.75,26,36100,1388,-31000,bts
2024-04-22,24,10600,441.67,27,34400,1274,-23800,bts
2024-04-19,31,22900,738.71,34,71800,2112,-48900,bts
2024-04-17,34,35600,1047.06,44,88900,2020,-53300,bts
2024-04-16,33,22300,675.76,40,46700,1168,-24400,bts
2024-04-15,30,38900,1296.67,33,47200,1430,-8300,bts
2024-04-12,36,43100,1197.22,32,75600,2362,-32500,bts
2024-04-11,27,16000,592.59,31,62300,2010,-46300,bts
2024-04-10,23,12200,530.43,34,56100,1650,-43900,bts
2024-04-09,32,28400,887.5,37,78600,2124,-50200,bts
2024-04-08,21,32100,1528.57,44,110900,2520,-78800,bts
2024-04-05,22,21900,995.45,32,81200,2538,-59300,bts
2024-04-04,24,18800,783.33,38,85400,2247,-66600,bts
2024-04-03,23,21200,921.74,38,95300,2508,-74100,bts
2024-04-02,23,10600,460.87,37,102900,2781,-92300,bts
2024-04-01,24,14400,600.0,34,71900,2115,-57500,bts
2024-03-29,30,40900,1363.33,44,100100,2275,-59200,bts
2024-03-28,35,31700,905.71,42,86900,2069,-55200,bts
2024-03-27,22,18000,818.18,37,110900,2997,-92900,bts
2024-03-26,29,36400,1255.17,46,82600,1796,-46200,bts
2024-03-25,32,16700,521.88,39,80100,2054,-63400,bts
2024-03-22,27,18100,670.37,38,60300,1587,-42200,bts
2024-03-21,50,53800,1076.0,65,104600,1609,-50800,bts
2024-03-20,19,12700,668.42,31,96300,3106,-83600,bts
2024-03-19,18,16000,888.89,30,69400,2313,-53400,bts
2024-03-18,49,99100,2022.45,53,163800,3091,-64700,bts
2024-03-15,42,52100,1240.48,43,77700,1807,-25600,bts
2024-03-14,50,59900,1198.0,62,115900,1869,-56000,bts
2024-03-13,49,177400,3620.41,54,172000,3185,5400,bts
2024-03-12,42,23200,552.38,63,125300,1989,-102100,bts
2024-03-11,33,21600,654.55,47,104300,2219,-82700,bts
2024-03-08,43,61300,1425.58,51,114600,2247,-53300,bts
2024-03-07,37,63300,1710.81,48,127300,2652,-64000,bts
2024-03-06,58,78400,1351.72,57,138300,2426,-59900,bts
2024-03-05,48,64000,1333.33,40,150900,3772,-86900,bts
2024-03-04,72,81500,1131.94,58,147000,2534,-65500,bts
2024-03-01,58,36300,625.86,46,132500,2880,-96200,bts
2024-02-29,53,108900,2054.72,35,134700,3849,-25800,bts
2024-02-28,41,40800,995.12,45,164100,3647,-123300,bts
2024-02-27,49,61400,1253.06,47,152200,3238,-90800,bts
2024-02-26,30,49300,1643.33,37,131300,3549,-82000,bts
2024-02-23,64,68800,1075.0,49,147300,3006,-78500,bts
2024-02-22,49,88100,1797.96,40,133000,3325,-44900,bts
2024-02-21,55,59900,1089.09,61,157600,2584,-97700,bts
2024-02-20,53,55600,1049.06,50,145300,2906,-89700,bts
2024-02-19,57,58100,1019.3,41,131400,3205,-73300,bts
2024-02-16,33,56700,1718.18,33,140200,4248,-83500,bts
2024-02-15,28,42400,1514.29,46,128300,2789,-85900,bts
2024-02-07,23,35200,1530.43,33,184400,5588,-149200,bts
2024-02-06,35,33400,954.29,41,82000,2000,-48600,bts
2024-02-05,39,31800,815.38,43,83900,1951,-52100,bts
2024-02-02,23,28500,1239.13,33,45100,1367,-16600,bts
2024-02-01,28,29300,1046.43,31,74100,2390,-44800,bts
2024-01-31,39,29500,756.41,48,66100,1377,-36600,bts
2024-01-30,31,26100,841.94,49,70500,1439,-44400,bts
2024-01-29,28,22400,800.0,36,45300,1258,-22900,bts
2024-01-26,28,28000,1000.0,42,131100,3121,-103100,bts
2024-01-25,43,45900,1067.44,41,55500,1354,-9600,bts
2024-01-24,37,24900,672.97,31,54700,1765,-29800,bts
2024-01-23,45,20400,453.33,42,127400,3033,-107000,bts
2024-01-22,30,20900,696.67,30,117200,3907,-96300,bts
2024-01-19,47,49600,1055.32,40,150400,3760,-100800,bts
2024-01-18,37,39400,1064.86,38,128200,3374,-88800,bts
2024-01-17,36,50300,1397.22,39,134300,3444,-84000,bts
2024-01-16,34,42400,1247.06,36,94400,2622,-52000,bts
2024-01-15,42,39200,933.33,38,81200,2137,-42000,bts
2024-01-12,45,57000,1266.67,55,143100,2602,-86100,bts
2024-01-11,28,51100,1825.0,34,93700,2756,-42600,bts
2024-01-10,41,39500,963.41,45,120100,2669,-80600,bts
2024-01-09,23,47700,2073.91,35,104500,2986,-56800,bts
2024-01-08,21,61900,2947.62,37,99100,2678,-37200,bts
2024-01-05,34,73300,2155.88,43,98900,2300,-25600,bts
2024-01-04,54,84900,1572.22,53,127000,2396,-42100,bts
2024-01-03,61,89900,1473.77,49,143800,2935,-53900,bts
2024-01-02,45,50900,1131.11,47,77500,1649,-26600,bts
2024-09-12,1,100,100.0,6,3600,600,-3500,btt
2024-09-11,2,200,100.0,4,600,150,-400,btt
2024-09-10,2,600,300.0,13,3700,285,-3100,btt
2024-09-09,0,0,0.0,13,4900,377,-4900,btt
2024-09-06,1,100,100.0,10,3900,390,-3800,btt
2024-09-05,1,2000,2000.0,6,3200,533,-1200,btt
2024-09-04,4,3500,875.0,16,10900,681,-7400,btt
2024-08-30,16,4400,275.0,12,15600,1300,-11200,btt
2024-08-29,18,7900,438.89,10,12400,1240,-4500,btt
2024-08-28,28,39800,1421.43,11,13400,1218,26400,btt
2024-08-27,29,12700,437.93,21,25400,1210,-12700,btt
2024-08-26,13,4500,346.15,32,39300,1228,-34800,btt
2024-08-23,10,5500,550.0,11,8600,782,-3100,btt
2024-08-22,30,7500,250.0,15,3800,253,3700,btt
2024-08-21,40,26900,672.5,11,4300,391,22600,btt
2024-08-20,27,15300,566.67,5,1800,360,13500,btt
2024-08-19,25,16300,652.0,4,2500,625,13800,btt
2024-08-16,3,700,233.33,2,1700,850,-1000,btt
2024-08-15,1,200,200.0,3,2000,667,-1800,btt
2024-08-14,2,200,100.0,2,1000,500,-800,btt
2024-08-13,1,100,100.0,3,1600,533,-1500,btt
2024-08-12,1,100,100.0,2,1300,650,-1200,btt
2024-08-08,1,100,100.0,3,1200,400,-1100,btt
2024-08-07,2,600,300.0,2,1000,500,-400,btt
2024-08-06,1,100,100.0,1,100,100,0,btt
2024-08-05,1,800,800.0,4,900,225,-100,btt
2024-08-02,1,500,500.0,4,1500,375,-1000,btt
2024-08-01,1,500,500.0,3,2100,700,-1600,btt
2024-07-31,1,100,100.0,3,700,233,-600,btt
2024-07-30,3,1200,400.0,2,600,300,600,btt
2024-07-29,2,200,100.0,2,700,350,-500,btt
2024-07-26,0,0,0.0,2,400,200,-400,btt
2024-07-25,1,100,100.0,2,400,200,-300,btt
2024-07-24,1,1000,1000.0,2,300,150,700,btt
2024-07-22,1,1000,1000.0,6,2100,350,-1100,btt
2024-07-19,2,1100,550.0,5,1700,340,-600,btt
2024-07-18,3,2300,766.67,4,2500,625,-200,btt
2024-07-17,4,3400,850.0,4,2200,550,1200,btt
2024-07-16,4,2300,575.0,2,1700,850,600,btt
2024-07-15,3,700,233.33,2,1500,750,-800,btt
2024-07-12,3,2200,733.33,3,1900,633,300,btt
2024-07-11,7,1600,228.57,4,2300,575,-700,btt
2024-07-10,10,4600,460.0,5,1400,280,3200,btt
2024-07-09,6,3700,616.67,4,3000,750,700,btt
2024-07-08,1,1000,1000.0,3,1300,433,-300,btt
2024-07-05,2,600,300.0,4,1800,450,-1200,btt
2024-07-04,3,1100,366.67,4,1800,450,-700,btt
2024-07-03,5,2300,460.0,8,2700,338,-400,btt
2024-07-02,6,2100,350.0,3,1600,533,500,btt
2024-07-01,1,500,500.0,6,2400,400,-1900,btt
2024-06-28,8,2900,362.5,6,2200,367,700,btt
2024-06-27,1,500,500.0,5,2400,480,-1900,btt
2024-06-26,0,0,0.0,5,3000,600,-3000,btt
2024-06-25,2,300,150.0,5,2100,420,-1800,btt
2024-06-24,3,300,100.0,6,2600,433,-2300,btt
2024-06-21,2,200,100.0,3,2000,667,-1800,btt
2024-06-20,1,100,100.0,4,2500,625,-2400,btt
2024-06-19,2,1600,800.0,4,1900,475,-300,btt
2024-06-18,1,100,100.0,5,3100,620,-3000,btt
2024-06-17,3,400,133.33,5,2400,480,-2000,btt
2024-06-14,2,200,100.0,4,2100,525,-1900,btt
2024-06-13,3,2000,666.67,4,3200,800,-1200,btt
2024-06-12,5,2400,480.0,7,3000,429,-600,btt
2024-06-11,1,1000,1000.0,6,1900,317,-900,btt
2024-06-10,9,2600,288.89,4,500,125,2100,btt
2024-06-07,5,2900,580.0,7,2600,371,300,btt
2024-06-06,2,600,300.0,5,2900,580,-2300,btt
2024-06-05,5,1600,320.0,3,1700,567,-100,btt
2024-06-04,4,2500,625.0,5,4300,860,-1800,btt
2024-06-03,7,2200,314.29,8,2500,312,-300,btt
2024-05-31,2,1100,550.0,5,1500,300,-400,btt
2024-05-30,1,500,500.0,5,2300,460,-1800,btt
2024-05-29,2,600,300.0,5,2300,460,-1700,btt
2024-05-28,1,500,500.0,4,2200,550,-1700,btt
2024-05-27,1,500,500.0,4,2100,525,-1600,btt
2024-05-24,7,2600,371.43,9,4800,533,-2200,btt
2024-05-23,5,1400,280.0,3,2000,667,-600,btt
2024-05-22,4,600,150.0,3,900,300,-300,btt
2024-05-21,3,1500,500.0,2,400,200,1100,btt
2024-05-20,2,800,400.0,2,2000,1000,-1200,btt
2024-05-17,3,1200,400.0,2,1300,650,-100,btt
2024-05-16,1,200,200.0,4,1500,375,-1300,btt
2024-05-15,2,200,100.0,2,200,100,0,btt
2024-05-14,2,200,100.0,3,1200,400,-1000,btt
2024-05-13,0,0,0.0,3,2400,800,-2400,btt
2024-05-10,1,300,300.0,4,2200,550,-1900,btt
2024-05-09,2,400,200.0,3,1100,367,-700,btt
2024-05-08,1,200,200.0,4,3100,775,-2900,btt
2024-05-07,4,1100,275.0,5,4200,840,-3100,btt
2024-05-06,5,1300,260.0,7,3700,529,-2400,btt
2024-05-03,4,1500,375.0,2,2200,1100,-700,btt
2024-05-02,5,1600,320.0,2,2000,1000,-400,btt
2024-04-26,1,1000,1000.0,2,2800,1400,-1800,btt
2024-04-25,3,1300,433.33,0,0,0,1300,btt
2024-04-24,5,1700,340.0,2,1600,800,100,btt
2024-04-23,6,1600,266.67,3,2200,733,-600,btt
2024-04-22,7,1700,242.86,2,3700,1850,-2000,btt
2024-04-19,9,4000,444.44,2,2800,1400,1200,btt
2024-04-17,7,7100,1014.29,4,5100,1275,2000,btt
2024-04-16,5,1500,300.0,1,1100,1100,400,btt
2024-04-15,6,1800,300.0,2,1900,950,-100,btt
2024-04-12,5,2800,560.0,1,1100,1100,1700,btt
2024-04-11,6,1800,300.0,2,2300,1150,-500,btt
2024-04-10,3,1500,500.0,2,1800,900,-300,btt
2024-04-09,4,1600,400.0,5,2500,500,-900,btt
2024-04-08,3,800,266.67,1,1700,1700,-900,btt
2024-04-05,3,700,233.33,2,3300,1650,-2600,btt
2024-04-04,4,1700,425.0,2,1700,850,0,btt
2024-04-03,4,1700,425.0,2,1500,750,200,btt
2024-04-02,3,1400,466.67,2,2200,1100,-800,btt
2024-04-01,2,1200,600.0,2,2400,1200,-1200,btt
2024-03-29,3,1700,566.67,3,3500,1167,-1800,btt
2024-03-28,3,800,266.67,5,800,160,0,btt
2024-03-27,7,1100,157.14,6,2500,417,-1400,btt
2024-03-26,5,900,180.0,4,2500,625,-1600,btt
2024-03-25,1,100,100.0,5,2500,500,-2400,btt
2024-03-22,4,1000,250.0,3,2300,767,-1300,btt
2024-03-21,3,1300,433.33,4,2200,550,-900,btt
2024-03-20,6,2800,466.67,8,3400,425,-600,btt
2024-03-19,3,1700,566.67,4,2300,575,-600,btt
2024-03-18,7,2800,400.0,2,2800,1400,0,btt
2024-03-15,3,1300,433.33,3,2700,900,-1400,btt
2024-03-14,5,2400,480.0,5,2800,560,-400,btt
2024-03-13,10,3000,300.0,5,3100,620,-100,btt
2024-03-12,7,3600,514.29,2,1900,950,1700,btt
2024-03-11,5,2000,400.0,2,2200,1100,-200,btt
2024-03-08,4,1700,425.0,1,500,500,1200,btt
2024-03-07,4,1700,425.0,3,2800,933,-1100,btt
2024-03-06,4,2200,550.0,3,2200,733,0,btt
2024-03-05,4,2100,525.0,3,2300,767,-200,btt
2024-03-04,5,2400,480.0,4,2600,650,-200,btt
2024-03-01,8,5000,625.0,4,3300,825,1700,btt
2024-02-29,5,2400,480.0,4,3200,800,-800,btt
2024-02-28,4,2600,650.0,4,2900,725,-300,btt
2024-02-27,5,1800,360.0,3,2300,767,-500,btt
2024-02-26,6,2400,400.0,3,2300,767,100,btt
2024-02-23,5,2900,580.0,2,3200,1600,-300,btt
2024-02-22,8,4400,550.0,4,3000,750,1400,btt
2024-02-21,11,3600,327.27,8,3900,488,-300,btt
2024-02-20,10,3000,300.0,10,4800,480,-1800,btt
2024-02-19,3,1200,400.0,1,1800,1800,-600,btt
2024-02-16,4,1400,350.0,2,1900,950,-500,btt
2024-02-15,6,1900,316.67,2,1800,900,100,btt
2024-02-07,0,0,0.0,0,0,0,0,btt
2024-02-06,7,1800,257.14,4,2600,650,-800,btt
2024-02-05,6,1800,300.0,3,2000,667,-200,btt
2024-02-02,9,3500,388.89,8,3100,388,400,btt
2024-02-01,12,3900,325.0,2,2000,1000,1900,btt
2024-01-31,8,2300,287.5,1,200,200,2100,btt
2024-01-30,7,2600,371.43,1,1000,1000,1600,btt
2024-01-29,10,5500,550.0,0,0,0,5500,btt
2024-01-26,8,3100,387.5,1,1700,1700,1400,btt
2024-01-25,9,2800,311.11,1,1100,1100,1700,btt
2024-01-24,10,2900,290.0,1,1700,1700,1200,btt
2024-01-23,10,4300,430.0,2,1100,550,3200,btt
2024-01-22,12,5800,483.33,1,1700,1700,4100,btt
2024-01-19,10,3900,390.0,1,1700,1700,2200,btt
2024-01-18,7,2600,371.43,1,700,700,1900,btt
2024-01-17,10,2700,270.0,1,900,900,1800,btt
2024-01-16,13,3500,269.23,1,1100,1100,2400,btt
2024-01-15,17,7300,429.41,3,900,300,6400,btt
2024-01-12,8,3500,437.5,1,900,900,2600,btt
2024-01-11,17,5800,341.18,1,1000,1000,4800,btt
2024-01-10,0,0,0.0,0,0,0,0,btt
2024-01-09,14,6000,428.57,1,500,500,5500,btt
2024-01-08,16,7800,487.5,5,2000,400,5800,btt
2024-01-05,17,7300,429.41,10,2500,250,4800,btt
2024-01-04,16,8900,556.25,10,2300,230,6600,btt
2024-01-03,24,14500,604.17,11,9500,864,5000,btt
2024-01-02,14,7000,500.0,4,1500,375,5500,btt
2024-09-12,1,200,200.0,1,300,300,-100,btu
2024-09-11,1,200,200.0,2,400,200,-200,btu
2024-09-10,1,200,200.0,2,400,200,-200,btu
2024-09-09,1,200,200.0,3,600,200,-400,btu
2024-09-06,1,200,200.0,2,400,200,-200,btu
2024-09-05,1,200,200.0,1,300,300,-100,btu
2024-09-04,3,500,166.67,4,600,150,-100,btu
2024-08-30,3,1200,400.0,1,400,400,800,btu
2024-08-29,2,5100,2550.0,1,100,100,5000,btu
2024-08-28,3,200,66.67,3,400,133,-200,btu
2024-08-27,4,500,125.0,3,700,233,-200,btu
2024-08-26,1,100,100.0,3,2500,833,-2400,btu
2024-08-23,0,0,0.0,2,2500,1250,-2500,btu
2024-08-22,2,400,200.0,2,2600,1300,-2200,btu
2024-08-21,2,300,150.0,3,2900,967,-2600,btu
2024-08-20,1,200,200.0,2,2700,1350,-2500,btu
2024-08-19,0,0,0.0,2,2700,1350,-2700,btu
2024-08-16,0,0,0.0,2,2700,1350,-2700,btu
2024-08-15,0,0,0.0,2,2700,1350,-2700,btu
2024-08-14,0,0,0.0,2,2700,1350,-2700,btu
2024-08-13,1,100,100.0,2,2800,1400,-2700,btu
2024-08-12,0,0,0.0,1,800,800,-800,btu
2024-08-09,0,0,0.0,1,2000,2000,-2000,btu
2024-08-08,0,0,0.0,0,0,0,0,btu
2024-08-07,0,0,0.0,0,0,0,0,btu
2024-08-06,0,0,0.0,2,900,450,-900,btu
2024-08-05,0,0,0.0,1,0,0,0,btu
2024-08-02,0,0,0.0,3,1000,333,-1000,btu
2024-08-01,0,0,0.0,2,1100,550,-1100,btu
2024-07-31,1,100,100.0,2,1200,600,-1100,btu
2024-07-30,0,0,0.0,1,900,900,-900,btu
2024-07-29,1,100,100.0,1,1000,1000,-900,btu
2024-07-26,0,0,0.0,2,3000,1500,-3000,btu
2024-07-25,0,0,0.0,1,1000,1000,-1000,btu
2024-07-24,0,0,0.0,1,1000,1000,-1000,btu
2024-07-23,0,0,0.0,1,1000,1000,-1000,btu
2024-07-22,0,0,0.0,1,1000,1000,-1000,btu
2024-07-19,1,300,300.0,3,8000,2667,-7700,btu
2024-07-18,0,0,0.0,2,2800,1400,-2800,btu
2024-07-17,2,200,100.0,2,2000,1000,-1800,btu
2024-07-16,5,2400,480.0,2,5200,2600,-2800,btu
2024-07-15,2,100,50.0,2,5200,2600,-5100,btu
2024-07-12,2,3100,1550.0,0,0,0,3100,btu
2024-07-11,4,2000,500.0,1,700,700,1300,btu
2024-07-10,1,0,0.0,1,700,700,-700,btu
2024-07-09,1,0,0.0,1,700,700,-700,btu
2024-07-08,0,0,0.0,1,700,700,-700,btu
2024-07-05,3,200,66.67,2,800,400,-600,btu
2024-07-04,2,1200,600.0,6,4800,800,-3600,btu
2024-07-03,1,200,200.0,2,800,400,-600,btu
2024-07-02,1,200,200.0,1,100,100,100,btu
2024-07-01,2,10000,5000.0,1,100,100,9900,btu
2024-06-28,0,0,0.0,1,100,100,-100,btu
2024-06-27,5,7400,1480.0,5,2500,500,4900,btu
2024-06-26,1,100,100.0,3,900,300,-800,btu
2024-06-25,2,1800,900.0,5,1700,340,100,btu
2024-06-24,2,300,150.0,3,900,300,-600,btu
2024-06-21,1,400,400.0,2,800,400,-400,btu
2024-06-20,0,0,0.0,3,900,300,-900,btu
2024-06-19,0,0,0.0,2,800,400,-800,btu
2024-06-18,1,0,0.0,2,800,400,-800,btu
2024-06-17,0,0,0.0,1,100,100,-100,btu
2024-06-14,1,6000,6000.0,4,2900,725,3100,btu
2024-06-13,1,100,100.0,2,800,400,-700,btu
2024-06-12,0,0,0.0,2,200,100,-200,btu
2024-06-11,0,0,0.0,3,900,300,-900,btu
2024-06-10,1,100,100.0,1,100,100,0,btu
2024-06-07,1,2000,2000.0,2,800,400,1200,btu
2024-06-06,1,100,100.0,2,800,400,-700,btu
2024-06-05,1,100,100.0,3,900,300,-800,btu
2024-06-04,2,600,300.0,1,800,800,-200,btu
2024-06-03,1,100,100.0,2,900,450,-800,btu
2024-05-31,3,1200,400.0,3,4000,1333,-2800,btu
2024-05-30,1,300,300.0,1,900,900,-600,btu
2024-05-29,1,300,300.0,1,900,900,-600,btu
2024-05-28,4,50900,12725.0,1,900,900,50000,btu
2024-05-27,2,300,150.0,1,11900,11900,-11600,btu
2024-05-24,0,0,0.0,1,900,900,-900,btu
2024-05-23,0,0,0.0,1,900,900,-900,btu
2024-05-22,0,0,0.0,2,12800,6400,-12800,btu
2024-05-21,0,0,0.0,1,900,900,-900,btu
2024-05-20,0,0,0.0,1,900,900,-900,btu
2024-05-17,1,0,0.0,1,100,100,-100,btu
2024-05-16,0,0,0.0,1,900,900,-900,btu
2024-05-15,1,500,500.0,1,900,900,-400,btu
2024-05-14,0,0,0.0,1,900,900,-900,btu
2024-05-13,0,0,0.0,1,900,900,-900,btu
2024-05-10,0,0,0.0,1,900,900,-900,btu
2024-05-09,0,0,0.0,1,900,900,-900,btu
2024-05-08,0,0,0.0,1,900,900,-900,btu
2024-05-07,0,0,0.0,2,12800,6400,-12800,btu
2024-05-06,0,0,0.0,1,900,900,-900,btu
2024-05-03,0,0,0.0,1,900,900,-900,btu
2024-05-02,0,0,0.0,1,900,900,-900,btu
2024-04-26,0,0,0.0,1,100,100,-100,btu
2024-04-25,1,200,200.0,0,0,0,200,btu
2024-04-24,0,0,0.0,0,0,0,0,btu
2024-04-23,0,0,0.0,1,900,900,-900,btu
2024-04-22,0,0,0.0,1,11900,11900,-11900,btu
2024-04-19,0,0,0.0,1,400,400,-400,btu
2024-04-17,0,0,0.0,1,500,500,-500,btu
2024-04-16,0,0,0.0,1,900,900,-900,btu
2024-04-15,0,0,0.0,1,900,900,-900,btu
2024-04-12,3,800,266.67,2,1300,650,-500,btu
2024-04-11,1,500,500.0,3,1300,433,-800,btu
2024-04-10,1,500,500.0,2,500,250,0,btu
2024-04-09,1,100,100.0,1,900,900,-800,btu
2024-04-08,2,200,100.0,3,13200,4400,-13000,btu
2024-04-05,4,400,100.0,2,1000,500,-600,btu
2024-04-04,3,1200,400.0,1,3000,3000,-1800,btu
2024-04-03,5,1700,340.0,2,1000,500,700,btu
2024-04-02,0,0,0.0,1,100,100,-100,btu
2024-04-01,1,100,100.0,2,1300,650,-1200,btu
2024-03-29,0,0,0.0,2,1900,950,-1900,btu
2024-03-28,1,2000,2000.0,3,2400,800,-400,btu
2024-03-27,0,0,0.0,1,900,900,-900,btu
2024-03-26,0,0,0.0,2,1900,950,-1900,btu
2024-03-25,0,0,0.0,3,2400,800,-2400,btu
2024-03-22,0,0,0.0,2,200,100,-200,btu
2024-03-21,0,0,0.0,2,1300,650,-1300,btu
2024-03-20,0,0,0.0,2,1300,650,-1300,btu
2024-03-19,0,0,0.0,3,1800,600,-1800,btu
2024-03-18,0,0,0.0,3,13200,4400,-13200,btu
2024-03-15,0,0,0.0,2,1300,650,-1300,btu
2024-03-14,0,0,0.0,2,1300,650,-1300,btu
2024-03-13,0,0,0.0,3,1400,467,-1400,btu
2024-03-12,0,0,0.0,2,1300,650,-1300,btu
2024-03-11,0,0,0.0,2,1300,650,-1300,btu
2024-03-08,0,0,0.0,2,1300,650,-1300,btu
2024-03-07,0,0,0.0,2,1300,650,-1300,btu
2024-03-06,2,100,50.0,3,1400,467,-1300,btu
2024-03-05,2,1100,550.0,3,1800,600,-700,btu
2024-03-04,0,0,0.0,3,1400,467,-1400,btu
2024-03-01,0,0,0.0,2,1300,650,-1300,btu
2024-02-29,0,0,0.0,2,1300,650,-1300,btu
2024-02-28,1,0,0.0,4,1500,375,-1500,btu
2024-02-27,1,0,0.0,4,1900,475,-1900,btu
2024-02-26,1,100,100.0,2,500,250,-400,btu
2024-02-23,1,100,100.0,2,1400,700,-1300,btu
2024-02-22,1,200,200.0,2,1400,700,-1200,btu
2024-02-21,1,100,100.0,3,11100,3700,-11000,btu
2024-02-20,1,100,100.0,2,200,100,-100,btu
2024-02-19,1,200,200.0,3,1600,533,-1400,btu
2024-02-16,1,200,200.0,2,1100,550,-900,btu
2024-02-15,0,0,0.0,3,1600,533,-1600,btu
2024-02-07,0,0,0.0,2,1300,650,-1300,btu
2024-02-06,1,100,100.0,3,1300,433,-1200,btu
2024-02-05,0,0,0.0,4,1800,450,-1800,btu
2024-02-02,2,200,100.0,3,1900,633,-1700,btu
2024-02-01,0,0,0.0,1,400,400,-400,btu
2024-01-31,0,0,0.0,3,2100,700,-2100,btu
2024-01-30,1,100,100.0,2,1600,800,-1500,btu
2024-01-29,1,100,100.0,2,1600,800,-1500,btu
2024-01-26,1,100,100.0,2,5400,2700,-5300,btu
2024-01-25,1,100,100.0,3,2100,700,-2000,btu
2024-01-24,0,0,0.0,1,400,400,-400,btu
2024-01-23,0,0,0.0,1,400,400,-400,btu
2024-01-22,0,0,0.0,3,1000,333,-1000,btu
2024-01-19,0,0,0.0,1,500,500,-500,btu
2024-01-18,0,0,0.0,1,100,100,-100,btu
2024-01-17,5,2200,440.0,4,7100,1775,-4900,btu
2024-01-16,1,1000,1000.0,5,3800,760,-2800,btu
2024-01-15,0,0,0.0,3,2100,700,-2100,btu
2024-01-12,0,0,0.0,4,2200,550,-2200,btu
2024-01-11,0,0,0.0,5,2700,540,-2700,btu
2024-01-10,0,0,0.0,2,1600,800,-1600,btu
2024-01-09,0,0,0.0,4,3300,825,-3300,btu
2024-01-08,1,100,100.0,5,3800,760,-3700,btu
2024-01-05,0,0,0.0,5,3400,680,-3400,btu
2024-01-04,0,0,0.0,3,2800,933,-2800,btu
2024-01-03,0,0,0.0,3,2100,700,-2100,btu
2024-01-02,0,0,0.0,3,2500,833,-2500,btu
2024-09-12,2,200,100.0,6,2200,367,-2000,btv
2024-09-11,2,200,100.0,4,1000,250,-800,btv
2024-09-10,3,300,100.0,8,3200,400,-2900,btv
2024-09-09,2,200,100.0,5,2000,400,-1800,btv
2024-09-06,2,200,100.0,4,800,200,-600,btv
2024-09-05,1,100,100.0,1,300,300,-200,btv
2024-09-04,1,100,100.0,3,600,200,-500,btv
2024-08-30,2,1800,900.0,4,1700,425,100,btv
2024-08-29,2,1800,900.0,2,800,400,1000,btv
2024-08-28,2,200,100.0,3,1400,467,-1200,btv
2024-08-27,4,2000,500.0,3,600,200,1400,btv
2024-08-26,3,300,100.0,2,400,200,-100,btv
2024-08-23,3,400,133.33,4,1800,450,-1400,btv
2024-08-22,3,400,133.33,4,1500,375,-1100,btv
2024-08-21,1,100,100.0,2,600,300,-500,btv
2024-08-20,2,400,200.0,3,600,200,-200,btv
2024-08-19,2,300,150.0,5,1800,360,-1500,btv
2024-08-16,5,1500,300.0,5,1900,380,-400,btv
2024-08-15,3,600,200.0,2,400,200,200,btv
2024-08-14,4,700,175.0,5,1200,240,-500,btv
2024-08-13,1,200,200.0,5,2100,420,-1900,btv
2024-08-12,1,600,600.0,4,1100,275,-500,btv
2024-08-09,1,600,600.0,1,100,100,500,btv
2024-08-08,4,900,225.0,3,800,267,100,btv
2024-08-07,3,900,300.0,5,2000,400,-1100,btv
2024-08-06,2,700,350.0,4,1900,475,-1200,btv
2024-08-05,2,700,350.0,4,1800,450,-1100,btv
2024-08-02,4,300,75.0,6,1800,300,-1500,btv
2024-08-01,4,1000,250.0,4,1700,425,-700,btv
2024-07-31,3,900,300.0,4,800,200,100,btv
2024-07-30,3,900,300.0,6,1800,300,-900,btv
2024-07-29,7,2100,300.0,4,1500,375,600,btv
2024-07-26,4,2300,575.0,3,700,233,1600,btv
2024-07-25,3,1800,600.0,3,1000,333,800,btv
2024-07-24,4,1800,450.0,4,1200,300,600,btv
2024-07-23,4,1800,450.0,3,1400,467,400,btv
2024-07-22,5,1900,380.0,3,500,167,1400,btv
2024-07-19,6,2200,366.67,4,500,125,1700,btv
2024-07-18,3,2300,766.67,1,100,100,2200,btv
2024-07-17,5,3200,640.0,5,2000,400,1200,btv
2024-07-16,2,200,100.0,7,3100,443,-2900,btv
2024-07-15,3,1300,433.33,11,3900,355,-2600,btv
2024-07-12,16,6800,425.0,7,1600,229,5200,btv
2024-07-11,16,8100,506.25,8,3400,425,4700,btv
2024-07-10,10,6500,650.0,5,3600,720,2900,btv
2024-07-09,3,300,100.0,2,4400,2200,-4100,btv
2024-07-08,6,400,66.67,2,2800,1400,-2400,btv
2024-07-05,5,800,160.0,2,2800,1400,-2000,btv
2024-07-04,9,8200,911.11,2,1600,800,6600,btv
2024-07-03,5,3500,700.0,3,1700,567,1800,btv
2024-07-02,3,300,100.0,4,3700,925,-3400,btv
2024-07-01,7,20500,2928.57,11,20600,1873,-100,btv
2024-06-28,2,600,300.0,3,3400,1133,-2800,btv
2024-06-27,2,100,50.0,4,3700,925,-3600,btv
2024-06-26,2,200,100.0,6,7100,1183,-6900,btv
2024-06-25,1,100,100.0,4,6100,1525,-6000,btv
2024-06-24,2,200,100.0,6,7300,1217,-7100,btv
2024-06-21,2,600,300.0,6,4400,733,-3800,btv
2024-06-20,1,100,100.0,4,5000,1250,-4900,btv
2024-06-19,1,100,100.0,3,2500,833,-2400,btv
2024-06-18,1,100,100.0,3,4800,1600,-4700,btv
2024-06-17,1,100,100.0,2,1700,850,-1600,btv
2024-06-14,2,200,100.0,3,2500,833,-2300,btv
2024-06-13,1,100,100.0,2,2200,1100,-2100,btv
2024-06-12,3,300,100.0,4,3700,925,-3400,btv
2024-06-11,1,100,100.0,2,1700,850,-1600,btv
2024-06-10,3,300,100.0,2,1700,850,-1400,btv
2024-06-07,0,0,0.0,3,2700,900,-2700,btv
2024-06-06,2,600,300.0,3,1900,633,-1300,btv
2024-06-05,2,200,100.0,2,2200,1100,-2000,btv
2024-06-04,3,700,233.33,4,4400,1100,-3700,btv
2024-06-03,2,600,300.0,4,4400,1100,-3800,btv
2024-05-31,2,200,100.0,2,1700,850,-1500,btv
2024-05-30,4,1100,275.0,3,1800,600,-700,btv
2024-05-29,4,600,150.0,3,1800,600,-1200,btv
2024-05-28,2,200,100.0,2,1800,900,-1600,btv
2024-05-27,1,100,100.0,3,400,133,-300,btv
2024-05-24,2,200,100.0,2,1700,850,-1500,btv
2024-05-23,2,1200,600.0,2,800,400,400,btv
2024-05-22,2,600,300.0,5,1900,380,-1300,btv
2024-05-21,2,700,350.0,2,1600,800,-900,btv
2024-05-20,2,600,300.0,2,300,150,300,btv
2024-05-17,2,1700,850.0,2,1600,800,100,btv
2024-05-16,1,2000,2000.0,7,2300,329,-300,btv
2024-05-15,1,0,0.0,4,1900,475,-1900,btv
2024-05-14,3,400,133.33,4,1800,450,-1400,btv
2024-05-13,2,200,100.0,3,1900,633,-1700,btv
2024-05-10,1,100,100.0,3,1800,600,-1700,btv
2024-05-09,1,100,100.0,2,1600,800,-1500,btv
2024-05-08,1,100,100.0,3,500,167,-400,btv
2024-05-07,1,100,100.0,2,1600,800,-1500,btv
2024-05-06,2,200,100.0,4,2000,500,-1800,btv
2024-05-03,2,200,100.0,2,1600,800,-1400,btv
2024-05-02,1,100,100.0,4,2000,500,-1900,btv
2024-04-26,3,300,100.0,3,1700,567,-1400,btv
2024-04-25,2,200,100.0,3,700,233,-500,btv
2024-04-24,2,200,100.0,1,100,100,100,btv
2024-04-23,1,100,100.0,2,200,100,-100,btv
2024-04-22,1,100,100.0,1,100,100,0,btv
2024-04-19,1,100,100.0,1,100,100,0,btv
2024-04-17,1,100,100.0,1,100,100,0,btv
2024-04-16,1,100,100.0,1,100,100,0,btv
2024-04-15,3,200,66.67,1,100,100,100,btv
2024-04-12,4,300,75.0,1,100,100,200,btv
2024-04-11,2,200,100.0,1,100,100,100,btv
2024-04-10,3,200,66.67,1,100,100,100,btv
2024-04-09,2,200,100.0,2,200,100,0,btv
2024-04-08,1,100,100.0,1,100,100,0,btv
2024-04-05,4,700,175.0,2,500,250,200,btv
2024-04-04,6,1200,200.0,2,200,100,1000,btv
2024-04-03,3,800,266.67,1,100,100,700,btv
2024-04-02,4,900,225.0,2,200,100,700,btv
2024-04-01,2,200,100.0,1,100,100,100,btv
2024-03-29,2,600,300.0,1,100,100,500,btv
2024-03-28,2,1100,550.0,1,100,100,1000,btv
2024-03-27,2,700,350.0,1,100,100,600,btv
2024-03-26,4,9100,2275.0,1,100,100,9000,btv
2024-03-25,2,1100,550.0,0,0,0,1100,btv
2024-03-22,4,200,50.0,0,0,0,200,btv
2024-03-21,4,3300,825.0,4,2200,550,1100,btv
2024-03-20,6,1400,233.33,3,3000,1000,-1600,btv
2024-03-19,2,100,50.0,2,1700,850,-1600,btv
2024-03-18,4,400,100.0,7,2400,343,-2000,btv
2024-03-15,2,100,50.0,7,2700,386,-2600,btv
2024-03-14,5,9200,1840.0,8,11300,1412,-2100,btv
2024-03-13,1,100,100.0,5,10900,2180,-10800,btv
2024-03-12,1,100,100.0,3,3500,1167,-3400,btv
2024-03-11,1,100,100.0,5,9900,1980,-9800,btv
2024-03-08,2,600,300.0,5,3100,620,-2500,btv
2024-03-07,2,2100,1050.0,5,2900,580,-800,btv
2024-03-06,4,1500,375.0,4,4500,1125,-3000,btv
2024-03-05,4,1400,350.0,3,2000,667,-600,btv
2024-03-04,3,2200,733.33,3,2200,733,0,btv
2024-03-01,2,200,100.0,2,1800,900,-1600,btv
2024-02-29,1,100,100.0,2,1700,850,-1600,btv
2024-02-28,3,300,100.0,2,1700,850,-1400,btv
2024-02-27,3,2200,733.33,5,3900,780,-1700,btv
2024-02-26,4,900,225.0,11,5200,473,-4300,btv
2024-02-23,7,1200,171.43,5,3600,720,-2400,btv
2024-02-22,1,100,100.0,5,1100,220,-1000,btv
2024-02-21,2,300,150.0,4,3600,900,-3300,btv
2024-02-20,1,100,100.0,4,4300,1075,-4200,btv
2024-02-19,7,2500,357.14,12,7900,658,-5400,btv
2024-02-16,3,500,166.67,6,3900,650,-3400,btv
2024-02-15,2,200,100.0,2,2500,1250,-2300,btv
2024-02-07,2,400,200.0,6,2800,467,-2400,btv
2024-02-06,3,500,166.67,6,4200,700,-3700,btv
2024-02-05,2,900,450.0,8,4600,575,-3700,btv
2024-02-02,6,3400,566.67,6,4800,800,-1400,btv
2024-02-01,7,4200,600.0,11,8000,727,-3800,btv
2024-01-31,5,12400,2480.0,7,6000,857,6400,btv
2024-01-30,4,1400,350.0,6,6400,1067,-5000,btv
2024-01-29,5,900,180.0,8,7200,900,-6300,btv
2024-01-26,1,100,100.0,5,5900,1180,-5800,btv
2024-01-25,2,1000,500.0,7,7400,1057,-6400,btv
2024-01-24,5,800,160.0,6,7200,1200,-6400,btv
2024-01-23,3,1200,400.0,4,5300,1325,-4100,btv
2024-01-22,2,700,350.0,6,5500,917,-4800,btv
2024-01-19,3,1700,566.67,6,4600,767,-2900,btv
2024-01-18,2,1200,600.0,6,5500,917,-4300,btv
2024-01-17,3,7100,2366.67,4,4500,1125,2600,btv
2024-01-16,3,1200,400.0,4,4800,1200,-3600,btv
2024-01-15,4,2700,675.0,5,5000,1000,-2300,btv
2024-01-12,5,2500,500.0,7,6800,971,-4300,btv
2024-01-11,9,4000,444.44,9,4600,511,-600,btv
2024-01-10,5,2000,400.0,7,2100,300,-100,btv
2024-01-09,10,5000,500.0,13,8900,685,-3900,btv
2024-01-08,1,1000,1000.0,3,800,267,200,btv
2024-01-05,1,100,100.0,9,6400,711,-6300,btv
2024-01-04,1,100,100.0,6,8200,1367,-8100,btv
2024-01-03,1,100,100.0,7,3500,500,-3400,btv
2024-01-02,2,200,100.0,6,5500,917,-5300,btv
2024-09-12,1,500,500.0,3,700,233,-200,btw
2024-09-11,4,100,25.0,6,1000,167,-900,btw
2024-09-10,8,3300,412.5,15,3100,207,200,btw
2024-09-09,2,700,350.0,9,1900,211,-1200,btw
2024-09-06,6,5300,883.33,11,4300,391,1000,btw
2024-09-05,16,15100,943.75,16,5800,362,9300,btw
2024-09-04,2,200,100.0,8,4000,500,-3800,btw
2024-08-30,7,3700,528.57,10,6100,610,-2400,btw
2024-08-29,12,1400,116.67,6,3900,650,-2500,btw
2024-08-28,16,8300,518.75,6,1300,217,7000,btw
2024-08-27,6,3900,650.0,1,200,200,3700,btw
2024-08-26,8,5100,637.5,3,3200,1067,1900,btw
2024-08-23,14,8100,578.57,2,3100,1550,5000,btw
2024-08-22,10,8300,830.0,1,100,100,8200,btw
2024-08-21,9,6000,666.67,2,3100,1550,2900,btw
2024-08-20,9,13400,1488.89,2,3100,1550,10300,btw
2024-08-19,9,13800,1533.33,1,100,100,13700,btw
2024-08-16,7,10700,1528.57,2,400,200,10300,btw
2024-08-15,6,11100,1850.0,1,100,100,11000,btw
2024-08-14,5,10100,2020.0,1,100,100,10000,btw
2024-08-13,8,10300,1287.5,1,100,100,10200,btw
2024-08-12,8,10500,1312.5,1,100,100,10400,btw
2024-08-09,6,7200,1200.0,1,100,100,7100,btw
2024-08-08,6,7200,1200.0,1,100,100,7100,btw
2024-08-07,7,7400,1057.14,1,100,100,7300,btw
2024-08-06,6,7400,1233.33,2,200,100,7200,btw
2024-08-05,8,6300,787.5,1,100,100,6200,btw
2024-08-02,7,6000,857.14,1,100,100,5900,btw
2024-08-01,9,8400,933.33,1,100,100,8300,btw
2024-07-31,8,8100,1012.5,2,200,100,7900,btw
2024-07-30,7,7200,1028.57,1,100,100,7100,btw
2024-07-29,9,7300,811.11,1,100,100,7200,btw
2024-07-26,6,5800,966.67,1,100,100,5700,btw
2024-07-25,3,600,200.0,2,300,150,300,btw
2024-07-24,9,5500,611.11,3,600,200,4900,btw
2024-07-23,6,5200,866.67,1,200,200,5000,btw
2024-07-22,12,10800,900.0,4,1200,300,9600,btw
2024-07-19,12,27900,2325.0,3,3100,1033,24800,btw
2024-07-18,5,300,60.0,3,3200,1067,-2900,btw
2024-07-17,8,7000,875.0,2,200,100,6800,btw
2024-07-16,5,7100,1420.0,1,100,100,7000,btw
2024-07-15,4,6600,1650.0,1,100,100,6500,btw
2024-07-12,6,6900,1150.0,1,100,100,6800,btw
2024-07-11,4,3800,950.0,1,200,200,3600,btw
2024-07-10,4,3700,925.0,2,3100,1550,600,btw
2024-07-09,5,3800,760.0,1,100,100,3700,btw
2024-07-08,6,4000,666.67,1,100,100,3900,btw
2024-07-05,5,3900,780.0,1,100,100,3800,btw
2024-07-04,6,11100,1850.0,1,100,100,11000,btw
2024-07-03,5,10800,2160.0,2,3100,1550,7700,btw
2024-07-02,6,20900,3483.33,1,100,100,20800,btw
2024-07-01,6,20900,3483.33,1,100,100,20800,btw
2024-06-28,6,20800,3466.67,2,200,100,20600,btw
2024-06-27,5,500,100.0,2,200,100,300,btw
2024-06-26,8,21100,2637.5,2,300,150,20800,btw
2024-06-25,5,20800,4160.0,1,100,100,20700,btw
2024-06-24,3,900,300.0,2,200,100,700,btw
2024-06-21,5,20400,4080.0,3,600,200,19800,btw
2024-06-20,3,20200,6733.33,1,200,200,20000,btw
2024-06-19,3,20300,6766.67,1,200,200,20100,btw
2024-06-18,4,20300,5075.0,2,300,150,20000,btw
2024-06-17,6,20400,3400.0,1,200,200,20200,btw
2024-06-14,4,20300,5075.0,1,200,200,20100,btw
2024-06-13,6,20500,3416.67,2,400,200,20100,btw
2024-06-12,3,20200,6733.33,2,400,200,19800,btw
2024-06-11,4,20400,5100.0,1,200,200,20200,btw
2024-06-10,11,27500,2500.0,3,4800,1600,22700,btw
2024-06-07,5,22200,4440.0,1,200,200,22000,btw
2024-06-06,6,22300,3716.67,2,300,150,22000,btw
2024-06-05,7,31700,4528.57,2,4700,2350,27000,btw
2024-06-04,5,26500,5300.0,1,200,200,26300,btw
2024-06-03,8,29800,3725.0,1,200,200,29600,btw
2024-05-31,7,27400,3914.29,4,800,200,26600,btw
2024-05-30,6,35300,5883.33,3,400,133,34900,btw
2024-05-29,9,47400,5266.67,3,400,133,47000,btw
2024-05-28,9,39400,4377.78,2,300,150,39100,btw
2024-05-27,5,37200,7440.0,2,200,100,37000,btw
2024-05-24,6,37200,6200.0,2,300,150,36900,btw
2024-05-23,5,37200,7440.0,2,300,150,36900,btw
2024-05-22,4,37100,9275.0,2,400,200,36700,btw
2024-05-21,6,37300,6216.67,2,300,150,37000,btw
2024-05-20,4,37200,9300.0,2,200,100,37000,btw
2024-05-17,10,37400,3740.0,9,1300,144,36100,btw
2024-05-16,12,35200,2933.33,3,300,100,34900,btw
2024-05-15,11,39400,3581.82,3,1100,367,38300,btw
2024-05-14,11,40100,3645.45,3,1100,367,39000,btw
2024-05-13,8,39500,4937.5,1,100,100,39400,btw
2024-05-10,8,39300,4912.5,0,0,0,39300,btw
2024-05-09,16,42800,2675.0,2,1100,550,41700,btw
2024-05-08,8,40800,5100.0,2,300,150,40500,btw
2024-05-07,7,38800,5542.86,0,0,0,38800,btw
2024-05-06,9,38300,4255.56,1,100,100,38200,btw
2024-05-03,7,37700,5385.71,0,0,0,37700,btw
2024-05-02,8,38000,4750.0,1,100,100,37900,btw
2024-04-26,7,38200,5457.14,1,100,100,38100,btw
2024-04-25,6,37300,6216.67,1,100,100,37200,btw
2024-04-24,8,37800,4725.0,0,0,0,37800,btw
2024-04-23,7,37600,5371.43,1,100,100,37500,btw
2024-04-22,7,37700,5385.71,0,0,0,37700,btw
2024-04-19,3,500,166.67,3,500,167,0,btw
2024-04-17,2,300,150.0,3,100,33,200,btw
2024-04-16,8,37600,4700.0,4,300,75,37300,btw
2024-04-15,7,37000,5285.71,4,300,75,36700,btw
2024-04-12,8,38000,4750.0,4,300,75,37700,btw
2024-04-11,7,38200,5457.14,4,400,100,37800,btw
2024-04-10,4,37200,9300.0,2,200,100,37000,btw
2024-04-09,9,37700,4188.89,3,200,67,37500,btw
2024-04-08,6,39400,6566.67,2,200,100,39200,btw
2024-04-05,10,39300,3930.0,2,200,100,39100,btw
2024-04-04,13,41100,3161.54,3,300,100,40800,btw
2024-04-03,7,38300,5471.43,2,200,100,38100,btw
2024-04-02,6,2300,383.33,6,400,67,1900,btw
2024-04-01,7,40000,5714.29,7,3000,429,37000,btw
2024-03-29,6,37300,6216.67,5,1200,240,36100,btw
2024-03-28,10,39700,3970.0,1,300,300,39400,btw
2024-03-27,6,38700,6450.0,0,0,0,38700,btw
2024-03-26,6,39200,6533.33,2,1000,500,38200,btw
2024-03-25,5,36100,7220.0,2,1100,550,35000,btw
2024-03-22,4,35800,8950.0,1,100,100,35700,btw
2024-03-21,4,35500,8875.0,1,100,100,35400,btw
2024-03-20,3,35600,11866.67,0,0,0,35600,btw
2024-03-19,3,35600,11866.67,1,100,100,35500,btw
2024-03-18,3,35600,11866.67,1,100,100,35500,btw
2024-03-15,3,35600,11866.67,0,0,0,35600,btw
2024-03-14,3,35600,11866.67,0,0,0,35600,btw
2024-03-13,4,35700,8925.0,1,5000,5000,30700,btw
2024-03-12,2,35500,17750.0,0,0,0,35500,btw
2024-03-11,3,1300,433.33,0,0,0,1300,btw
2024-03-08,1,500,500.0,0,0,0,500,btw
2024-03-07,2,600,300.0,0,0,0,600,btw
2024-03-06,2,600,300.0,0,0,0,600,btw
2024-03-05,1,500,500.0,0,0,0,500,btw
2024-03-04,2,600,300.0,0,0,0,600,btw
2024-03-01,1,500,500.0,0,0,0,500,btw
2024-02-29,1,500,500.0,0,0,0,500,btw
2024-02-28,1,500,500.0,0,0,0,500,btw
2024-02-27,3,700,233.33,0,0,0,700,btw
2024-02-26,2,500,250.0,0,0,0,500,btw
2024-02-23,2,600,300.0,0,0,0,600,btw
2024-02-22,2,600,300.0,0,0,0,600,btw
2024-02-21,2,600,300.0,0,0,0,600,btw
2024-02-20,2,1500,750.0,0,0,0,1500,btw
2024-02-19,2,600,300.0,0,0,0,600,btw
2024-02-16,2,600,300.0,0,0,0,600,btw
2024-02-15,2,500,250.0,0,0,0,500,btw
2024-02-07,3,600,200.0,0,0,0,600,btw
2024-02-06,2,500,250.0,0,0,0,500,btw
2024-02-05,3,600,200.0,0,0,0,600,btw
2024-02-02,3,600,200.0,0,0,0,600,btw
2024-02-01,3,600,200.0,0,0,0,600,btw
2024-01-31,4,800,200.0,0,0,0,800,btw
2024-01-30,3,600,200.0,0,0,0,600,btw
2024-01-29,3,600,200.0,0,0,0,600,btw
2024-01-26,3,600,200.0,0,0,0,600,btw
2024-01-25,2,600,300.0,0,0,0,600,btw
2024-01-24,3,600,200.0,0,0,0,600,btw
2024-01-23,3,700,233.33,0,0,0,700,btw
2024-01-22,6,600,100.0,0,0,0,600,btw
2024-01-19,6,1000,166.67,0,0,0,1000,btw
2024-01-18,7,1000,142.86,1,200,200,800,btw
2024-01-17,5,600,120.0,0,0,0,600,btw
2024-01-16,9,20600,2288.89,2,10000,5000,10600,btw
2024-01-15,4,5500,1375.0,0,0,0,5500,btw
2024-01-12,6,5500,916.67,0,0,0,5500,btw
2024-01-11,9,6800,755.56,0,0,0,6800,btw
2024-01-10,7,6000,857.14,0,0,0,6000,btw
2024-01-09,6,5800,966.67,0,0,0,5800,btw
2024-01-08,4,5700,1425.0,0,0,0,5700,btw
2024-01-05,5,5800,1160.0,0,0,0,5800,btw
2024-01-04,4,5700,1425.0,0,0,0,5700,btw
2024-01-03,6,5900,983.33,1,200,200,5700,btw
2024-01-02,6,6000,1000.0,0,0,0,6000,btw
2024-09-12,0,0,0.0,0,0,0,0,bvg
2024-09-11,0,0,0.0,0,0,0,0,bvg
2024-09-10,0,0,0.0,0,0,0,0,bvg
2024-09-09,0,0,0.0,0,0,0,0,bvg
2024-09-06,8,52800,6600.0,25,60900,2436,-8100,bvg
2024-09-05,0,0,0.0,0,0,0,0,bvg
2024-09-04,0,0,0.0,0,0,0,0,bvg
2024-08-30,20,64800,3240.0,40,105500,2638,-40700,bvg
2024-08-29,0,0,0.0,0,0,0,0,bvg
2024-08-28,0,0,0.0,0,0,0,0,bvg
2024-08-27,0,0,0.0,0,0,0,0,bvg
2024-08-26,0,0,0.0,0,0,0,0,bvg
2024-08-23,27,104600,3874.07,30,56200,1873,48400,bvg
2024-08-22,0,0,0.0,0,0,0,0,bvg
2024-08-21,0,0,0.0,0,0,0,0,bvg
2024-08-20,0,0,0.0,0,0,0,0,bvg
2024-08-19,0,0,0.0,0,0,0,0,bvg
2024-08-16,23,114100,4960.87,21,44000,2095,70100,bvg
2024-08-15,0,0,0.0,0,0,0,0,bvg
2024-08-14,0,0,0.0,0,0,0,0,bvg
2024-08-13,0,0,0.0,0,0,0,0,bvg
2024-08-12,0,0,0.0,0,0,0,0,bvg
2024-08-09,27,70900,2625.93,29,68900,2376,2000,bvg
2024-08-08,0,0,0.0,0,0,0,0,bvg
2024-08-07,0,0,0.0,0,0,0,0,bvg
2024-08-06,0,0,0.0,0,0,0,0,bvg
2024-08-05,0,0,0.0,0,0,0,0,bvg
2024-08-02,23,73100,3178.26,30,138800,4627,-65700,bvg
2024-08-01,0,0,0.0,0,0,0,0,bvg
2024-07-31,0,0,0.0,0,0,0,0,bvg
2024-07-30,0,0,0.0,0,0,0,0,bvg
2024-07-29,0,0,0.0,0,0,0,0,bvg
2024-07-26,20,61300,3065.0,34,122700,3609,-61400,bvg
2024-07-25,0,0,0.0,0,0,0,0,bvg
2024-07-24,0,0,0.0,0,0,0,0,bvg
2024-07-23,0,0,0.0,0,0,0,0,bvg
2024-07-22,0,0,0.0,0,0,0,0,bvg
2024-07-19,17,108400,6376.47,27,115000,4259,-6600,bvg
2024-07-18,0,0,0.0,0,0,0,0,bvg
2024-07-17,0,0,0.0,0,0,0,0,bvg
2024-07-16,0,0,0.0,0,0,0,0,bvg
2024-07-15,0,0,0.0,0,0,0,0,bvg
2024-07-12,30,224800,7493.33,47,163200,3472,61600,bvg
2024-07-11,0,0,0.0,0,0,0,0,bvg
2024-07-10,0,0,0.0,0,0,0,0,bvg
2024-07-09,0,0,0.0,0,0,0,0,bvg
2024-07-08,0,0,0.0,0,0,0,0,bvg
2024-07-05,26,114800,4415.38,52,140400,2700,-25600,bvg
2024-07-04,0,0,0.0,0,0,0,0,bvg
2024-07-03,0,0,0.0,0,0,0,0,bvg
2024-07-02,0,0,0.0,0,0,0,0,bvg
2024-07-01,0,0,0.0,0,0,0,0,bvg
2024-06-28,22,162800,7400.0,44,224000,5091,-61200,bvg
2024-06-27,0,0,0.0,0,0,0,0,bvg
2024-06-26,0,0,0.0,0,0,0,0,bvg
2024-06-25,0,0,0.0,0,0,0,0,bvg
2024-06-24,0,0,0.0,0,0,0,0,bvg
2024-06-21,27,324700,12025.93,81,311400,3844,13300,bvg
2024-06-20,0,0,0.0,0,0,0,0,bvg
2024-06-19,0,0,0.0,0,0,0,0,bvg
2024-06-18,0,0,0.0,0,0,0,0,bvg
2024-06-17,0,0,0.0,0,0,0,0,bvg
2024-06-14,30,305800,10193.33,77,353100,4586,-47300,bvg
2024-06-13,0,0,0.0,0,0,0,0,bvg
2024-06-12,0,0,0.0,0,0,0,0,bvg
2024-06-11,0,0,0.0,0,0,0,0,bvg
2024-06-10,0,0,0.0,0,0,0,0,bvg
2024-06-07,31,227800,7348.39,75,220100,2935,7700,bvg
2024-06-06,0,0,0.0,0,0,0,0,bvg
2024-06-05,0,0,0.0,0,0,0,0,bvg
2024-06-04,0,0,0.0,0,0,0,0,bvg
2024-06-03,0,0,0.0,0,0,0,0,bvg
2024-05-31,21,254200,12104.76,98,326800,3335,-72600,bvg
2024-05-30,0,0,0.0,0,0,0,0,bvg
2024-05-29,0,0,0.0,0,0,0,0,bvg
2024-05-28,0,0,0.0,0,0,0,0,bvg
2024-05-27,0,0,0.0,0,0,0,0,bvg
2024-05-24,49,319200,6514.29,114,565000,4956,-245800,bvg
2024-05-23,0,0,0.0,0,0,0,0,bvg
2024-05-22,0,0,0.0,0,0,0,0,bvg
2024-05-21,0,0,0.0,0,0,0,0,bvg
2024-05-20,0,0,0.0,0,0,0,0,bvg
2024-05-17,127,332500,2618.11,133,274900,2067,57600,bvg
2024-05-16,0,0,0.0,0,0,0,0,bvg
2024-05-15,0,0,0.0,0,0,0,0,bvg
2024-05-14,0,0,0.0,0,0,0,0,bvg
2024-05-13,0,0,0.0,0,0,0,0,bvg
2024-05-10,90,442600,4917.78,71,157100,2213,285500,bvg
2024-05-09,0,0,0.0,0,0,0,0,bvg
2024-05-08,0,0,0.0,0,0,0,0,bvg
2024-05-07,0,0,0.0,0,0,0,0,bvg
2024-05-06,0,0,0.0,0,0,0,0,bvg
2024-05-03,76,257800,3392.11,71,151000,2127,106800,bvg
2024-05-02,0,0,0.0,0,0,0,0,bvg
2024-04-26,98,225300,2298.98,86,355900,4138,-130600,bvg
2024-04-25,0,0,0.0,0,0,0,0,bvg
2024-04-24,0,0,0.0,0,0,0,0,bvg
2024-04-23,0,0,0.0,0,0,0,0,bvg
2024-04-22,0,0,0.0,0,0,0,0,bvg
2024-04-19,85,346600,4077.65,86,726400,8447,-379800,bvg
2024-04-17,0,0,0.0,0,0,0,0,bvg
2024-04-16,0,0,0.0,0,0,0,0,bvg
2024-04-15,0,0,0.0,0,0,0,0,bvg
2024-04-12,185,529200,2860.54,147,825600,5616,-296400,bvg
2024-04-11,0,0,0.0,0,0,0,0,bvg
2024-04-10,0,0,0.0,0,0,0,0,bvg
2024-04-09,226,789000,3491.15,72,753300,10462,35700,bvg
2024-04-08,270,512500,1898.15,87,916100,10530,-403600,bvg
2024-04-05,136,228300,1678.68,72,434800,6039,-206500,bvg
2024-04-04,71,94700,1333.8,46,134800,2930,-40100,bvg
2024-04-03,58,104100,1794.83,48,217700,4535,-113600,bvg
2024-04-02,51,84600,1658.82,50,150100,3002,-65500,bvg
2024-04-01,75,131800,1757.33,59,293000,4966,-161200,bvg
2024-03-29,44,91600,2081.82,60,220500,3675,-128900,bvg
2024-03-28,45,69900,1553.33,53,185200,3494,-115300,bvg
2024-03-27,55,99200,1803.64,57,200100,3511,-100900,bvg
2024-03-26,50,94100,1882.0,60,142700,2378,-48600,bvg
2024-03-25,44,68200,1550.0,40,128700,3218,-60500,bvg
2024-03-22,43,89200,2074.42,53,159400,3008,-70200,bvg
2024-03-21,48,107200,2233.33,74,228600,3089,-121400,bvg
2024-03-20,50,116400,2328.0,46,203100,4415,-86700,bvg
2024-03-19,51,80300,1574.51,56,185600,3314,-105300,bvg
2024-03-18,64,105100,1642.19,69,220400,3194,-115300,bvg
2024-03-15,85,285900,3363.53,95,308600,3248,-22700,bvg
2024-03-14,56,115000,2053.57,66,233900,3544,-118900,bvg
2024-03-13,74,163400,2208.11,74,223600,3022,-60200,bvg
2024-03-12,51,95900,1880.39,65,183200,2818,-87300,bvg
2024-03-11,60,71100,1185.0,88,198600,2257,-127500,bvg
2024-03-08,64,84700,1323.44,78,163100,2091,-78400,bvg
2024-03-07,96,142100,1480.21,116,272800,2352,-130700,bvg
2024-03-06,48,76800,1600.0,82,186600,2276,-109800,bvg
2024-03-05,58,66600,1148.28,60,123600,2060,-57000,bvg
2024-03-04,87,104300,1198.85,69,236200,3423,-131900,bvg
2024-03-01,88,290600,3302.27,106,315000,2972,-24400,bvg
2024-02-29,68,119000,1750.0,79,202400,2562,-83400,bvg
2024-02-28,50,159000,3180.0,68,154400,2271,4600,bvg
2024-02-27,65,111100,1709.23,45,135200,3004,-24100,bvg
2024-02-26,66,76900,1165.15,42,152200,3624,-75300,bvg
2024-02-23,55,69300,1260.0,74,218800,2957,-149500,bvg
2024-02-22,67,123400,1841.79,65,197300,3035,-73900,bvg
2024-02-21,49,66900,1365.31,55,152200,2767,-85300,bvg
2024-02-20,51,72500,1421.57,53,121900,2300,-49400,bvg
2024-02-19,60,85900,1431.67,58,166100,2864,-80200,bvg
2024-02-16,77,114300,1484.42,56,133600,2386,-19300,bvg
2024-02-15,48,77500,1614.58,37,101200,2735,-23700,bvg
2024-02-07,35,71600,2045.71,40,47800,1195,23800,bvg
2024-02-06,39,34400,882.05,37,54900,1484,-20500,bvg
2024-02-05,50,67600,1352.0,48,132200,2754,-64600,bvg
2024-02-02,50,86700,1734.0,51,111600,2188,-24900,bvg
2024-02-01,51,75300,1476.47,35,83400,2383,-8100,bvg
2024-01-31,52,65700,1263.46,53,146700,2768,-81000,bvg
2024-01-30,34,55100,1620.59,51,128300,2516,-73200,bvg
2024-01-29,47,111900,2380.85,45,116700,2593,-4800,bvg
2024-01-26,34,48700,1432.35,52,163900,3152,-115200,bvg
2024-01-25,34,47000,1382.35,38,136800,3600,-89800,bvg
2024-01-24,47,75900,1614.89,60,142700,2378,-66800,bvg
2024-01-23,37,54400,1470.27,64,148000,2312,-93600,bvg
2024-01-22,50,54000,1080.0,57,152000,2667,-98000,bvg
2024-01-19,43,96000,2232.56,55,193800,3524,-97800,bvg
2024-01-18,40,73400,1835.0,44,102700,2334,-29300,bvg
2024-01-17,43,107400,2497.67,69,202700,2938,-95300,bvg
2024-01-16,51,188900,3703.92,54,157600,2919,31300,bvg
2024-01-15,30,84200,2806.67,46,104700,2276,-20500,bvg
2024-01-12,44,97100,2206.82,64,169400,2647,-72300,bvg
2024-01-11,60,157600,2626.67,56,161400,2882,-3800,bvg
2024-01-10,43,62200,1446.51,49,137200,2800,-75000,bvg
2024-01-09,39,118800,3046.15,54,163900,3035,-45100,bvg
2024-01-08,47,71700,1525.53,47,116300,2474,-44600,bvg
2024-01-05,34,78600,2311.76,45,128100,2847,-49500,bvg
2024-01-04,64,94900,1482.81,59,211700,3588,-116800,bvg
2024-01-03,53,83600,1577.36,47,168000,3574,-84400,bvg
2024-01-02,62,103100,1662.9,57,219500,3851,-116400,bvg
2024-09-12,699,782600,1119.6,598,920400,1539,-137800,bvh
2024-09-11,900,894100,993.44,496,795900,1605,98200,bvh
2024-09-10,1397,2156900,1543.95,1206,1975500,1638,181400,bvh
2024-09-09,1017,1172200,1152.61,743,1094500,1473,77700,bvh
2024-09-06,575,822900,1431.13,726,1093400,1506,-270500,bvh
2024-09-05,541,998000,1844.73,655,879300,1342,118700,bvh
2024-09-04,761,1148300,1508.94,766,1124200,1468,24100,bvh
2024-08-30,624,671200,1075.64,674,632500,938,38700,bvh
2024-08-29,569,841400,1478.73,739,1140000,1543,-298600,bvh
2024-08-28,764,981800,1285.08,770,1068000,1387,-86200,bvh
2024-08-27,831,1275600,1535.02,764,1142200,1495,133400,bvh
2024-08-26,874,1226200,1402.97,1014,1633700,1611,-407500,bvh
2024-08-23,1651,3438200,2082.5,2287,3165900,1384,272300,bvh
2024-08-22,1115,1761600,1579.91,1150,1674200,1456,87400,bvh
2024-08-21,743,1054900,1419.78,961,1183700,1232,-128800,bvh
2024-08-20,1141,2207100,1934.36,1047,1952600,1865,254500,bvh
2024-08-19,1078,1981200,1837.85,1280,1723100,1346,258100,bvh
2024-08-16,1088,2108200,1937.68,984,1462600,1486,645600,bvh
2024-08-15,564,673600,1194.33,737,822100,1115,-148500,bvh
2024-08-14,708,1153900,1629.8,728,889900,1222,264000,bvh
2024-08-13,788,917500,1164.34,752,1403000,1866,-485500,bvh
2024-08-12,639,764100,1195.77,669,702800,1051,61300,bvh
2024-08-08,576,914300,1587.33,643,848600,1320,65700,bvh
2024-08-07,515,750400,1457.09,430,692700,1611,57700,bvh
2024-08-06,872,1159300,1329.47,603,1149600,1906,9700,bvh
2024-08-05,1024,1499400,1464.26,992,1848000,1863,-348600,bvh
2024-08-02,880,1221500,1388.07,541,1046300,1934,175200,bvh
2024-08-01,1183,1269400,1073.03,1192,1483600,1245,-214200,bvh
2024-07-31,782,1264000,1616.37,998,1350400,1353,-86400,bvh
2024-07-30,691,942700,1364.25,558,964300,1728,-21600,bvh
2024-07-29,557,714000,1281.87,769,808600,1051,-94600,bvh
2024-07-26,783,848400,1083.52,713,837600,1175,10800,bvh
2024-07-25,1030,1636800,1589.13,705,1100700,1561,536100,bvh
2024-07-24,1923,2436100,1266.82,1191,2509500,2107,-73400,bvh
2024-07-22,1458,1573900,1079.49,1033,1832100,1774,-258200,bvh
2024-07-19,1107,1770200,1599.1,933,1749600,1875,20600,bvh
2024-07-18,791,1255500,1587.23,648,1010900,1560,244600,bvh
2024-07-17,1056,2446900,2317.14,1505,2819500,1873,-372600,bvh
2024-07-16,689,1209000,1754.72,1158,1701400,1469,-492400,bvh
2024-07-15,749,1093900,1460.48,799,1377600,1724,-283700,bvh
2024-07-12,1006,1187800,1180.72,685,1285500,1877,-97700,bvh
2024-07-11,971,1227600,1264.26,855,1662000,1944,-434400,bvh
2024-07-10,940,1176200,1251.28,941,1385700,1473,-209500,bvh
2024-07-09,1690,2333700,1380.89,1477,2265900,1534,67800,bvh
2024-07-08,1566,2167000,1383.78,1042,1652400,1586,514600,bvh
2024-07-05,806,1145400,1421.09,888,1476300,1662,-330900,bvh
2024-07-04,738,1255500,1701.22,1017,1499900,1475,-244400,bvh
2024-07-03,1071,1359300,1269.19,1117,1716200,1536,-356900,bvh
2024-07-02,1360,2610400,1919.41,2129,3505400,1647,-895000,bvh
2024-07-01,892,893500,1001.68,716,1074800,1501,-181300,bvh
2024-06-28,1264,1754900,1388.37,1127,2143900,1902,-389000,bvh
2024-06-27,2082,4010900,1926.46,2391,4392600,1837,-381700,bvh
2024-06-26,771,610100,791.31,582,737200,1267,-127100,bvh
2024-06-25,631,889800,1410.14,610,612200,1004,277600,bvh
2024-06-24,1379,1400700,1015.74,870,1782600,2049,-381900,bvh
2024-06-21,631,1089300,1726.31,653,1192200,1826,-102900,bvh
2024-06-20,1052,1174800,1116.73,1143,1605000,1404,-430200,bvh
2024-06-19,747,946800,1267.47,893,1358800,1522,-412000,bvh
2024-06-18,1098,1491300,1358.2,869,1287900,1482,203400,bvh
2024-06-17,1192,1296500,1087.67,806,1244300,1544,52200,bvh
2024-06-14,1024,1880100,1836.04,1002,1485300,1482,394800,bvh
2024-06-13,1665,2151100,1291.95,1308,2117900,1619,33200,bvh
2024-06-12,1000,1472600,1472.6,671,1253900,1869,218700,bvh
2024-06-11,1354,1775500,1311.3,979,1972800,2015,-197300,bvh
2024-06-10,1128,1482800,1314.54,1288,2216400,1721,-733600,bvh
2024-06-07,1022,1464900,1433.37,812,1609400,1982,-144500,bvh
2024-06-06,1114,1380100,1238.87,1297,2978900,2297,-1598800,bvh
2024-06-05,2236,5042400,2255.1,2421,5108800,2110,-66400,bvh
2024-06-04,1093,2065900,1890.12,1470,2621500,1783,-555600,bvh
2024-06-03,1045,1670400,1598.47,996,1619200,1626,51200,bvh
2024-05-31,1063,1783600,1677.89,962,1706100,1773,77500,bvh
2024-05-30,2219,3923400,1768.09,931,2928300,3145,995100,bvh
2024-05-29,1373,2219300,1616.39,1366,2203600,1613,15700,bvh
2024-05-28,1641,2906200,1770.99,2022,2702400,1336,203800,bvh
2024-05-27,1229,4338100,3529.78,2529,4237100,1675,101000,bvh
2024-05-24,1632,2599600,1592.89,2155,3327000,1544,-727400,bvh
2024-05-23,2058,4758400,2312.15,2244,3438600,1532,1319800,bvh
2024-05-22,796,809700,1017.21,825,1106000,1341,-296300,bvh
2024-05-21,1003,1024900,1021.83,1009,1522300,1509,-497400,bvh
2024-05-20,1266,1867100,1474.8,1512,1846700,1221,20400,bvh
2024-05-17,581,615800,1059.9,430,777100,1807,-161300,bvh
2024-05-16,526,493500,938.21,516,592600,1148,-99100,bvh
2024-05-15,471,558800,1186.41,424,461700,1089,97100,bvh
2024-05-14,535,374400,699.81,391,478100,1223,-103700,bvh
2024-05-13,431,373900,867.52,414,398400,962,-24500,bvh
2024-05-10,506,528200,1043.87,520,686600,1320,-158400,bvh
2024-05-09,501,839500,1675.65,477,643800,1350,195700,bvh
2024-05-08,545,764700,1403.12,622,835500,1343,-70800,bvh
2024-05-07,544,1209100,2222.61,828,1147400,1386,61700,bvh
2024-05-06,451,503500,1116.41,432,633300,1466,-129800,bvh
2024-05-03,410,539000,1314.63,505,706400,1399,-167400,bvh
2024-05-02,444,838700,1888.96,474,682000,1439,156700,bvh
2024-04-26,536,706400,1317.91,417,548900,1316,157500,bvh
2024-04-25,443,367700,830.02,290,466100,1607,-98400,bvh
2024-04-24,544,644400,1184.56,390,578000,1482,66400,bvh
2024-04-23,460,418100,908.91,496,657800,1326,-239700,bvh
2024-04-22,609,938300,1540.72,741,1024200,1382,-85900,bvh
2024-04-19,918,1033800,1126.14,459,952900,2076,80900,bvh
2024-04-17,1113,1156500,1039.08,437,1137200,2602,19300,bvh
2024-04-16,1254,1125800,897.77,476,1174500,2467,-48700,bvh
2024-04-15,745,645300,866.17,511,867100,1697,-221800,bvh
2024-04-12,504,501100,994.25,389,406000,1044,95100,bvh
2024-04-11,723,443000,612.72,307,417000,1358,26000,bvh
2024-04-10,609,467500,767.65,482,596500,1238,-129000,bvh
2024-04-09,599,665200,1110.52,313,550400,1758,114800,bvh
2024-04-08,723,1060700,1467.08,348,579200,1664,481500,bvh
2024-04-05,685,589400,860.44,405,596800,1474,-7400,bvh
2024-04-04,525,562400,1071.24,449,658300,1466,-95900,bvh
2024-04-03,461,508700,1103.47,664,787600,1186,-278900,bvh
2024-04-02,961,1140500,1186.78,483,748900,1551,391600,bvh
2024-04-01,573,506800,884.47,721,612100,849,-105300,bvh
2024-03-29,666,1140100,1711.86,487,1071800,2201,68300,bvh
2024-03-28,340,687900,2023.24,731,933000,1276,-245100,bvh
2024-03-27,456,923600,2025.44,899,1006500,1120,-82900,bvh
2024-03-26,522,582500,1115.9,593,844800,1425,-262300,bvh
2024-03-25,673,1154500,1715.45,964,1344100,1394,-189600,bvh
2024-03-22,740,733500,991.22,733,1039500,1418,-306000,bvh
2024-03-21,695,941700,1354.96,714,1035200,1450,-93500,bvh
2024-03-20,821,980800,1194.64,504,502600,997,478200,bvh
2024-03-19,545,659500,1210.09,452,477200,1056,182300,bvh
2024-03-18,1512,1549600,1024.87,787,1757700,2233,-208100,bvh
2024-03-15,1335,1288900,965.47,693,1447300,2088,-158400,bvh
2024-03-14,736,1112400,1511.41,868,1106200,1274,6200,bvh
2024-03-13,1197,1167600,975.44,568,1018100,1792,149500,bvh
2024-03-12,973,1563400,1606.78,578,1237400,2141,326000,bvh
2024-03-11,971,1561700,1608.34,835,1832100,2194,-270400,bvh
2024-03-08,1477,3523000,2385.24,1479,3198300,2162,324700,bvh
2024-03-07,887,5442300,6135.63,1542,2477200,1606,2965100,bvh
2024-03-06,967,1771900,1832.37,1423,1691200,1188,80700,bvh
2024-03-05,671,1526300,2274.66,814,1193100,1466,333200,bvh
2024-03-04,672,1247600,1856.55,1093,1577700,1443,-330100,bvh
2024-03-01,683,743900,1089.17,791,1137900,1439,-394000,bvh
2024-02-29,878,1261600,1436.9,1375,1764500,1283,-502900,bvh
2024-02-28,696,1065900,1531.47,574,893100,1556,172800,bvh
2024-02-27,446,793400,1778.92,760,785100,1033,8300,bvh
2024-02-26,636,1005400,1580.82,504,761600,1511,243800,bvh
2024-02-23,978,997800,1020.25,880,1200500,1364,-202700,bvh
2024-02-22,861,902400,1048.08,541,893200,1651,9200,bvh
2024-02-21,924,907200,981.82,706,1049200,1486,-142000,bvh
2024-02-20,680,728400,1071.18,810,1030400,1272,-302000,bvh
2024-02-19,1049,1439600,1372.35,1338,1674200,1251,-234600,bvh
2024-02-16,1082,2013800,1861.18,1634,2100000,1285,-86200,bvh
2024-02-15,419,604300,1442.24,717,757000,1056,-152700,bvh
2024-02-07,0,0,0.0,0,0,0,0,bvh
2024-02-06,350,541800,1548.0,477,755200,1583,-213400,bvh
2024-02-05,576,713600,1238.89,845,1159200,1372,-445600,bvh
2024-02-02,378,327900,867.46,472,578700,1226,-250800,bvh
2024-02-01,556,821100,1476.8,750,1070500,1427,-249400,bvh
2024-01-31,628,742000,1181.53,523,795100,1520,-53100,bvh
2024-01-30,411,392000,953.77,451,523000,1160,-131000,bvh
2024-01-29,579,628700,1085.84,756,770100,1019,-141400,bvh
2024-01-26,431,343400,796.75,331,421600,1274,-78200,bvh
2024-01-25,419,397400,948.45,299,461200,1542,-63800,bvh
2024-01-24,665,694300,1044.06,423,688700,1628,5600,bvh
2024-01-23,753,770300,1022.97,517,842300,1629,-72000,bvh
2024-01-22,407,411100,1010.07,497,686500,1381,-275400,bvh
2024-01-19,447,502900,1125.06,612,681400,1113,-178500,bvh
2024-01-18,532,751200,1412.03,529,736800,1393,14400,bvh
2024-01-17,818,1149900,1405.75,762,1029100,1351,120800,bvh
2024-01-16,1014,1378000,1358.97,391,924000,2363,454000,bvh
2024-01-15,812,924600,1138.67,558,1084100,1943,-159500,bvh
2024-01-12,889,1171000,1317.21,787,1293800,1644,-122800,bvh
2024-01-11,1369,1987400,1451.72,1716,2019200,1177,-31800,bvh
2024-01-10,0,0,0.0,0,0,0,0,bvh
2024-01-09,704,1071200,1521.59,585,901000,1540,170200,bvh
2024-01-08,524,622700,1188.36,605,783800,1296,-161100,bvh
2024-01-05,450,702100,1560.22,605,809200,1338,-107100,bvh
2024-01-04,895,1330200,1486.26,1108,1336600,1206,-6400,bvh
2024-01-03,603,960200,1592.37,649,599000,923,361200,bvh
2024-01-02,470,638100,1357.66,711,657200,924,-19100,bvh
2024-09-12,3,3200,1066.67,7,2200,314,1000,bvn
2024-09-11,3,51200,17066.67,8,1300,162,49900,bvn
2024-09-10,3,52200,17400.0,7,1600,229,50600,bvn
2024-09-09,6,3000,500.0,7,3500,500,-500,bvn
2024-09-06,2,300,150.0,11,3900,355,-3600,bvn
2024-09-05,0,0,0.0,6,3300,550,-3300,bvn
2024-09-04,14,52600,3757.14,5,3100,620,49500,bvn
2024-08-30,5,1500,300.0,11,10900,991,-9400,bvn
2024-08-29,5,4300,860.0,6,7800,1300,-3500,bvn
2024-08-28,4,7200,1800.0,5,7500,1500,-300,bvn
2024-08-27,4,2200,550.0,3,5900,1967,-3700,bvn
2024-08-26,9,5200,577.78,6,5600,933,-400,bvn
2024-08-23,10,5700,570.0,12,9800,817,-4100,bvn
2024-08-22,4,3300,825.0,8,9400,1175,-6100,bvn
2024-08-21,5,2500,500.0,4,2100,525,400,bvn
2024-08-20,3,5400,1800.0,9,13200,1467,-7800,bvn
2024-08-19,0,0,0.0,6,7700,1283,-7700,bvn
2024-08-16,0,0,0.0,10,13000,1300,-13000,bvn
2024-08-15,4,5200,1300.0,13,13600,1046,-8400,bvn
2024-08-14,2,300,150.0,8,6400,800,-6100,bvn
2024-08-13,7,102600,14657.14,6,5900,983,96700,bvn
2024-08-12,7,53300,7614.29,7,2800,400,50500,bvn
2024-08-09,4,4200,1050.0,3,900,300,3300,bvn
2024-08-08,6,2900,483.33,5,900,180,2000,bvn
2024-08-07,2,50100,25050.0,4,5800,1450,44300,bvn
2024-08-06,1,100,100.0,5,9700,1940,-9600,bvn
2024-08-05,3,800,266.67,5,9700,1940,-8900,bvn
2024-08-02,5,5800,1160.0,4,7700,1925,-1900,bvn
2024-08-01,6,78300,13050.0,3,5700,1900,72600,bvn
2024-07-31,8,107400,13425.0,2,2100,1050,105300,bvn
2024-07-30,3,4200,1400.0,3,4100,1367,100,bvn
2024-07-29,4,4300,1075.0,2,2100,1050,2200,bvn
2024-07-26,3,4200,1400.0,2,2100,1050,2100,bvn
2024-07-25,6,8700,1450.0,3,2700,900,6000,bvn
2024-07-24,4,100,25.0,4,3200,800,-3100,bvn
2024-07-23,8,16400,2050.0,7,4600,657,11800,bvn
2024-07-22,2,1200,600.0,8,13000,1625,-11800,bvn
2024-07-19,2,200,100.0,7,17100,2443,-16900,bvn
2024-07-18,4,2900,725.0,6,5700,950,-2800,bvn
2024-07-17,3,2300,766.67,7,6300,900,-4000,bvn
2024-07-16,5,3600,720.0,8,5400,675,-1800,bvn
2024-07-15,5,2600,520.0,7,4900,700,-2300,bvn
2024-07-12,4,3800,950.0,8,13000,1625,-9200,bvn
2024-07-11,4,3800,950.0,7,2600,371,1200,bvn
2024-07-10,8,4300,537.5,11,8700,791,-4400,bvn
2024-07-09,5,7900,1580.0,11,11700,1064,-3800,bvn
2024-07-08,5,7900,1580.0,11,12200,1109,-4300,bvn
2024-07-05,5,7900,1580.0,10,10600,1060,-2700,bvn
2024-07-04,10,10000,1000.0,11,13100,1191,-3100,bvn
2024-07-03,7,10400,1485.71,6,4700,783,5700,bvn
2024-07-02,8,8100,1012.5,8,8100,1012,0,bvn
2024-07-01,7,8400,1200.0,12,9200,767,-800,bvn
2024-06-28,14,4200,300.0,14,11200,800,-7000,bvn
2024-06-27,16,50800,3175.0,9,6400,711,44400,bvn
2024-06-26,22,53400,2427.27,16,10200,638,43200,bvn
2024-06-25,16,36300,2268.75,6,1400,233,34900,bvn
2024-06-24,15,30300,2020.0,13,22400,1723,7900,bvn
2024-06-21,11,9800,890.91,7,3700,529,6100,bvn
2024-06-20,20,14500,725.0,7,5200,743,9300,bvn
2024-06-19,13,12400,953.85,3,1400,467,11000,bvn
2024-06-18,19,20400,1073.68,8,4700,588,15700,bvn
2024-06-17,7,11200,1600.0,8,10500,1312,700,bvn
2024-06-14,22,19100,868.18,17,7700,453,11400,bvn
2024-06-13,25,9400,376.0,6,2400,400,7000,bvn
2024-06-12,7,5400,771.43,7,2300,329,3100,bvn
2024-06-11,5,6500,1300.0,6,2300,383,4200,bvn
2024-06-10,5,6100,1220.0,7,5700,814,400,bvn
2024-06-07,9,3800,422.22,5,2800,560,1000,bvn
2024-06-06,6,6700,1116.67,8,7400,925,-700,bvn
2024-06-05,21,17500,833.33,2,200,100,17300,bvn
2024-06-04,11,7400,672.73,0,0,0,7400,bvn
2024-06-03,13,11100,853.85,0,0,0,11100,bvn
2024-05-31,9,9200,1022.22,3,1100,367,8100,bvn
2024-05-30,8,3400,425.0,10,6900,690,-3500,bvn
2024-05-29,18,8500,472.22,4,1300,325,7200,bvn
2024-05-28,10,3600,360.0,6,2000,333,1600,bvn
2024-05-27,10,5100,510.0,12,11600,967,-6500,bvn
2024-05-24,3,1100,366.67,10,11400,1140,-10300,bvn
2024-05-23,4,5300,1325.0,12,16500,1375,-11200,bvn
2024-05-22,3,4200,1400.0,11,12000,1091,-7800,bvn
2024-05-21,3,4200,1400.0,12,16500,1375,-12300,bvn
2024-05-20,8,13100,1637.5,12,14900,1242,-1800,bvn
2024-05-17,5,8200,1640.0,9,14200,1578,-6000,bvn
2024-05-16,12,14700,1225.0,8,6000,750,8700,bvn
2024-05-15,9,7200,800.0,10,4700,470,2500,bvn
2024-05-14,4,3400,850.0,9,15600,1733,-12200,bvn
2024-05-13,3,900,300.0,8,15100,1888,-14200,bvn
2024-05-10,3,900,300.0,6,3600,600,-2700,bvn
2024-05-09,2,300,150.0,6,3100,517,-2800,bvn
2024-05-08,3,1000,333.33,8,6600,825,-5600,bvn
2024-05-07,8,3100,387.5,8,3500,438,-400,bvn
2024-05-06,6,5000,833.33,6,3500,583,1500,bvn
2024-05-03,6,5100,850.0,10,9500,950,-4400,bvn
2024-05-02,5,3600,720.0,6,3400,567,200,bvn
2024-04-26,7,2900,414.29,10,8300,830,-5400,bvn
2024-04-25,6,6700,1116.67,6,6600,1100,100,bvn
2024-04-24,6,4200,700.0,6,1600,267,2600,bvn
2024-04-23,7,5800,828.57,7,7800,1114,-2000,bvn
2024-04-22,7,4800,685.71,6,6600,1100,-1800,bvn
2024-04-19,9,7500,833.33,7,6900,986,600,bvn
2024-04-17,7,5800,828.57,11,13900,1264,-8100,bvn
2024-04-16,8,3800,475.0,10,12100,1210,-8300,bvn
2024-04-15,7,3400,485.71,7,4800,686,-1400,bvn
2024-04-12,5,3400,680.0,8,9500,1188,-6100,bvn
2024-04-11,6,4800,800.0,9,8900,989,-4100,bvn
2024-04-10,6,3700,616.67,8,15500,1938,-11800,bvn
2024-04-09,8,4400,550.0,9,15400,1711,-11000,bvn
2024-04-08,11,9600,872.73,7,6500,929,3100,bvn
2024-04-05,13,10200,784.62,12,10900,908,-700,bvn
2024-04-04,7,2600,371.43,7,7500,1071,-4900,bvn
2024-04-03,12,10000,833.33,12,18600,1550,-8600,bvn
2024-04-02,10,4100,410.0,7,8300,1186,-4200,bvn
2024-04-01,12,4400,366.67,11,11600,1055,-7200,bvn
2024-03-29,9,7800,866.67,10,12400,1240,-4600,bvn
2024-03-28,10,6700,670.0,8,7200,900,-500,bvn
2024-03-27,16,4100,256.25,8,12100,1512,-8000,bvn
2024-03-26,23,15400,669.57,2,200,100,15200,bvn
2024-03-25,12,1100,91.67,9,11100,1233,-10000,bvn
2024-03-22,15,1400,93.33,7,8900,1271,-7500,bvn
2024-03-21,11,1100,100.0,7,8200,1171,-7100,bvn
2024-03-20,10,6500,650.0,8,13000,1625,-6500,bvn
2024-03-19,13,10500,807.69,10,6200,620,4300,bvn
2024-03-18,15,18700,1246.67,16,12700,794,6000,bvn
2024-03-15,13,20800,1600.0,10,7500,750,13300,bvn
2024-03-14,9,16700,1855.56,8,4100,512,12600,bvn
2024-03-13,7,17400,2485.71,6,2700,450,14700,bvn
2024-03-12,4,7300,1825.0,4,400,100,6900,bvn
2024-03-11,14,22600,1614.29,20,12100,605,10500,bvn
2024-03-08,8,9900,1237.5,7,3900,557,6000,bvn
2024-03-07,7,22600,3228.57,6,4000,667,18600,bvn
2024-03-06,8,22500,2812.5,4,1800,450,20700,bvn
2024-03-05,22,51200,2327.27,6,5000,833,46200,bvn
2024-03-04,7,10700,1528.57,5,3500,700,7200,bvn
2024-03-01,17,15000,882.35,7,5800,829,9200,bvn
2024-02-29,10,4500,450.0,15,9600,640,-5100,bvn
2024-02-28,17,107400,6317.65,10,2700,270,104700,bvn
2024-02-27,29,32900,1134.48,6,11100,1850,21800,bvn
2024-02-26,30,137200,4573.33,3,1200,400,136000,bvn
2024-02-23,19,168700,8878.95,3,12600,4200,156100,bvn
2024-02-22,13,28900,2223.08,3,10800,3600,18100,bvn
2024-02-21,4,5300,1325.0,2,10700,5350,-5400,bvn
2024-02-20,7,11000,1571.43,1,100,100,10900,bvn
2024-02-19,6,10900,1816.67,0,0,0,10900,bvn
2024-02-16,8,10200,1275.0,0,0,0,10200,bvn
2024-02-15,6,9200,1533.33,0,0,0,9200,bvn
2024-02-07,10,23300,2330.0,2,10800,5400,12500,bvn
2024-02-06,9,16100,1788.89,4,11000,2750,5100,bvn
2024-02-05,4,2300,575.0,3,11100,3700,-8800,bvn
2024-02-02,3,2200,733.33,2,10900,5450,-8700,bvn
2024-02-01,2,2200,1100.0,3,11700,3900,-9500,bvn
2024-01-31,3,2300,766.67,4,12700,3175,-10400,bvn
2024-01-30,3,2300,766.67,4,12300,3075,-10000,bvn
2024-01-29,4,2500,625.0,3,11400,3800,-8900,bvn
2024-01-26,4,2800,700.0,4,11000,2750,-8200,bvn
2024-01-25,4,6400,1600.0,2,400,200,6000,bvn
2024-01-24,3,6200,2066.67,0,0,0,6200,bvn
2024-01-23,4,6400,1600.0,0,0,0,6400,bvn
2024-01-22,6,6500,1083.33,0,0,0,6500,bvn
2024-01-19,6,12400,2066.67,3,300,100,12100,bvn
2024-01-18,2,2100,1050.0,7,12100,1729,-10000,bvn
2024-01-17,11,7700,700.0,4,1300,325,6400,bvn
2024-01-16,11,17900,1627.27,3,300,100,17600,bvn
2024-01-15,6,6300,1050.0,8,6000,750,300,bvn
2024-01-12,3,400,133.33,5,5500,1100,-5100,bvn
2024-01-11,7,7500,1071.43,1,100,100,7400,bvn
2024-01-10,7,3700,528.57,2,200,100,3500,bvn
2024-01-09,2,300,150.0,3,300,100,0,bvn
2024-01-08,7,5500,785.71,5,5400,1080,100,bvn
2024-01-05,4,2700,675.0,7,5600,800,-2900,bvn
2024-01-04,5,2800,560.0,6,5500,917,-2700,bvn
2024-01-03,11,8400,763.64,2,200,100,8200,bvn
2024-01-02,7,5400,771.43,3,400,133,5000,bvn
2024-09-12,531,496100,934.27,616,773600,1256,-277500,bvs
2024-09-11,1076,985100,915.52,789,1030100,1306,-45000,bvs
2024-09-10,758,873400,1152.24,671,968300,1443,-94900,bvs
2024-09-09,582,557800,958.42,382,457400,1197,100400,bvs
2024-09-06,865,863000,997.69,587,852300,1452,10700,bvs
2024-09-05,1060,1318900,1244.25,1060,1634700,1542,-315800,bvs
2024-09-04,758,955200,1260.16,571,800400,1402,154800,bvs
2024-08-30,650,911300,1402.0,808,904200,1119,7100,bvs
2024-08-29,568,598400,1053.52,554,748200,1351,-149800,bvs
2024-08-28,987,1122600,1137.39,921,1158900,1258,-36300,bvs
2024-08-27,980,844200,861.43,698,913400,1309,-69200,bvs
2024-08-26,1150,1358700,1181.48,964,1634900,1696,-276200,bvs
2024-08-23,1073,1465000,1365.33,928,1425000,1536,40000,bvs
2024-08-22,802,930700,1160.47,1022,1238400,1212,-307700,bvs
2024-08-21,811,1203100,1483.48,893,1368300,1532,-165200,bvs
2024-08-20,1720,2019000,1173.84,1265,2280900,1803,-261900,bvs
2024-08-19,996,1151100,1155.72,817,1179800,1444,-28700,bvs
2024-08-16,1439,2245700,1560.6,1731,2114000,1221,131700,bvs
2024-08-15,917,924500,1008.18,833,1058900,1271,-134400,bvs
2024-08-14,892,881000,987.67,1127,1283900,1139,-402900,bvs
2024-08-13,961,966100,1005.31,837,1179500,1409,-213400,bvs
2024-08-12,785,972800,1239.24,918,1040200,1133,-67400,bvs
2024-08-09,1262,1658500,1314.18,1847,1692000,916,-33500,bvs
2024-08-08,1450,1442200,994.62,954,1212500,1271,229700,bvs
2024-08-07,1030,1123500,1090.78,777,947300,1219,176200,bvs
2024-08-06,1327,1895100,1428.11,1310,1375000,1050,520100,bvs
2024-08-05,1465,1549100,1057.41,1067,1419400,1330,129700,bvs
2024-08-02,1708,1894100,1108.96,1511,1420700,940,473400,bvs
2024-08-01,1760,1851300,1051.88,1090,1793300,1645,58000,bvs
2024-07-31,1130,907200,802.83,913,1095300,1200,-188100,bvs
2024-07-30,775,675900,872.13,620,817400,1318,-141500,bvs
2024-07-29,694,771800,1112.1,593,782200,1319,-10400,bvs
2024-07-26,665,510000,766.92,529,620200,1172,-110200,bvs
2024-07-25,808,603100,746.41,574,622600,1085,-19500,bvs
2024-07-24,1191,1238800,1040.13,894,1150500,1287,88300,bvs
2024-07-23,1166,1103400,946.31,882,1211400,1373,-108000,bvs
2024-07-22,2405,2404000,999.58,1467,2544800,1735,-140800,bvs
2024-07-19,1505,1334700,886.84,962,1584400,1647,-249700,bvs
2024-07-18,938,771200,822.17,568,736700,1297,34500,bvs
2024-07-17,1438,1593200,1107.93,1348,1707300,1267,-114100,bvs
2024-07-16,1128,1262900,1119.59,941,1411500,1500,-148600,bvs
2024-07-15,736,840500,1141.98,733,1209900,1651,-369400,bvs
2024-07-12,913,1054000,1154.44,780,1065000,1365,-11000,bvs
2024-07-11,1117,1255900,1124.35,1048,1313100,1253,-57200,bvs
2024-07-10,896,1020600,1139.06,955,1133500,1187,-112900,bvs
2024-07-09,1875,2335900,1245.81,1860,2469900,1328,-134000,bvs
2024-07-08,782,632600,808.95,645,805000,1248,-172400,bvs
2024-07-05,996,747200,750.2,625,843700,1350,-96500,bvs
2024-07-04,486,484400,996.71,677,668900,988,-184500,bvs
2024-07-03,595,651200,1094.45,489,815700,1668,-164500,bvs
2024-07-02,584,588000,1006.85,824,726900,882,-138900,bvs
2024-07-01,755,739000,978.81,583,520500,893,218500,bvs
2024-06-28,1111,1017000,915.39,877,1087800,1240,-70800,bvs
2024-06-27,701,557100,794.72,591,693300,1173,-136200,bvs
2024-06-26,1052,901900,857.32,630,913400,1450,-11500,bvs
2024-06-25,832,792200,952.16,609,686400,1127,105800,bvs
2024-06-24,2338,2115900,905.0,1234,2286200,1853,-170300,bvs
2024-06-21,952,853600,896.64,784,889800,1135,-36200,bvs
2024-06-20,957,774600,809.4,599,786700,1313,-12100,bvs
2024-06-19,1026,771500,751.95,708,782000,1105,-10500,bvs
2024-06-18,821,657300,800.61,509,608000,1194,49300,bvs
2024-06-17,1364,1009400,740.03,681,879900,1292,129500,bvs
2024-06-14,1313,1245800,948.82,893,1461600,1637,-215800,bvs
2024-06-13,921,773400,839.74,708,906400,1280,-133000,bvs
2024-06-12,785,1091700,1390.7,709,1053200,1485,38500,bvs
2024-06-11,842,717200,851.78,679,761000,1121,-43800,bvs
2024-06-10,996,947300,951.1,776,1046800,1349,-99500,bvs
2024-06-07,790,724300,916.84,568,860700,1515,-136400,bvs
2024-06-06,739,712900,964.68,842,1033400,1227,-320500,bvs
2024-06-05,1063,1206800,1135.28,1164,1476700,1269,-269900,bvs
2024-06-04,754,882000,1169.76,802,1213000,1512,-331000,bvs
2024-06-03,690,1095600,1587.83,930,1291900,1389,-196300,bvs
2024-05-31,836,1119600,1339.23,873,998500,1144,121100,bvs
2024-05-30,1815,2032400,1119.78,1057,1639000,1551,393400,bvs
2024-05-29,1151,1064300,924.67,808,1441200,1784,-376900,bvs
2024-05-28,902,1386100,1536.7,1467,1600600,1091,-214500,bvs
2024-05-27,1019,1157000,1135.43,795,1009900,1270,147100,bvs
2024-05-24,2039,1581100,775.43,1258,1595100,1268,-14000,bvs
2024-05-23,1670,1893600,1133.89,1032,1498600,1452,395000,bvs
2024-05-22,1871,2130300,1138.59,1064,1971900,1853,158400,bvs
2024-05-21,1318,1960000,1487.1,1164,1737000,1492,223000,bvs
2024-05-20,1299,1421900,1094.61,962,1634800,1699,-212900,bvs
2024-05-17,1087,1138100,1047.01,882,1453200,1648,-315100,bvs
2024-05-16,1084,1098400,1013.28,960,1344600,1401,-246200,bvs
2024-05-15,1037,1334400,1286.79,1134,1597800,1409,-263400,bvs
2024-05-14,1476,1302200,882.25,626,1360200,2173,-58000,bvs
2024-05-13,1155,1332100,1153.33,824,1363200,1654,-31100,bvs
2024-05-10,1164,1617700,1389.78,853,1163700,1364,454000,bvs
2024-05-09,1097,1097300,1000.27,798,1252300,1569,-155000,bvs
2024-05-08,984,1194400,1213.82,922,1331600,1444,-137200,bvs
2024-05-07,913,1144400,1253.45,820,1190400,1452,-46000,bvs
2024-05-06,1029,1299100,1262.49,1038,1422800,1371,-123700,bvs
2024-05-03,769,832100,1082.05,554,774400,1398,57700,bvs
2024-05-02,1170,989500,845.73,615,878100,1428,111400,bvs
2024-04-26,857,733800,856.24,641,675700,1054,58100,bvs
2024-04-25,897,813600,907.02,626,751900,1201,61700,bvs
2024-04-24,806,1199400,1488.09,969,1108600,1144,90800,bvs
2024-04-23,936,805000,860.04,771,1111900,1442,-306900,bvs
2024-04-22,888,1718000,1934.68,1094,1482500,1355,235500,bvs
2024-04-19,1165,1496400,1284.46,941,1368000,1454,128400,bvs
2024-04-17,879,865600,984.76,669,1015000,1517,-149400,bvs
2024-04-16,1544,1687300,1092.81,970,1447700,1492,239600,bvs
2024-04-15,1379,1497100,1085.64,973,1933800,1987,-436700,bvs
2024-04-12,864,874700,1012.38,884,1000900,1132,-126200,bvs
2024-04-11,1171,1160800,991.29,1132,1331000,1176,-170200,bvs
2024-04-10,749,716400,956.48,713,728200,1021,-11800,bvs
2024-04-09,1216,1335000,1097.86,1013,1163200,1148,171800,bvs
2024-04-08,1714,1683700,982.32,913,1551900,1700,131800,bvs
2024-04-05,1128,1217100,1078.99,857,1169500,1365,47600,bvs
2024-04-04,1176,1316600,1119.56,1070,1518100,1419,-201500,bvs
2024-04-03,1178,2060100,1748.81,1218,1947400,1599,112700,bvs
2024-04-02,910,1090100,1197.91,502,870700,1734,219400,bvs
2024-04-01,966,1043100,1079.81,516,924200,1791,118900,bvs
2024-03-29,606,626800,1034.32,505,657600,1302,-30800,bvs
2024-03-28,1554,1967800,1266.28,1139,1775600,1559,192200,bvs
2024-03-27,661,614400,929.5,407,707100,1737,-92700,bvs
2024-03-26,704,767900,1090.77,341,703600,2063,64300,bvs
2024-03-25,710,751800,1058.87,495,875600,1769,-123800,bvs
2024-03-22,742,903100,1217.12,709,1103200,1556,-200100,bvs
2024-03-21,613,756300,1233.77,794,995200,1253,-238900,bvs
2024-03-20,519,655000,1262.04,574,653300,1138,1700,bvs
2024-03-19,543,625100,1151.2,411,584000,1421,41100,bvs
2024-03-18,1513,1590100,1050.96,645,1374600,2131,215500,bvs
2024-03-15,1324,1472700,1112.31,497,1206500,2428,266200,bvs
2024-03-14,875,1007200,1151.09,635,1258800,1982,-251600,bvs
2024-03-13,799,1831700,2292.49,811,2117300,2611,-285600,bvs
2024-03-12,566,1015200,1793.64,601,1259700,2096,-244500,bvs
2024-03-11,644,861800,1338.2,617,916300,1485,-54500,bvs
2024-03-08,941,1172000,1245.48,611,1462700,2394,-290700,bvs
2024-03-07,787,1566100,1989.96,721,2247900,3118,-681800,bvs
2024-03-06,1591,2898000,1821.5,1045,1943300,1860,954700,bvs
2024-03-05,617,833000,1350.08,543,780800,1438,52200,bvs
2024-03-04,409,581100,1420.78,581,1188700,2046,-607600,bvs
2024-03-01,667,862800,1293.55,465,967800,2081,-105000,bvs
2024-02-29,1003,1797300,1791.92,651,1398000,2147,399300,bvs
2024-02-28,226,271800,1202.65,247,406100,1644,-134300,bvs
2024-02-27,283,507200,1792.23,257,475400,1850,31800,bvs
2024-02-26,326,584400,1792.64,292,410200,1405,174200,bvs
2024-02-23,378,720000,1904.76,394,635800,1614,84200,bvs
2024-02-22,282,401900,1425.18,297,406200,1368,-4300,bvs
2024-02-21,397,640900,1614.36,277,395100,1426,245800,bvs
2024-02-20,483,840400,1739.96,333,693400,2082,147000,bvs
2024-02-19,370,605100,1635.41,278,465100,1673,140000,bvs
2024-02-16,254,337500,1328.74,255,337200,1322,300,bvs
2024-02-15,465,679200,1460.65,245,686800,2803,-7600,bvs
2024-02-07,231,225100,974.46,181,199700,1103,25400,bvs
2024-02-06,336,508400,1513.1,210,471100,2243,37300,bvs
2024-02-05,349,396600,1136.39,180,390500,2169,6100,bvs
2024-02-02,173,226200,1307.51,183,240800,1316,-14600,bvs
2024-02-01,241,270400,1121.99,144,260700,1810,9700,bvs
2024-01-31,338,461000,1363.91,371,752000,2027,-291000,bvs
2024-01-30,179,222700,1244.13,144,208100,1445,14600,bvs
2024-01-29,185,266700,1441.62,168,342900,2041,-76200,bvs
2024-01-26,151,235500,1559.6,139,224900,1618,10600,bvs
2024-01-25,172,288700,1678.49,170,294900,1735,-6200,bvs
2024-01-24,266,535000,2011.28,285,633400,2222,-98400,bvs
2024-01-23,206,220400,1069.9,146,225300,1543,-4900,bvs
2024-01-22,166,231700,1395.78,181,310000,1713,-78300,bvs
2024-01-19,197,228700,1160.91,194,345200,1779,-116500,bvs
2024-01-18,200,159400,797.0,162,278900,1722,-119500,bvs
2024-01-17,293,482000,1645.05,322,761200,2364,-279200,bvs
2024-01-16,213,268900,1262.44,104,223100,2145,45800,bvs
2024-01-15,133,182800,1374.44,132,274400,2079,-91600,bvs
2024-01-12,242,217000,896.69,186,310500,1669,-93500,bvs
2024-01-11,206,318300,1545.15,157,312900,1993,5400,bvs
2024-01-10,232,231200,996.55,150,243300,1622,-12100,bvs
2024-01-09,212,291200,1373.58,188,353500,1880,-62300,bvs
2024-01-08,323,573100,1774.3,355,512100,1443,61000,bvs
2024-01-05,153,182300,1191.5,175,176600,1009,5700,bvs
2024-01-04,273,370300,1356.41,245,441900,1804,-71600,bvs
2024-01-03,175,232200,1326.86,123,224500,1825,7700,bvs
2024-01-02,447,769700,1721.92,189,749700,3967,20000,bvs
2024-09-12,0,0,0.0,0,0,0,0,bwa
2024-09-11,0,0,0.0,0,0,0,0,bwa
2024-09-10,0,0,0.0,0,0,0,0,bwa
2024-09-09,0,0,0.0,0,0,0,0,bwa
2024-09-06,0,0,0.0,0,0,0,0,bwa
2024-09-05,0,0,0.0,0,0,0,0,bwa
2024-09-04,0,0,0.0,1,900,900,-900,bwa
2024-08-30,0,0,0.0,0,0,0,0,bwa
2024-08-29,0,0,0.0,0,0,0,0,bwa
2024-08-28,0,0,0.0,0,0,0,0,bwa
2024-08-27,2,200,100.0,3,400,133,-200,bwa
2024-08-26,0,0,0.0,0,0,0,0,bwa
2024-08-23,1,100,100.0,1,1000,1000,-900,bwa
2024-08-22,0,0,0.0,0,0,0,0,bwa
2024-08-21,0,0,0.0,0,0,0,0,bwa
2024-08-20,0,0,0.0,0,0,0,0,bwa
2024-08-19,1,100,100.0,0,0,0,100,bwa
2024-08-16,0,0,0.0,1,1000,1000,-1000,bwa
2024-08-15,0,0,0.0,0,0,0,0,bwa
2024-08-14,0,0,0.0,0,0,0,0,bwa
2024-08-13,1,100,100.0,0,0,0,100,bwa
2024-08-12,0,0,0.0,0,0,0,0,bwa
2024-08-09,0,0,0.0,0,0,0,0,bwa
2024-08-08,1,100,100.0,0,0,0,100,bwa
2024-08-07,0,0,0.0,0,0,0,0,bwa
2024-08-06,1,100,100.0,1,100,100,0,bwa
2024-08-05,1,0,0.0,0,0,0,0,bwa
2024-08-02,1,100,100.0,1,100,100,0,bwa
2024-08-01,2,200,100.0,1,100,100,100,bwa
2024-07-31,2,200,100.0,0,0,0,200,bwa
2024-07-30,1,100,100.0,1,100,100,0,bwa
2024-07-29,1,100,100.0,0,0,0,100,bwa
2024-07-26,1,100,100.0,0,0,0,100,bwa
2024-07-25,2,100,50.0,0,0,0,100,bwa
2024-07-24,1,100,100.0,0,0,0,100,bwa
2024-07-23,2,400,200.0,0,0,0,400,bwa
2024-07-22,1,100,100.0,0,0,0,100,bwa
2024-07-19,1,100,100.0,0,0,0,100,bwa
2024-07-18,1,100,100.0,0,0,0,100,bwa
2024-07-17,1,0,0.0,0,0,0,0,bwa
2024-07-16,1,100,100.0,0,0,0,100,bwa
2024-07-15,1,100,100.0,0,0,0,100,bwa
2024-07-12,3,300,100.0,0,0,0,300,bwa
2024-07-11,1,100,100.0,0,0,0,100,bwa
2024-07-10,2,100,50.0,1,4400,4400,-4300,bwa
2024-07-09,1,0,0.0,0,0,0,0,bwa
2024-07-08,2,2700,1350.0,0,0,0,2700,bwa
2024-07-05,3,300,100.0,1,100,100,200,bwa
2024-07-04,0,0,0.0,0,0,0,0,bwa
2024-07-03,0,0,0.0,0,0,0,0,bwa
2024-07-02,0,0,0.0,0,0,0,0,bwa
2024-07-01,0,0,0.0,0,0,0,0,bwa
2024-06-28,1,100,100.0,0,0,0,100,bwa
2024-06-27,1,100,100.0,0,0,0,100,bwa
2024-06-26,0,0,0.0,0,0,0,0,bwa
2024-06-25,1,0,0.0,0,0,0,0,bwa
2024-06-24,3,300,100.0,1,100,100,200,bwa
2024-06-21,1,100,100.0,0,0,0,100,bwa
2024-06-20,2,1700,850.0,0,0,0,1700,bwa
2024-06-19,1,100,100.0,0,0,0,100,bwa
2024-06-18,2,200,100.0,0,0,0,200,bwa
2024-06-17,3,1200,400.0,1,100,100,1100,bwa
2024-06-14,1,100,100.0,0,0,0,100,bwa
2024-06-13,2,2100,1050.0,0,0,0,2100,bwa
2024-06-12,1,2000,2000.0,0,0,0,2000,bwa
2024-06-11,2,2100,1050.0,0,0,0,2100,bwa
2024-06-10,2,1100,550.0,0,0,0,1100,bwa
2024-06-07,3,11100,3700.0,0,0,0,11100,bwa
2024-06-06,2,2100,1050.0,0,0,0,2100,bwa
2024-06-05,2,1100,550.0,1,100,100,1000,bwa
2024-06-04,1,100,100.0,1,100,100,0,bwa
2024-06-03,1,100,100.0,1,100,100,0,bwa
2024-05-31,0,0,0.0,0,0,0,0,bwa
2024-05-30,2,1100,550.0,0,0,0,1100,bwa
2024-05-29,1,100,100.0,0,0,0,100,bwa
2024-05-28,1,100,100.0,0,0,0,100,bwa
2024-05-27,2,100,50.0,0,0,0,100,bwa
2024-05-24,2,300,150.0,0,0,0,300,bwa
2024-05-23,3,1100,366.67,0,0,0,1100,bwa
2024-05-22,1,100,100.0,0,0,0,100,bwa
2024-05-21,4,1300,325.0,0,0,0,1300,bwa
2024-05-20,4,1300,325.0,0,0,0,1300,bwa
2024-05-17,4,1300,325.0,0,0,0,1300,bwa
2024-05-16,4,3100,775.0,0,0,0,3100,bwa
2024-05-15,6,5300,883.33,1,100,100,5200,bwa
2024-05-14,4,8100,2025.0,0,0,0,8100,bwa
2024-05-13,2,2300,1150.0,0,0,0,2300,bwa
2024-05-10,2,2600,1300.0,0,0,0,2600,bwa
2024-05-09,5,10300,2060.0,1,10000,10000,300,bwa
2024-05-08,4,2200,550.0,0,0,0,2200,bwa
2024-05-07,3,2200,733.33,0,0,0,2200,bwa
2024-05-06,5,1500,300.0,0,0,0,1500,bwa
2024-05-03,3,2700,900.0,0,0,0,2700,bwa
2024-05-02,3,2100,700.0,0,0,0,2100,bwa
2024-04-26,4,500,125.0,0,0,0,500,bwa
2024-04-25,3,3200,1066.67,0,0,0,3200,bwa
2024-04-24,4,4200,1050.0,0,0,0,4200,bwa
2024-04-23,2,200,100.0,0,0,0,200,bwa
2024-04-22,4,2200,550.0,0,0,0,2200,bwa
2024-04-19,5,4200,840.0,0,0,0,4200,bwa
2024-04-17,4,3200,800.0,0,0,0,3200,bwa
2024-04-16,4,3200,800.0,0,0,0,3200,bwa
2024-04-15,4,3100,775.0,0,0,0,3100,bwa
2024-04-12,4,2700,675.0,0,0,0,2700,bwa
2024-04-11,4,2200,550.0,0,0,0,2200,bwa
2024-04-10,3,3000,1000.0,0,0,0,3000,bwa
2024-04-09,8,400,50.0,1,100,100,300,bwa
2024-04-08,4,3100,775.0,0,0,0,3100,bwa
2024-04-05,8,6200,775.0,0,0,0,6200,bwa
2024-04-04,7,1400,200.0,0,0,0,1400,bwa
2024-04-03,11,4600,418.18,0,0,0,4600,bwa
2024-04-02,9,2400,266.67,0,0,0,2400,bwa
2024-04-01,9,3200,355.56,0,0,0,3200,bwa
2024-03-29,5,3100,620.0,0,0,0,3100,bwa
2024-03-28,12,6600,550.0,0,0,0,6600,bwa
2024-03-27,11,4500,409.09,0,0,0,4500,bwa
2024-03-26,25,8000,320.0,1,100,100,7900,bwa
2024-03-25,3,1800,600.0,0,0,0,1800,bwa
2024-03-22,3,1000,333.33,2,200,100,800,bwa
2024-03-21,2,1100,550.0,0,0,0,1100,bwa
2024-03-20,1,100,100.0,0,0,0,100,bwa
2024-03-19,2,800,400.0,0,0,0,800,bwa
2024-03-18,1,500,500.0,1,100,100,400,bwa
2024-03-15,2,0,0.0,0,0,0,0,bwa
2024-03-14,1,100,100.0,0,0,0,100,bwa
2024-03-13,1,100,100.0,0,0,0,100,bwa
2024-03-12,0,0,0.0,0,0,0,0,bwa
2024-03-11,0,0,0.0,0,0,0,0,bwa
2024-03-08,1,1000,1000.0,0,0,0,1000,bwa
2024-03-07,1,100,100.0,0,0,0,100,bwa
2024-03-06,1,100,100.0,0,0,0,100,bwa
2024-03-05,1,100,100.0,0,0,0,100,bwa
2024-03-04,0,0,0.0,0,0,0,0,bwa
2024-03-01,1,100,100.0,0,0,0,100,bwa
2024-02-29,1,100,100.0,0,0,0,100,bwa
2024-02-28,1,100,100.0,0,0,0,100,bwa
2024-02-27,1,100,100.0,0,0,0,100,bwa
2024-02-26,0,0,0.0,0,0,0,0,bwa
2024-02-23,1,100,100.0,0,0,0,100,bwa
2024-02-22,1,100,100.0,0,0,0,100,bwa
2024-02-21,0,0,0.0,0,0,0,0,bwa
2024-02-20,1,100,100.0,0,0,0,100,bwa
2024-02-19,0,0,0.0,0,0,0,0,bwa
2024-02-16,1,100,100.0,0,0,0,100,bwa
2024-02-15,1,200,200.0,0,0,0,200,bwa
2024-02-07,1,100,100.0,0,0,0,100,bwa
2024-02-06,0,0,0.0,0,0,0,0,bwa
2024-02-05,1,100,100.0,0,0,0,100,bwa
2024-02-02,0,0,0.0,0,0,0,0,bwa
2024-02-01,0,0,0.0,0,0,0,0,bwa
2024-01-31,0,0,0.0,0,0,0,0,bwa
2024-01-30,0,0,0.0,0,0,0,0,bwa
2024-01-29,0,0,0.0,0,0,0,0,bwa
2024-01-26,0,0,0.0,0,0,0,0,bwa
2024-01-25,1,100,100.0,0,0,0,100,bwa
2024-01-24,0,0,0.0,0,0,0,0,bwa
2024-01-23,0,0,0.0,0,0,0,0,bwa
2024-01-22,0,0,0.0,0,0,0,0,bwa
2024-01-19,0,0,0.0,1,100,100,-100,bwa
2024-01-18,0,0,0.0,0,0,0,0,bwa
2024-01-17,0,0,0.0,0,0,0,0,bwa
2024-01-16,0,0,0.0,0,0,0,0,bwa
2024-01-15,0,0,0.0,0,0,0,0,bwa
2024-01-12,0,0,0.0,1,100,100,-100,bwa
2024-01-11,0,0,0.0,0,0,0,0,bwa
2024-01-10,0,0,0.0,0,0,0,0,bwa
2024-01-09,0,0,0.0,0,0,0,0,bwa
2024-01-08,1,100,100.0,1,1000,1000,-900,bwa
2024-01-05,0,0,0.0,0,0,0,0,bwa
2024-01-04,0,0,0.0,0,0,0,0,bwa
2024-01-03,1,1000,1000.0,1,100,100,900,bwa
2024-01-02,0,0,0.0,0,0,0,0,bwa
2024-09-12,2,900,450.0,0,0,0,900,bxh
2024-09-11,2,1000,500.0,0,0,0,1000,bxh
2024-09-10,3,1100,366.67,0,0,0,1100,bxh
2024-09-09,2,1000,500.0,0,0,0,1000,bxh
2024-09-06,2,1000,500.0,0,0,0,1000,bxh
2024-09-05,2,1000,500.0,0,0,0,1000,bxh
2024-09-04,3,900,300.0,0,0,0,900,bxh
2024-08-30,8,700,87.5,1,100,100,600,bxh
2024-08-29,3,600,200.0,2,1400,700,-800,bxh
2024-08-28,1,100,100.0,1,100,100,0,bxh
2024-08-27,1,100,100.0,4,1500,375,-1400,bxh
2024-08-26,0,0,0.0,2,300,150,-300,bxh
2024-08-23,1,100,100.0,2,200,100,-100,bxh
2024-08-22,3,1600,533.33,2,300,150,1300,bxh
2024-08-21,9,7600,844.44,5,3500,700,4100,bxh
2024-08-20,2,100,50.0,8,2800,350,-2700,bxh
2024-08-19,6,300,50.0,2,1700,850,-1400,bxh
2024-08-16,17,17000,1000.0,6,16500,2750,500,bxh
2024-08-15,6,8200,1366.67,6,4600,767,3600,bxh
2024-08-14,2,500,250.0,1,300,300,200,bxh
2024-08-13,2,800,400.0,2,300,150,500,bxh
2024-08-12,7,2600,371.43,1,500,500,2100,bxh
2024-08-09,8,800,100.0,0,0,0,800,bxh
2024-08-08,3,800,266.67,1,100,100,700,bxh
2024-08-07,6,1100,183.33,0,0,0,1100,bxh
2024-08-06,10,1700,170.0,2,400,200,1300,bxh
2024-08-05,4,500,125.0,2,400,200,100,bxh
2024-08-02,5,1300,260.0,2,600,300,700,bxh
2024-08-01,3,500,166.67,1,300,300,200,bxh
2024-07-31,6,1400,233.33,2,800,400,600,bxh
2024-07-30,4,800,200.0,2,800,400,0,bxh
2024-07-29,5,2200,440.0,4,1700,425,500,bxh
2024-07-26,3,2300,766.67,1,300,300,2000,bxh
2024-07-25,7,2400,342.86,1,300,300,2100,bxh
2024-07-24,6,4000,666.67,3,1700,567,2300,bxh
2024-07-23,9,1800,200.0,2,1700,850,100,bxh
2024-07-22,4,2000,500.0,1,1300,1300,700,bxh
2024-07-19,7,2100,300.0,3,1000,333,1100,bxh
2024-07-18,1,300,300.0,6,1700,283,-1400,bxh
2024-07-17,0,0,0.0,1,1000,1000,-1000,bxh
2024-07-16,1,300,300.0,2,2300,1150,-2000,bxh
2024-07-15,4,2700,675.0,2,1200,600,1500,bxh
2024-07-12,3,1200,400.0,14,3800,271,-2600,bxh
2024-07-11,1,2100,2100.0,15,4200,280,-2100,bxh
2024-07-10,11,8600,781.82,12,10000,833,-1400,bxh
2024-07-09,7,23800,3400.0,4,23000,5750,800,bxh
2024-07-08,13,5000,384.62,3,1300,433,3700,bxh
2024-07-05,6,3700,616.67,0,0,0,3700,bxh
2024-07-04,7,24600,3514.29,2,22100,11050,2500,bxh
2024-07-03,5,2300,460.0,1,1300,1300,1000,bxh
2024-07-02,6,2700,450.0,0,0,0,2700,bxh
2024-07-01,4,1600,400.0,2,200,100,1400,bxh
2024-06-28,7,3200,457.14,0,0,0,3200,bxh
2024-06-27,13,5700,438.46,3,1500,500,4200,bxh
2024-06-26,10,4000,400.0,2,200,100,3800,bxh
2024-06-25,18,58700,3261.11,4,56300,14075,2400,bxh
2024-06-24,5,1400,280.0,1,200,200,1200,bxh
2024-06-21,8,3400,425.0,6,1500,250,1900,bxh
2024-06-20,1,400,400.0,2,1000,500,-600,bxh
2024-06-19,5,2400,480.0,12,2700,225,-300,bxh
2024-06-18,18,13200,733.33,26,9900,381,3300,bxh
2024-06-17,15,2700,180.0,17,3800,224,-1100,bxh
2024-06-14,37,8000,216.22,8,2700,338,5300,bxh
2024-06-13,18,18600,1033.33,2,16300,8150,2300,bxh
2024-06-12,23,30300,1317.39,8,28700,3588,1600,bxh
2024-06-11,19,4500,236.84,8,2500,312,2000,bxh
2024-06-10,11,3600,327.27,5,2300,460,1300,bxh
2024-06-07,6,1200,200.0,1,1000,1000,200,bxh
2024-06-06,13,2700,207.69,3,800,267,1900,bxh
2024-06-05,6,1200,200.0,4,1400,350,-200,bxh
2024-06-04,4,1300,325.0,5,300,60,1000,bxh
2024-06-03,7,1500,214.29,7,4800,686,-3300,bxh
2024-05-31,9,1400,155.56,1,500,500,900,bxh
2024-05-30,3,1500,500.0,1,500,500,1000,bxh
2024-05-29,4,1600,400.0,1,1000,1000,600,bxh
2024-05-28,1,1100,1100.0,2,2100,1050,-1000,bxh
2024-05-27,2,600,300.0,4,1300,325,-700,bxh
2024-05-24,2,50000,25000.0,10,51200,5120,-1200,bxh
2024-05-23,2,50100,25050.0,9,52700,5856,-2600,bxh
2024-05-22,0,0,0.0,3,2000,667,-2000,bxh
2024-05-21,0,0,0.0,1,500,500,-500,bxh
2024-05-20,0,0,0.0,1,600,600,-600,bxh
2024-05-17,0,0,0.0,1,500,500,-500,bxh
2024-05-16,1,1000,1000.0,4,1700,425,-700,bxh
2024-05-15,0,0,0.0,1,1000,1000,-1000,bxh
2024-05-14,0,0,0.0,2,3000,1500,-3000,bxh
2024-05-13,0,0,0.0,2,700,350,-700,bxh
2024-05-10,0,0,0.0,3,3100,1033,-3100,bxh
2024-05-09,0,0,0.0,1,600,600,-600,bxh
2024-05-08,0,0,0.0,2,2000,1000,-2000,bxh
2024-05-07,0,0,0.0,2,1600,800,-1600,bxh
2024-05-06,0,0,0.0,2,1500,750,-1500,bxh
2024-05-03,0,0,0.0,1,100,100,-100,bxh
2024-05-02,0,0,0.0,1,100,100,-100,bxh
2024-04-26,0,0,0.0,3,400,133,-400,bxh
2024-04-25,0,0,0.0,2,700,350,-700,bxh
2024-04-24,0,0,0.0,1,100,100,-100,bxh
2024-04-23,0,0,0.0,2,600,300,-600,bxh
2024-04-22,0,0,0.0,2,600,300,-600,bxh
2024-04-19,1,300,300.0,4,1000,250,-700,bxh
2024-04-17,0,0,0.0,4,1500,375,-1500,bxh
2024-04-16,0,0,0.0,2,1100,550,-1100,bxh
2024-04-15,0,0,0.0,3,700,233,-700,bxh
2024-04-12,0,0,0.0,3,1000,333,-1000,bxh
2024-04-11,0,0,0.0,1,500,500,-500,bxh
2024-04-10,0,0,0.0,1,600,600,-600,bxh
2024-04-09,0,0,0.0,2,200,100,-200,bxh
2024-04-08,0,0,0.0,3,1400,467,-1400,bxh
2024-04-05,1,300,300.0,5,1400,280,-1100,bxh
2024-04-04,0,0,0.0,2,400,200,-400,bxh
2024-04-03,0,0,0.0,2,600,300,-600,bxh
2024-04-02,0,0,0.0,1,200,200,-200,bxh
2024-04-01,0,0,0.0,4,1100,275,-1100,bxh
2024-03-29,2,200,100.0,7,1400,200,-1200,bxh
2024-03-28,1,100,100.0,2,500,250,-400,bxh
2024-03-27,0,0,0.0,1,200,200,-200,bxh
2024-03-26,0,0,0.0,3,600,200,-600,bxh
2024-03-25,0,0,0.0,2,200,100,-200,bxh
2024-03-22,0,0,0.0,2,500,250,-500,bxh
2024-03-21,0,0,0.0,3,500,167,-500,bxh
2024-03-20,1,100,100.0,5,600,120,-500,bxh
2024-03-19,0,0,0.0,3,500,167,-500,bxh
2024-03-18,2,100,50.0,1,100,100,0,bxh
2024-03-15,2,300,150.0,0,0,0,300,bxh
2024-03-14,1,100,100.0,0,0,0,100,bxh
2024-03-13,1,100,100.0,2,300,150,-200,bxh
2024-03-12,0,0,0.0,0,0,0,0,bxh
2024-03-11,0,0,0.0,1,700,700,-700,bxh
2024-03-08,0,0,0.0,1,200,200,-200,bxh
2024-03-07,0,0,0.0,1,200,200,-200,bxh
2024-03-06,2,300,150.0,2,500,250,-200,bxh
2024-03-05,4,900,225.0,3,900,300,0,bxh
2024-03-04,1,500,500.0,1,500,500,0,bxh
2024-03-01,0,0,0.0,0,0,0,0,bxh
2024-02-29,1,1000,1000.0,1,200,200,800,bxh
2024-02-28,0,0,0.0,1,200,200,-200,bxh
2024-02-27,0,0,0.0,1,700,700,-700,bxh
2024-02-26,0,0,0.0,2,1700,850,-1700,bxh
2024-02-23,0,0,0.0,1,1000,1000,-1000,bxh
2024-02-22,0,0,0.0,2,900,450,-900,bxh
2024-02-21,0,0,0.0,1,1500,1500,-1500,bxh
2024-02-20,0,0,0.0,1,700,700,-700,bxh
2024-02-19,0,0,0.0,1,500,500,-500,bxh
2024-02-16,0,0,0.0,1,1000,1000,-1000,bxh
2024-02-15,0,0,0.0,2,400,200,-400,bxh
2024-02-07,0,0,0.0,2,1200,600,-1200,bxh
2024-02-06,0,0,0.0,1,700,700,-700,bxh
2024-02-05,0,0,0.0,2,3200,1600,-3200,bxh
2024-02-02,0,0,0.0,4,1800,450,-1800,bxh
2024-02-01,0,0,0.0,0,0,0,0,bxh
2024-01-31,0,0,0.0,1,500,500,-500,bxh
2024-01-30,0,0,0.0,1,1000,1000,-1000,bxh
2024-01-29,0,0,0.0,1,2000,2000,-2000,bxh
2024-01-26,0,0,0.0,1,3000,3000,-3000,bxh
2024-01-25,0,0,0.0,1,1000,1000,-1000,bxh
2024-01-24,0,0,0.0,2,400,200,-400,bxh
2024-01-23,0,0,0.0,2,700,350,-700,bxh
2024-01-22,0,0,0.0,1,500,500,-500,bxh
2024-01-19,2,5700,2850.0,3,5900,1967,-200,bxh
2024-01-18,0,0,0.0,1,400,400,-400,bxh
2024-01-17,0,0,0.0,1,600,600,-600,bxh
2024-01-16,0,0,0.0,2,900,450,-900,bxh
2024-01-15,0,0,0.0,1,300,300,-300,bxh
2024-01-12,0,0,0.0,1,500,500,-500,bxh
2024-01-11,0,0,0.0,0,0,0,0,bxh
2024-01-10,0,0,0.0,1,200,200,-200,bxh
2024-01-09,0,0,0.0,0,0,0,0,bxh
2024-01-08,0,0,0.0,0,0,0,0,bxh
2024-01-05,0,0,0.0,0,0,0,0,bxh
2024-01-04,1,50000,50000.0,3,50200,16733,-200,bxh
2024-01-03,0,0,0.0,1,0,0,0,bxh
2024-01-02,0,0,0.0,0,0,0,0,bxh
2024-09-12,8,4100,512.5,4,11300,2825,-7200,c21
2024-09-11,5,1400,280.0,2,200,100,1200,c21
2024-09-10,6,1900,316.67,5,2800,560,-900,c21
2024-09-09,7,2700,385.71,7,10200,1457,-7500,c21
2024-09-06,5,7200,1440.0,9,12200,1356,-5000,c21
2024-09-05,19,29100,1531.58,12,21700,1808,7400,c21
2024-09-04,7,1200,171.43,2,300,150,900,c21
2024-08-30,5,2700,540.0,2,200,100,2500,c21
2024-08-29,11,23400,2127.27,7,16900,2414,6500,c21
2024-08-28,6,2300,383.33,7,70300,10043,-68000,c21
2024-08-27,14,52100,3721.43,9,48600,5400,3500,c21
2024-08-26,14,10500,750.0,7,4400,629,6100,c21
2024-08-23,13,3600,276.92,2,200,100,3400,c21
2024-08-22,12,4300,358.33,2,200,100,4100,c21
2024-08-21,13,4000,307.69,4,1400,350,2600,c21
2024-08-20,7,2800,400.0,2,1100,550,1700,c21
2024-08-19,13,5900,453.85,2,200,100,5700,c21
2024-08-16,14,3400,242.86,2,500,250,2900,c21
2024-08-15,8,3100,387.5,2,200,100,2900,c21
2024-08-14,13,4700,361.54,3,800,267,3900,c21
2024-08-13,6,1500,250.0,3,300,100,1200,c21
2024-08-12,3,900,300.0,1,100,100,800,c21
2024-08-09,17,12900,758.82,8,9000,1125,3900,c21
2024-08-08,7,1700,242.86,4,6300,1575,-4600,c21
2024-08-07,5,1300,260.0,6,7000,1167,-5700,c21
2024-08-06,9,2300,255.56,9,7700,856,-5400,c21
2024-08-05,6,1700,283.33,5,16600,3320,-14900,c21
2024-08-02,4,2000,500.0,4,6300,1575,-4300,c21
2024-08-01,5,1300,260.0,5,6400,1280,-5100,c21
2024-07-31,10,6900,690.0,5,7300,1460,-400,c21
2024-07-30,7,2900,414.29,5,8000,1600,-5100,c21
2024-07-29,6,2800,466.67,5,8400,1680,-5600,c21
2024-07-26,6,2700,450.0,7,13400,1914,-10700,c21
2024-07-25,10,3200,320.0,4,6300,1575,-3100,c21
2024-07-24,6,2300,383.33,5,2500,500,-200,c21
2024-07-23,6,2900,483.33,5,10900,2180,-8000,c21
2024-07-22,5,2200,440.0,6,2700,450,-500,c21
2024-07-19,5,1700,340.0,8,3500,438,-1800,c21
2024-07-18,5,1700,340.0,6,2400,400,-700,c21
2024-07-17,5,1500,300.0,6,2400,400,-900,c21
2024-07-16,10,6800,680.0,7,5500,786,1300,c21
2024-07-15,9,3500,388.89,8,4000,500,-500,c21
2024-07-12,8,3000,375.0,5,1400,280,1600,c21
2024-07-11,10,10000,1000.0,10,13900,1390,-3900,c21
2024-07-10,7,4200,600.0,10,6400,640,-2200,c21
2024-07-09,19,8700,457.89,6,6400,1067,2300,c21
2024-07-08,5,1400,280.0,5,700,140,700,c21
2024-07-05,7,3300,471.43,6,1000,167,2300,c21
2024-07-04,9,7300,811.11,7,9800,1400,-2500,c21
2024-07-03,12,7900,658.33,8,4500,562,3400,c21
2024-07-02,7,3300,471.43,6,1700,283,1600,c21
2024-07-01,7,2700,385.71,7,9800,1400,-7100,c21
2024-06-28,9,9200,1022.22,6,3500,583,5700,c21
2024-06-27,8,4500,562.5,8,3700,462,800,c21
2024-06-26,7,3100,442.86,5,700,140,2400,c21
2024-06-25,8,3900,487.5,6,1700,283,2200,c21
2024-06-24,7,3400,485.71,5,1400,280,2000,c21
2024-06-21,15,6500,433.33,8,1100,138,5400,c21
2024-06-20,12,3900,325.0,3,1100,367,2800,c21
2024-06-19,10,2500,250.0,9,3900,433,-1400,c21
2024-06-18,7,1900,271.43,5,4000,800,-2100,c21
2024-06-17,11,5300,481.82,5,600,120,4700,c21
2024-06-14,16,5200,325.0,11,2500,227,2700,c21
2024-06-13,11,1300,118.18,18,73700,4094,-72400,c21
2024-06-12,29,22200,765.52,20,14900,745,7300,c21
2024-06-11,9,4100,455.56,12,3000,250,1100,c21
2024-06-10,13,8000,615.38,11,3100,282,4900,c21
2024-06-07,16,5700,356.25,6,600,100,5100,c21
2024-06-06,15,6600,440.0,7,2600,371,4000,c21
2024-06-05,16,4300,268.75,12,8200,683,-3900,c21
2024-06-04,12,4500,375.0,15,10000,667,-5500,c21
2024-06-03,18,12900,716.67,21,18200,867,-5300,c21
2024-05-31,14,7200,514.29,7,1400,200,5800,c21
2024-05-30,8,2100,262.5,9,1100,122,1000,c21
2024-05-29,21,5600,266.67,5,800,160,4800,c21
2024-05-28,11,4800,436.36,18,16700,928,-11900,c21
2024-05-27,8,2200,275.0,21,52600,2505,-50400,c21
2024-05-24,31,104400,3367.74,38,114000,3000,-9600,c21
2024-05-23,23,33500,1456.52,23,29100,1265,4400,c21
2024-05-22,44,65700,1493.18,46,66800,1452,-1100,c21
2024-05-21,20,10300,515.0,26,27400,1054,-17100,c21
2024-05-20,29,37200,1282.76,22,28800,1309,8400,c21
2024-05-17,7,2600,371.43,5,12800,2560,-10200,c21
2024-05-16,7,3500,500.0,5,12700,2540,-9200,c21
2024-05-15,7,2500,357.14,4,12500,3125,-10000,c21
2024-05-14,8,3600,450.0,4,900,225,2700,c21
2024-05-13,8,7400,925.0,3,13100,4367,-5700,c21
2024-05-10,7,3800,542.86,0,0,0,3800,c21
2024-05-09,5,1800,360.0,5,2300,460,-500,c21
2024-05-08,9,4500,500.0,9,3500,389,1000,c21
2024-05-07,10,11800,1180.0,3,11100,3700,700,c21
2024-05-06,8,3500,437.5,5,11800,2360,-8300,c21
2024-05-03,9,4200,466.67,4,600,150,3600,c21
2024-05-02,9,4400,488.89,4,1900,475,2500,c21
2024-04-26,8,2700,337.5,5,800,160,1900,c21
2024-04-25,20,22000,1100.0,9,13200,1467,8800,c21
2024-04-24,6,3000,500.0,5,1100,220,1900,c21
2024-04-23,10,4200,420.0,1,100,100,4100,c21
2024-04-22,10,4700,470.0,0,0,0,4700,c21
2024-04-19,8,2200,275.0,2,200,100,2000,c21
2024-04-17,7,3400,485.71,6,2100,350,1300,c21
2024-04-16,5,1600,320.0,4,500,125,1100,c21
2024-04-15,10,4300,430.0,8,1100,138,3200,c21
2024-04-12,8,14800,1850.0,7,17900,2557,-3100,c21
2024-04-11,10,4000,400.0,9,8300,922,-4300,c21
2024-04-10,4,1400,350.0,8,2200,275,-800,c21
2024-04-09,5,2200,440.0,5,1900,380,300,c21
2024-04-08,5,2400,480.0,8,4100,512,-1700,c21
2024-04-05,9,2700,300.0,5,1900,380,800,c21
2024-04-04,9,3500,388.89,6,2900,483,600,c21
2024-04-03,8,4900,612.5,6,2000,333,2900,c21
2024-04-02,13,5500,423.08,4,500,125,5000,c21
2024-04-01,9,3200,355.56,4,500,125,2700,c21
2024-03-29,11,5000,454.55,12,8400,700,-3400,c21
2024-03-28,8,3700,462.5,6,2000,333,1700,c21
2024-03-27,11,10100,918.18,6,11700,1950,-1600,c21
2024-03-26,9,12300,1366.67,9,9800,1089,2500,c21
2024-03-25,19,11900,626.32,9,7700,856,4200,c21
2024-03-22,9,2700,300.0,3,300,100,2400,c21
2024-03-21,8,3400,425.0,5,8300,1660,-4900,c21
2024-03-20,6,1700,283.33,2,200,100,1500,c21
2024-03-19,8,2100,262.5,2,200,100,1900,c21
2024-03-18,8,2400,300.0,4,800,200,1600,c21
2024-03-15,6,1400,233.33,5,1600,320,-200,c21
2024-03-14,7,1700,242.86,6,1600,267,100,c21
2024-03-13,10,3700,370.0,7,1800,257,1900,c21
2024-03-12,5,2000,400.0,4,500,125,1500,c21
2024-03-11,6,2700,450.0,5,3800,760,-1100,c21
2024-03-08,6,1900,316.67,6,700,117,1200,c21
2024-03-07,7,2900,414.29,4,500,125,2400,c21
2024-03-06,8,2800,350.0,5,2900,580,-100,c21
2024-03-05,5,1500,300.0,4,600,150,900,c21
2024-03-04,7,2500,357.14,3,400,133,2100,c21
2024-03-01,8,2700,337.5,4,600,150,2100,c21
2024-02-29,5,1900,380.0,9,15500,1722,-13600,c21
2024-02-28,10,3700,370.0,10,2500,250,1200,c21
2024-02-27,6,2700,450.0,5,2800,560,-100,c21
2024-02-26,8,4200,525.0,4,700,175,3500,c21
2024-02-23,7,2200,314.29,5,1400,280,800,c21
2024-02-22,5,1700,340.0,6,1100,183,600,c21
2024-02-21,7,2500,357.14,4,500,125,2000,c21
2024-02-20,6,1400,233.33,4,600,150,800,c21
2024-02-19,8,2900,362.5,6,4900,817,-2000,c21
2024-02-16,9,3800,422.22,6,4900,817,-1100,c21
2024-02-15,7,2400,342.86,5,1900,380,500,c21
2024-02-07,5,1400,280.0,5,1900,380,-500,c21
2024-02-06,8,4600,575.0,5,1900,380,2700,c21
2024-02-05,9,3100,344.44,4,1800,450,1300,c21
2024-02-02,11,4600,418.18,4,3800,950,800,c21
2024-02-01,6,3500,583.33,7,4000,571,-500,c21
2024-01-31,9,3900,433.33,7,2700,386,1200,c21
2024-01-30,7,2800,400.0,6,2100,350,700,c21
2024-01-29,12,6200,516.67,4,1100,275,5100,c21
2024-01-26,12,6100,508.33,5,2000,400,4100,c21
2024-01-25,13,7000,538.46,8,2600,325,4400,c21
2024-01-24,16,5700,356.25,6,2500,417,3200,c21
2024-01-23,13,3600,276.92,7,2400,343,1200,c21
2024-01-22,16,9600,600.0,8,2600,325,7000,c21
2024-01-19,17,7500,441.18,15,7300,487,200,c21
2024-01-18,12,3000,250.0,8,2800,350,200,c21
2024-01-17,11,3900,354.55,9,15600,1733,-11700,c21
2024-01-16,13,6600,507.69,12,15800,1317,-9200,c21
2024-01-15,20,11600,580.0,13,7300,562,4300,c21
2024-01-12,15,5400,360.0,12,2500,208,2900,c21
2024-01-11,12,3600,300.0,6,2100,350,1500,c21
2024-01-10,13,8100,623.08,14,10800,771,-2700,c21
2024-01-09,21,8300,395.24,11,3800,345,4500,c21
2024-01-08,15,7400,493.33,7,1300,186,6100,c21
2024-01-05,9,4400,488.89,3,600,200,3800,c21
2024-01-04,7,2100,300.0,1,100,100,2000,c21
2024-01-03,12,2800,233.33,2,200,100,2600,c21
2024-01-02,15,3400,226.67,3,400,133,3000,c21
2024-09-12,323,716500,2218.27,180,602900,3349,113600,c69
2024-09-11,336,554500,1650.3,349,1059300,3035,-504800,c69
2024-09-10,367,690400,1881.2,389,1065900,2740,-375500,c69
2024-09-09,350,713700,2039.14,289,845500,2926,-131800,c69
2024-09-06,504,1412500,2802.58,572,1643400,2873,-230900,c69
2024-09-05,285,1034500,3629.82,235,679100,2890,355400,c69
2024-09-04,229,737400,3220.09,230,734200,3192,3200,c69
2024-08-30,273,1222500,4478.02,248,884800,3568,337700,c69
2024-08-29,243,596100,2453.09,240,828300,3451,-232200,c69
2024-08-28,300,894000,2980.0,387,1184900,3062,-290900,c69
2024-08-27,422,1376600,3262.09,491,1404700,2861,-28100,c69
2024-08-26,275,1057800,3846.55,342,962900,2815,94900,c69
2024-08-23,221,652000,2950.23,248,957500,3861,-305500,c69
2024-08-22,285,818100,2870.53,263,930400,3538,-112300,c69
2024-08-21,284,631200,2222.54,286,811000,2836,-179800,c69
2024-08-20,315,554300,1759.68,368,1080700,2937,-526400,c69
2024-08-19,285,511600,1795.09,322,907100,2817,-395500,c69
2024-08-16,317,641200,2022.71,314,711400,2266,-70200,c69
2024-08-15,407,971900,2387.96,386,1308300,3389,-336400,c69
2024-08-14,216,513400,2376.85,206,550900,2674,-37500,c69
2024-08-13,187,520100,2781.28,239,556600,2329,-36500,c69
2024-08-12,253,552800,2184.98,208,542700,2609,10100,c69
2024-08-09,289,560300,1938.75,147,560200,3811,100,c69
2024-08-08,251,517900,2063.35,182,572100,3143,-54200,c69
2024-08-07,248,490100,1976.21,182,609800,3351,-119700,c69
2024-08-06,242,496100,2050.0,196,627600,3202,-131500,c69
2024-08-05,170,294800,1734.12,149,423300,2841,-128500,c69
2024-08-02,257,512700,1994.94,276,672700,2437,-160000,c69
2024-08-01,200,432900,2164.5,341,842600,2471,-409700,c69
2024-07-31,361,886700,2456.23,389,1043000,2681,-156300,c69
2024-07-30,258,735200,2849.61,393,1049800,2671,-314600,c69
2024-07-29,383,927200,2420.89,442,1059100,2396,-131900,c69
2024-07-26,360,982400,2728.89,428,1143500,2672,-161100,c69
2024-07-25,329,876100,2662.92,341,887200,2602,-11100,c69
2024-07-24,391,807500,2065.22,263,715600,2721,91900,c69
2024-07-23,235,422200,1796.6,185,504000,2724,-81800,c69
2024-07-22,229,410300,1791.7,285,566900,1989,-156600,c69
2024-07-19,290,499800,1723.45,211,508200,2409,-8400,c69
2024-07-18,279,645400,2313.26,306,754600,2466,-109200,c69
2024-07-17,237,428700,1808.86,266,769900,2894,-341200,c69
2024-07-16,292,663100,2270.89,217,718100,3309,-55000,c69
2024-07-15,258,545100,2112.79,204,687700,3371,-142600,c69
2024-07-12,396,700700,1769.44,269,955100,3551,-254400,c69
2024-07-11,205,450200,2196.1,212,642100,3029,-191900,c69
2024-07-10,289,673000,2328.72,265,732000,2762,-59000,c69
2024-07-09,258,645100,2500.39,270,677900,2511,-32800,c69
2024-07-08,308,755900,2454.22,339,689500,2034,66400,c69
2024-07-05,380,819100,2155.53,298,754600,2532,64500,c69
2024-07-04,326,828800,2542.33,269,806900,3000,21900,c69
2024-07-03,279,808400,2897.49,221,585600,2650,222800,c69
2024-07-02,275,666400,2423.27,158,634500,4016,31900,c69
2024-07-01,257,598600,2329.18,163,701100,4301,-102500,c69
2024-06-28,274,611300,2231.02,208,743600,3575,-132300,c69
2024-06-27,227,553900,2440.09,187,596200,3188,-42300,c69
2024-06-26,274,688300,2512.04,214,817900,3822,-129600,c69
2024-06-25,281,611400,2175.8,185,740400,4002,-129000,c69
2024-06-24,304,638900,2101.64,296,741600,2505,-102700,c69
2024-06-21,356,697900,1960.39,292,707500,2423,-9600,c69
2024-06-20,281,605200,2153.74,262,773900,2954,-168700,c69
2024-06-19,309,750600,2429.13,281,943100,3356,-192500,c69
2024-06-18,277,621300,2242.96,251,701300,2794,-80000,c69
2024-06-17,365,1083400,2968.22,223,718900,3224,364500,c69
2024-06-14,261,647200,2479.69,502,1545600,3079,-898400,c69
2024-06-13,481,1277300,2655.51,589,1267500,2152,9800,c69
2024-06-12,320,776700,2427.19,293,733400,2503,43300,c69
2024-06-11,321,989600,3082.87,335,1014200,3027,-24600,c69
2024-06-10,288,535200,1858.33,239,711100,2975,-175900,c69
2024-06-07,296,629400,2126.35,251,784500,3125,-155100,c69
2024-06-06,230,409400,1780.0,217,565300,2605,-155900,c69
2024-06-05,276,532500,1929.35,231,648100,2806,-115600,c69
2024-06-04,252,523800,2078.57,237,752900,3177,-229100,c69
2024-06-03,336,772300,2298.51,326,914700,2806,-142400,c69
2024-05-31,250,519000,2076.0,240,708000,2950,-189000,c69
2024-05-30,282,872100,3092.55,334,838400,2510,33700,c69
2024-05-29,246,512200,2082.11,191,498700,2611,13500,c69
2024-05-28,268,523600,1953.73,204,469900,2303,53700,c69
2024-05-27,246,518000,2105.69,205,524100,2557,-6100,c69
2024-05-24,267,648800,2429.96,380,756600,1991,-107800,c69
2024-05-23,199,462300,2323.12,227,581900,2563,-119600,c69
2024-05-22,289,535700,1853.63,198,593000,2995,-57300,c69
2024-05-21,291,600800,2064.6,317,808100,2549,-207300,c69
2024-05-20,217,503300,2319.35,232,460300,1984,43000,c69
2024-05-17,253,398100,1573.52,249,468600,1882,-70500,c69
2024-05-16,256,710800,2776.56,235,396500,1687,314300,c69
2024-05-15,272,493400,1813.97,163,611100,3749,-117700,c69
2024-05-14,261,520400,1993.87,247,632700,2562,-112300,c69
2024-05-13,264,1135000,4299.24,313,914000,2920,221000,c69
2024-05-10,308,519400,1686.36,207,475000,2295,44400,c69
2024-05-09,353,601600,1704.25,243,737500,3035,-135900,c69
2024-05-08,257,398900,1552.14,215,715300,3327,-316400,c69
2024-05-07,352,740900,2104.83,276,473000,1714,267900,c69
2024-05-06,258,689300,2671.71,228,372600,1634,316700,c69
2024-05-03,238,406200,1706.72,188,401700,2137,4500,c69
2024-05-02,202,316100,1564.85,190,389000,2047,-72900,c69
2024-04-26,199,445800,2240.2,180,506100,2812,-60300,c69
2024-04-25,259,520500,2009.65,168,496100,2953,24400,c69
2024-04-24,300,579100,1930.33,197,536200,2722,42900,c69
2024-04-23,270,417700,1547.04,165,394600,2392,23100,c69
2024-04-22,317,433700,1368.14,172,499900,2906,-66200,c69
2024-04-19,266,528100,1985.34,175,770400,4402,-242300,c69
2024-04-17,226,669300,2961.5,197,536200,2722,133100,c69
2024-04-16,220,354000,1609.09,230,553200,2405,-199200,c69
2024-04-15,362,394500,1089.78,340,767100,2256,-372600,c69
2024-04-12,399,726700,1821.3,344,754200,2192,-27500,c69
2024-04-11,493,797500,1617.65,503,1188600,2363,-391100,c69
2024-04-10,546,1300500,2381.87,633,1510200,2386,-209700,c69
2024-04-09,502,1592500,3172.31,434,1150900,2652,441600,c69
2024-04-08,316,500800,1584.81,182,520700,2861,-19900,c69
2024-04-05,411,712600,1733.82,237,860200,3630,-147600,c69
2024-04-04,419,862700,2058.95,299,1193100,3990,-330400,c69
2024-04-03,332,642000,1933.73,256,798900,3121,-156900,c69
2024-04-02,333,904100,2715.02,284,824800,2904,79300,c69
2024-04-01,331,826700,2497.58,274,804500,2936,22200,c69
2024-03-29,429,784700,1829.14,298,754100,2531,30600,c69
2024-03-28,373,807700,2165.42,342,879700,2572,-72000,c69
2024-03-27,383,851500,2223.24,300,811700,2706,39800,c69
2024-03-26,383,829300,2165.27,246,739500,3006,89800,c69
2024-03-25,353,770500,2182.72,251,762600,3038,7900,c69
2024-03-22,404,968400,2397.03,383,972600,2539,-4200,c69
2024-03-21,523,1570400,3002.68,500,1435100,2870,135300,c69
2024-03-20,347,870300,2508.07,343,912100,2659,-41800,c69
2024-03-19,478,1100100,2301.46,351,855600,2438,244500,c69
2024-03-18,561,1244900,2219.07,399,1373700,3443,-128800,c69
2024-03-15,440,881900,2004.32,352,978900,2781,-97000,c69
2024-03-14,427,1117500,2617.1,314,1281800,4082,-164300,c69
2024-03-13,283,687100,2427.92,382,977000,2558,-289900,c69
2024-03-12,309,870100,2815.86,306,1163600,3803,-293500,c69
2024-03-11,341,705400,2068.62,290,1053500,3633,-348100,c69
2024-03-08,444,711900,1603.38,256,1118500,4369,-406600,c69
2024-03-07,480,723900,1508.12,263,783600,2979,-59700,c69
2024-03-06,423,691000,1633.57,325,1076700,3313,-385700,c69
2024-03-05,382,604300,1581.94,366,843600,2305,-239300,c69
2024-03-04,398,960500,2413.32,375,1044600,2786,-84100,c69
2024-03-01,432,729900,1689.58,314,929100,2959,-199200,c69
2024-02-29,357,702500,1967.79,276,945700,3426,-243200,c69
2024-02-28,378,671900,1777.51,260,887100,3412,-215200,c69
2024-02-27,480,704500,1467.71,294,777000,2643,-72500,c69
2024-02-26,357,854400,2393.28,345,1024600,2970,-170200,c69
2024-02-23,484,1193800,2466.53,583,1678500,2879,-484700,c69
2024-02-22,514,905400,1761.48,558,1283400,2300,-378000,c69
2024-02-21,866,2153700,2486.95,550,1551200,2820,602500,c69
2024-02-20,321,783300,2440.19,289,799500,2766,-16200,c69
2024-02-19,282,581500,2062.06,209,585100,2800,-3600,c69
2024-02-16,272,515800,1896.32,250,554100,2216,-38300,c69
2024-02-15,315,775200,2460.95,264,714100,2705,61100,c69
2024-02-07,154,457100,2968.18,190,539000,2837,-81900,c69
2024-02-06,174,426700,2452.3,186,564600,3035,-137900,c69
2024-02-05,216,423800,1962.04,193,538900,2792,-115100,c69
2024-02-02,181,522900,2888.95,230,604700,2629,-81800,c69
2024-02-01,190,385400,2028.42,225,551300,2450,-165900,c69
2024-01-31,231,394000,1705.63,209,559600,2678,-165600,c69
2024-01-30,235,379100,1613.19,221,539900,2443,-160800,c69
2024-01-29,230,398700,1733.48,269,686500,2552,-287800,c69
2024-01-26,249,351600,1412.05,187,528200,2825,-176600,c69
2024-01-25,251,430000,1713.15,197,552900,2807,-122900,c69
2024-01-24,227,467800,2060.79,242,513500,2122,-45700,c69
2024-01-23,226,422900,1871.24,201,411000,2045,11900,c69
2024-01-22,181,353300,1951.93,163,418400,2567,-65100,c69
2024-01-19,203,517000,2546.8,265,603700,2278,-86700,c69
2024-01-18,260,776700,2987.31,280,908400,3244,-131700,c69
2024-01-17,207,450500,2176.33,178,709200,3984,-258700,c69
2024-01-16,217,355600,1638.71,197,537900,2730,-182300,c69
2024-01-15,195,415800,2132.31,139,424000,3050,-8200,c69
2024-01-12,352,716600,2035.8,193,803400,4163,-86800,c69
2024-01-11,202,627300,3105.45,176,612300,3479,15000,c69
2024-01-10,215,498700,2319.53,179,538600,3009,-39900,c69
2024-01-09,335,706800,2109.85,240,797700,3324,-90900,c69
2024-01-08,332,728500,2194.28,199,632000,3176,96500,c69
2024-01-05,243,543400,2236.21,271,653600,2412,-110200,c69
2024-01-04,194,553000,2850.52,255,641800,2517,-88800,c69
2024-01-03,279,826000,2960.57,361,643400,1782,182600,c69
2024-01-02,198,530900,2681.31,207,562700,2718,-31800,c69
2024-09-12,30,27900,930.0,20,17400,870,10500,c92
2024-09-11,48,36600,762.5,30,46800,1560,-10200,c92
2024-09-10,44,26200,595.45,39,44700,1146,-18500,c92
2024-09-09,24,12400,516.67,32,28200,881,-15800,c92
2024-09-06,30,25900,863.33,40,55300,1382,-29400,c92
2024-09-05,31,31300,1009.68,42,44600,1062,-13300,c92
2024-09-04,36,28600,794.44,48,42900,894,-14300,c92
2024-08-30,47,59700,1270.21,49,55700,1137,4000,c92
2024-08-29,51,31400,615.69,27,27300,1011,4100,c92
2024-08-28,70,55800,797.14,29,36100,1245,19700,c92
2024-08-27,82,49300,601.22,52,83500,1606,-34200,c92
2024-08-26,34,20600,605.88,29,24500,845,-3900,c92
2024-08-23,48,27000,562.5,40,38000,950,-11000,c92
2024-08-22,93,67000,720.43,44,65100,1480,1900,c92
2024-08-21,62,43100,695.16,25,35200,1408,7900,c92
2024-08-20,68,165700,2436.76,56,67500,1205,98200,c92
2024-08-19,50,27500,550.0,52,54900,1056,-27400,c92
2024-08-16,71,244300,3440.85,35,113600,3246,130700,c92
2024-08-15,112,335300,2993.75,42,119900,2855,215400,c92
2024-08-14,12,15100,1258.33,16,92500,5781,-77400,c92
2024-08-13,15,30500,2033.33,21,91700,4367,-61200,c92
2024-08-12,7,16300,2328.57,20,76900,3845,-60600,c92
2024-08-09,6,14900,2483.33,21,82100,3910,-67200,c92
2024-08-08,11,16900,1536.36,19,108200,5695,-91300,c92
2024-08-07,16,19400,1212.5,12,54700,4558,-35300,c92
2024-08-06,22,37000,1681.82,23,78900,3430,-41900,c92
2024-08-05,19,26500,1394.74,28,73400,2621,-46900,c92
2024-08-02,23,55500,2413.04,21,61800,2943,-6300,c92
2024-08-01,29,53000,1827.59,26,67700,2604,-14700,c92
2024-07-31,35,47700,1362.86,24,36400,1517,11300,c92
2024-07-30,60,71200,1186.67,50,53300,1066,17900,c92
2024-07-29,67,67200,1002.99,47,50000,1064,17200,c92
2024-07-26,46,31400,682.61,28,41400,1479,-10000,c92
2024-07-25,28,26700,953.57,32,38300,1197,-11600,c92
2024-07-24,59,49100,832.2,40,42500,1062,6600,c92
2024-07-23,30,8600,286.67,32,41100,1284,-32500,c92
2024-07-22,43,17600,409.3,40,40300,1008,-22700,c92
2024-07-19,68,41500,610.29,35,31100,889,10400,c92
2024-07-18,68,47400,697.06,42,45100,1074,2300,c92
2024-07-17,79,42100,532.91,39,62700,1608,-20600,c92
2024-07-16,77,49300,640.26,34,40500,1191,8800,c92
2024-07-15,36,22100,613.89,21,36000,1714,-13900,c92
2024-07-12,64,40800,637.5,46,56100,1220,-15300,c92
2024-07-11,51,15900,311.76,35,37000,1057,-21100,c92
2024-07-10,60,34700,578.33,29,45200,1559,-10500,c92
2024-07-09,56,55100,983.93,35,43100,1231,12000,c92
2024-07-08,39,19400,497.44,33,25900,785,-6500,c92
2024-07-05,69,120300,1743.48,49,105600,2155,14700,c92
2024-07-04,50,36900,738.0,44,34900,793,2000,c92
2024-07-03,45,52000,1155.56,14,10800,771,41200,c92
2024-07-02,122,109000,893.44,40,84900,2122,24100,c92
2024-07-01,23,25700,1117.39,27,92500,3426,-66800,c92
2024-06-28,50,39100,782.0,53,113900,2149,-74800,c92
2024-06-27,32,56600,1768.75,60,113900,1898,-57300,c92
2024-06-26,77,114100,1481.82,87,135800,1561,-21700,c92
2024-06-25,127,523700,4123.62,52,245500,4721,278200,c92
2024-06-24,92,552800,6008.7,39,94100,2413,458700,c92
2024-06-21,36,563900,15663.89,25,23300,932,540600,c92
2024-06-20,18,27000,1500.0,21,88100,4195,-61100,c92
2024-06-19,24,55200,2300.0,35,84300,2409,-29100,c92
2024-06-18,29,56400,1944.83,35,82900,2369,-26500,c92
2024-06-17,78,506300,6491.03,43,172700,4016,333600,c92
2024-06-14,30,425900,14196.67,43,52500,1221,373400,c92
2024-06-13,29,58100,2003.45,43,50100,1165,8000,c92
2024-06-12,6,19100,3183.33,15,63600,4240,-44500,c92
2024-06-11,7,9600,1371.43,20,72100,3605,-62500,c92
2024-06-10,30,69900,2330.0,33,30100,912,39800,c92
2024-06-07,28,111000,3964.29,28,104500,3732,6500,c92
2024-06-06,10,5600,560.0,10,25100,2510,-19500,c92
2024-06-05,12,57500,4791.67,16,24500,1531,33000,c92
2024-06-04,14,60800,4342.86,9,16600,1844,44200,c92
2024-06-03,10,52200,5220.0,12,23400,1950,28800,c92
2024-05-31,7,56800,8114.29,10,44200,4420,12600,c92
2024-05-30,4,51800,12950.0,20,26800,1340,25000,c92
2024-05-29,7,34400,4914.29,15,22600,1507,11800,c92
2024-05-28,14,43300,3092.86,18,23200,1289,20100,c92
2024-05-27,13,36100,2776.92,13,30900,2377,5200,c92
2024-05-24,19,58500,3078.95,24,55500,2312,3000,c92
2024-05-23,8,9900,1237.5,15,30800,2053,-20900,c92
2024-05-22,10,11300,1130.0,18,38800,2156,-27500,c92
2024-05-21,14,18900,1350.0,22,43500,1977,-24600,c92
2024-05-20,28,24300,867.86,27,37900,1404,-13600,c92
2024-05-17,14,27800,1985.71,32,49100,1534,-21300,c92
2024-05-16,21,13200,628.57,29,35000,1207,-21800,c92
2024-05-15,15,22200,1480.0,26,37700,1450,-15500,c92
2024-05-14,13,38900,2992.31,21,30100,1433,8800,c92
2024-05-13,11,17400,1581.82,21,29500,1405,-12100,c92
2024-05-10,11,6400,581.82,23,33300,1448,-26900,c92
2024-05-09,15,15400,1026.67,35,46200,1320,-30800,c92
2024-05-08,11,9700,881.82,32,58100,1816,-48400,c92
2024-05-07,31,36600,1180.65,26,49500,1904,-12900,c92
2024-05-06,3,600,200.0,16,28300,1769,-27700,c92
2024-05-03,3,1100,366.67,15,35000,2333,-33900,c92
2024-05-02,20,11300,565.0,16,19400,1212,-8100,c92
2024-04-26,12,6000,500.0,18,27700,1539,-21700,c92
2024-04-25,4,2500,625.0,29,31000,1069,-28500,c92
2024-04-24,15,10000,666.67,24,26700,1112,-16700,c92
2024-04-23,6,4900,816.67,25,31900,1276,-27000,c92
2024-04-22,6,2300,383.33,18,18700,1039,-16400,c92
2024-04-19,14,7200,514.29,15,21300,1420,-14100,c92
2024-04-17,22,14900,677.27,20,31200,1560,-16300,c92
2024-04-16,3,600,200.0,15,18700,1247,-18100,c92
2024-04-15,7,2700,385.71,22,25000,1136,-22300,c92
2024-04-12,14,5900,421.43,28,42300,1511,-36400,c92
2024-04-11,16,13600,850.0,20,23200,1160,-9600,c92
2024-04-10,16,15800,987.5,20,18600,930,-2800,c92
2024-04-09,22,32000,1454.55,25,33600,1344,-1600,c92
2024-04-08,28,13300,475.0,28,37000,1321,-23700,c92
2024-04-05,27,13000,481.48,35,34100,974,-21100,c92
2024-04-04,15,7200,480.0,17,18000,1059,-10800,c92
2024-04-03,32,15500,484.38,30,31000,1033,-15500,c92
2024-04-02,18,10800,600.0,32,29000,906,-18200,c92
2024-04-01,23,8000,347.83,28,36600,1307,-28600,c92
2024-03-29,18,19800,1100.0,37,46500,1257,-26700,c92
2024-03-28,18,10300,572.22,23,23700,1030,-13400,c92
2024-03-27,29,20100,693.1,27,27800,1030,-7700,c92
2024-03-26,40,45900,1147.5,52,66400,1277,-20500,c92
2024-03-25,15,6800,453.33,21,24000,1143,-17200,c92
2024-03-22,25,17200,688.0,32,34900,1091,-17700,c92
2024-03-21,29,17700,610.34,27,36600,1356,-18900,c92
2024-03-20,39,45400,1164.1,40,37300,932,8100,c92
2024-03-19,26,53100,2042.31,42,45100,1074,8000,c92
2024-03-18,28,29900,1067.86,44,39400,895,-9500,c92
2024-03-15,51,54000,1058.82,33,36700,1112,17300,c92
2024-03-14,47,88000,1872.34,27,30200,1119,57800,c92
2024-03-13,50,46800,936.0,20,10000,500,36800,c92
2024-03-12,85,92800,1091.76,40,60100,1502,32700,c92
2024-03-11,31,26300,848.39,33,38300,1161,-12000,c92
2024-03-08,52,51900,998.08,32,26400,825,25500,c92
2024-03-07,80,69900,873.75,68,100800,1482,-30900,c92
2024-03-06,80,74300,928.75,69,95400,1383,-21100,c92
2024-03-05,61,48400,793.44,16,33900,2119,14500,c92
2024-03-04,69,94100,1363.77,51,54000,1059,40100,c92
2024-03-01,17,11700,688.24,20,20400,1020,-8700,c92
2024-02-29,37,22900,618.92,36,35600,989,-12700,c92
2024-02-28,31,31700,1022.58,31,35200,1135,-3500,c92
2024-02-27,19,14500,763.16,27,33500,1241,-19000,c92
2024-02-26,27,20000,740.74,30,40700,1357,-20700,c92
2024-02-23,22,9500,431.82,27,25200,933,-15700,c92
2024-02-22,17,17000,1000.0,19,21400,1126,-4400,c92
2024-02-21,28,46800,1671.43,26,30400,1169,16400,c92
2024-02-20,13,11200,861.54,22,20200,918,-9000,c92
2024-02-19,24,18400,766.67,24,25100,1046,-6700,c92
2024-02-16,18,17000,944.44,21,22200,1057,-5200,c92
2024-02-15,15,10300,686.67,16,11400,712,-1100,c92
2024-02-07,14,14600,1042.86,15,24600,1640,-10000,c92
2024-02-06,12,4200,350.0,13,20900,1608,-16700,c92
2024-02-05,12,10200,850.0,15,22300,1487,-12100,c92
2024-02-02,9,7800,866.67,20,25600,1280,-17800,c92
2024-02-01,7,7100,1014.29,12,21600,1800,-14500,c92
2024-01-31,11,7700,700.0,16,24900,1556,-17200,c92
2024-01-30,18,15300,850.0,10,10000,1000,5300,c92
2024-01-29,18,31500,1750.0,13,15800,1215,15700,c92
2024-01-26,24,19700,820.83,14,17100,1221,2600,c92
2024-01-25,7,5900,842.86,15,14700,980,-8800,c92
2024-01-24,5,9500,1900.0,17,20900,1229,-11400,c92
2024-01-23,7,5600,800.0,12,18100,1508,-12500,c92
2024-01-22,10,8100,810.0,13,17600,1354,-9500,c92
2024-01-19,10,9600,960.0,21,22300,1062,-12700,c92
2024-01-18,17,25800,1517.65,19,23700,1247,2100,c92
2024-01-17,10,12400,1240.0,17,19100,1124,-6700,c92
2024-01-16,11,9800,890.91,11,12200,1109,-2400,c92
2024-01-15,12,15000,1250.0,15,19800,1320,-4800,c92
2024-01-12,10,9300,930.0,14,12300,879,-3000,c92
2024-01-11,15,13100,873.33,21,23600,1124,-10500,c92
2024-01-10,5,2100,420.0,12,19500,1625,-17400,c92
2024-01-09,8,7500,937.5,18,19900,1106,-12400,c92
2024-01-08,19,9600,505.26,26,30500,1173,-20900,c92
2024-01-05,20,20300,1015.0,23,29200,1270,-8900,c92
2024-01-04,17,16400,964.71,23,24500,1065,-8100,c92
2024-01-03,9,5500,611.11,21,18800,895,-13300,c92
2024-01-02,11,22000,2000.0,11,17900,1627,4100,c92
2024-09-12,3,1000,333.33,4,2700,675,-1700,can
2024-09-11,5,1200,240.0,3,300,100,900,can
2024-09-10,4,1300,325.0,3,2100,700,-800,can
2024-09-09,4,1400,350.0,3,2100,700,-700,can
2024-09-06,4,1400,350.0,3,2100,700,-700,can
2024-09-05,3,400,133.33,3,2100,700,-1700,can
2024-09-04,5,1500,300.0,3,2100,700,-600,can
2024-08-30,4,1400,350.0,3,2200,733,-800,can
2024-08-29,4,1400,350.0,2,2900,1450,-1500,can
2024-08-28,4,400,100.0,6,3000,500,-2600,can
2024-08-27,0,0,0.0,3,2200,733,-2200,can
2024-08-26,0,0,0.0,5,4000,800,-4000,can
2024-08-23,0,0,0.0,4,2400,600,-2400,can
2024-08-22,0,0,0.0,5,3300,660,-3300,can
2024-08-21,0,0,0.0,4,2300,575,-2300,can
2024-08-20,0,0,0.0,4,3300,825,-3300,can
2024-08-19,0,0,0.0,6,2600,433,-2600,can
2024-08-16,0,0,0.0,3,2200,733,-2200,can
2024-08-15,0,0,0.0,3,2200,733,-2200,can
2024-08-14,0,0,0.0,4,3200,800,-3200,can
2024-08-13,0,0,0.0,3,2200,733,-2200,can
2024-08-12,0,0,0.0,8,3600,450,-3600,can
2024-08-09,0,0,0.0,6,2600,433,-2600,can
2024-08-08,0,0,0.0,7,3600,514,-3600,can
2024-08-07,0,0,0.0,7,3500,500,-3500,can
2024-08-06,1,300,300.0,9,4800,533,-4500,can
2024-08-05,1,400,400.0,7,2900,414,-2500,can
2024-08-02,4,3800,950.0,10,6100,610,-2300,can
2024-08-01,2,900,450.0,6,4700,783,-3800,can
2024-07-31,4,2900,725.0,11,7900,718,-5000,can
2024-07-30,2,700,350.0,9,7200,800,-6500,can
2024-07-29,12,4200,350.0,10,7300,730,-3100,can
2024-07-26,2,1100,550.0,9,4000,444,-2900,can
2024-07-25,2,200,100.0,14,7900,564,-7700,can
2024-07-24,0,0,0.0,11,8800,800,-8800,can
2024-07-23,2,900,450.0,12,7400,617,-6500,can
2024-07-22,6,2300,383.33,2,1100,550,1200,can
2024-07-19,6,3000,500.0,0,0,0,3000,can
2024-07-18,4,2000,500.0,7,5400,771,-3400,can
2024-07-17,4,1100,275.0,5,5700,1140,-4600,can
2024-07-16,3,1000,333.33,5,5600,1120,-4600,can
2024-07-15,5,2000,400.0,8,5700,712,-3700,can
2024-07-12,5,2000,400.0,7,3100,443,-1100,can
2024-07-11,3,1000,333.33,7,3100,443,-2100,can
2024-07-10,3,1000,333.33,8,6700,838,-5700,can
2024-07-09,3,1000,333.33,6,5500,917,-4500,can
2024-07-08,3,1000,333.33,6,5500,917,-4500,can
2024-07-05,3,1000,333.33,7,6500,929,-5500,can
2024-07-04,4,1100,275.0,6,2900,483,-1800,can
2024-07-03,3,1000,333.33,6,2900,483,-1900,can
2024-07-02,3,1000,333.33,8,2900,362,-1900,can
2024-07-01,1,600,600.0,11,6700,609,-6100,can
2024-06-28,1,600,600.0,6,6600,1100,-6000,can
2024-06-27,2,800,400.0,11,7100,645,-6300,can
2024-06-26,1,600,600.0,9,6800,756,-6200,can
2024-06-25,1,600,600.0,10,7500,750,-6900,can
2024-06-24,1,600,600.0,8,5900,738,-5300,can
2024-06-21,1,600,600.0,5,3500,700,-2900,can
2024-06-20,1,600,600.0,8,6400,800,-5800,can
2024-06-19,1,600,600.0,7,6200,886,-5600,can
2024-06-18,1,600,600.0,9,6300,700,-5700,can
2024-06-17,2,1100,550.0,10,7100,710,-6000,can
2024-06-14,1,700,700.0,10,6300,630,-5600,can
2024-06-13,1,600,600.0,8,6000,750,-5400,can
2024-06-12,1,600,600.0,9,6100,678,-5500,can
2024-06-11,2,700,350.0,11,7100,645,-6400,can
2024-06-10,1,600,600.0,7,2700,386,-2100,can
2024-06-07,2,700,350.0,6,2500,417,-1800,can
2024-06-06,12,5200,433.33,8,5100,638,100,can
2024-06-05,8,1700,212.5,9,4700,522,-3000,can
2024-06-04,9,1600,177.78,4,3900,975,-2300,can
2024-06-03,7,1700,242.86,9,5400,600,-3700,can
2024-05-31,13,2900,223.08,1,100,100,2800,can
2024-05-30,19,4200,221.05,6,1200,200,3000,can
2024-05-29,11,2500,227.27,0,0,0,2500,can
2024-05-28,7,2000,285.71,1,100,100,1900,can
2024-05-27,10,2700,270.0,3,700,233,2000,can
2024-05-24,8,1500,187.5,6,2400,400,-900,can
2024-05-23,6,1400,233.33,6,2000,333,-600,can
2024-05-22,14,2600,185.71,6,2000,333,600,can
2024-05-21,26,6800,261.54,12,3900,325,2900,can
2024-05-20,6,1000,166.67,3,1700,567,-700,can
2024-05-17,31,10700,345.16,4,25700,6425,-15000,can
2024-05-16,2,200,100.0,7,2300,329,-2100,can
2024-05-15,2,900,450.0,4,25700,6425,-24800,can
2024-05-14,3,1100,366.67,5,2400,480,-1300,can
2024-05-13,5,900,180.0,8,1600,200,-700,can
2024-05-10,2,100,50.0,4,1200,300,-1100,can
2024-05-09,5,500,100.0,11,3900,355,-3400,can
2024-05-08,1,100,100.0,4,3200,800,-3100,can
2024-05-07,3,400,133.33,8,3300,412,-2900,can
2024-05-06,2,600,300.0,8,3300,412,-2700,can
2024-05-03,0,0,0.0,5,3200,640,-3200,can
2024-05-02,0,0,0.0,5,3100,620,-3100,can
2024-04-26,0,0,0.0,6,3200,533,-3200,can
2024-04-25,1,100,100.0,14,1600,114,-1500,can
2024-04-24,1,100,100.0,8,2600,325,-2500,can
2024-04-23,0,0,0.0,4,1100,275,-1100,can
2024-04-22,8,3000,375.0,9,2800,311,200,can
2024-04-19,3,1100,366.67,1,500,500,600,can
2024-04-17,10,3500,350.0,1,200,200,3300,can
2024-04-16,11,10100,918.18,2,7100,3550,3000,can
2024-04-15,7,2500,357.14,0,0,0,2500,can
2024-04-12,7,1500,214.29,2,300,150,1200,can
2024-04-11,3,1100,366.67,2,300,150,800,can
2024-04-10,4,1800,450.0,2,300,150,1500,can
2024-04-09,2,1300,650.0,2,300,150,1000,can
2024-04-08,2,1000,500.0,2,300,150,700,can
2024-04-05,6,1900,316.67,1,200,200,1700,can
2024-04-04,7,1800,257.14,1,200,200,1600,can
2024-04-03,5,1100,220.0,7,900,129,200,can
2024-04-02,2,600,300.0,2,700,350,-100,can
2024-04-01,1,100,100.0,2,700,350,-600,can
2024-03-29,1,100,100.0,1,200,200,-100,can
2024-03-28,2,300,150.0,1,200,200,100,can
2024-03-27,1,100,100.0,0,0,0,100,can
2024-03-26,1,100,100.0,0,0,0,100,can
2024-03-25,3,300,100.0,0,0,0,300,can
2024-03-22,2,600,300.0,1,500,500,100,can
2024-03-21,2,600,300.0,1,500,500,100,can
2024-03-20,2,600,300.0,1,500,500,100,can
2024-03-19,3,700,233.33,1,500,500,200,can
2024-03-18,2,600,300.0,1,500,500,100,can
2024-03-15,4,800,200.0,2,600,300,200,can
2024-03-14,2,600,300.0,1,500,500,100,can
2024-03-13,3,700,233.33,2,600,300,100,can
2024-03-12,3,700,233.33,2,600,300,100,can
2024-03-11,5,1000,200.0,2,500,250,500,can
2024-03-08,5,900,180.0,2,400,200,500,can
2024-03-07,7,1200,171.43,5,1400,280,-200,can
2024-03-06,14,2000,142.86,3,1100,367,900,can
2024-03-05,7,1500,214.29,2,900,450,600,can
2024-03-04,11,1100,100.0,4,1100,275,0,can
2024-03-01,3,500,166.67,1,500,500,0,can
2024-02-29,1,100,100.0,5,3400,680,-3300,can
2024-02-28,2,200,100.0,4,3600,900,-3400,can
2024-02-27,1,100,100.0,4,3400,850,-3300,can
2024-02-26,1,1400,1400.0,4,1400,350,0,can
2024-02-23,1,200,200.0,6,1200,200,-1000,can
2024-02-22,4,400,100.0,5,500,100,-100,can
2024-02-21,3,300,100.0,2,200,100,100,can
2024-02-20,14,1800,128.57,6,1500,250,300,can
2024-02-19,3,800,266.67,0,0,0,800,can
2024-02-16,6,2900,483.33,1,2900,2900,0,can
2024-02-15,1,100,100.0,1,100,100,0,can
2024-02-07,1,100,100.0,1,2900,2900,-2800,can
2024-02-06,0,0,0.0,1,2900,2900,-2900,can
2024-02-05,2,100,50.0,2,3100,1550,-3000,can
2024-02-02,2,200,100.0,1,100,100,100,can
2024-02-01,0,0,0.0,1,1800,1800,-1800,can
2024-01-31,1,100,100.0,2,2100,1050,-2000,can
2024-01-30,0,0,0.0,3,2100,700,-2100,can
2024-01-29,0,0,0.0,2,2200,1100,-2200,can
2024-01-26,0,0,0.0,3,2600,867,-2600,can
2024-01-25,0,0,0.0,1,1900,1900,-1900,can
2024-01-24,0,0,0.0,3,5000,1667,-5000,can
2024-01-23,0,0,0.0,1,1900,1900,-1900,can
2024-01-22,0,0,0.0,4,2300,575,-2300,can
2024-01-19,0,0,0.0,6,3100,517,-3100,can
2024-01-18,0,0,0.0,3,2500,833,-2500,can
2024-01-17,0,0,0.0,4,2000,500,-2000,can
2024-01-16,0,0,0.0,1,1900,1900,-1900,can
2024-01-15,0,0,0.0,4,3100,775,-3100,can
2024-01-12,0,0,0.0,2,2000,1000,-2000,can
2024-01-11,0,0,0.0,5,3700,740,-3700,can
2024-01-10,0,0,0.0,4,3000,750,-3000,can
2024-01-09,0,0,0.0,3,2000,667,-2000,can
2024-01-08,0,0,0.0,2,2100,1050,-2100,can
2024-01-05,0,0,0.0,2,2000,1000,-2000,can
2024-01-04,0,0,0.0,1,1900,1900,-1900,can
2024-01-03,0,0,0.0,1,1900,1900,-1900,can
2024-01-02,0,0,0.0,2,2900,1450,-2900,can
2024-09-12,85,32400,381.18,65,41100,632,-8700,cap
2024-09-11,71,22000,309.86,44,24400,555,-2400,cap
2024-09-10,77,53400,693.51,67,56300,840,-2900,cap
2024-09-09,86,26300,305.81,59,36900,625,-10600,cap
2024-09-06,71,22000,309.86,71,39700,559,-17700,cap
2024-09-05,46,17500,380.43,60,29500,492,-12000,cap
2024-09-04,117,31600,270.09,83,51100,616,-19500,cap
2024-08-30,56,16700,298.21,97,53800,555,-37100,cap
2024-08-29,57,15000,263.16,99,46400,469,-31400,cap
2024-08-28,79,43500,550.63,98,56400,576,-12900,cap
2024-08-27,71,26000,366.2,72,32700,454,-6700,cap
2024-08-26,85,34600,407.06,96,51300,534,-16700,cap
2024-08-23,61,21100,345.9,99,45700,462,-24600,cap
2024-08-22,64,53000,828.12,128,67100,524,-14100,cap
2024-08-21,74,29100,393.24,92,55400,602,-26300,cap
2024-08-20,100,65700,657.0,150,87100,581,-21400,cap
2024-08-19,65,18800,289.23,98,54700,558,-35900,cap
2024-08-16,111,50600,455.86,124,66200,534,-15600,cap
2024-08-15,55,16100,292.73,61,34000,557,-17900,cap
2024-08-14,38,11000,289.47,55,39200,713,-28200,cap
2024-08-13,55,19800,360.0,76,42600,561,-22800,cap
2024-08-12,71,30200,425.35,79,64600,818,-34400,cap
2024-08-09,117,36000,307.69,83,57700,695,-21700,cap
2024-08-08,94,36300,386.17,90,32200,358,4100,cap
2024-08-07,116,40500,349.14,63,32700,519,7800,cap
2024-08-06,181,61800,341.44,111,57600,519,4200,cap
2024-08-05,126,37200,295.24,111,60200,542,-23000,cap
2024-08-02,157,42100,268.15,64,42200,659,-100,cap
2024-08-01,118,43200,366.1,87,75500,868,-32300,cap
2024-07-31,136,61900,455.15,92,61800,672,100,cap
2024-07-30,83,27700,333.73,86,54000,628,-26300,cap
2024-07-29,126,66200,525.4,97,61700,636,4500,cap
2024-07-26,283,96600,341.34,154,90500,588,6100,cap
2024-07-25,163,60900,373.62,87,58400,671,2500,cap
2024-07-24,148,78200,528.38,93,52100,560,26100,cap
2024-07-23,173,75900,438.73,102,82700,811,-6800,cap
2024-07-22,265,105400,397.74,148,110100,744,-4700,cap
2024-07-19,109,31800,291.74,55,46900,853,-15100,cap
2024-07-18,142,41300,290.85,73,51800,710,-10500,cap
2024-07-17,133,51200,384.96,112,86200,770,-35000,cap
2024-07-16,121,46700,385.95,87,74700,859,-28000,cap
2024-07-15,113,38000,336.28,74,60700,820,-22700,cap
2024-07-12,131,55500,423.66,105,76200,726,-20700,cap
2024-07-11,150,70200,468.0,116,84000,724,-13800,cap
2024-07-10,222,93600,421.62,137,95400,696,-1800,cap
2024-07-09,213,117000,549.3,121,97100,802,19900,cap
2024-07-08,158,60100,380.38,85,66100,778,-6000,cap
2024-07-05,165,54300,329.09,85,71300,839,-17000,cap
2024-07-04,169,78300,463.31,80,79500,994,-1200,cap
2024-07-03,108,48900,452.78,73,73200,1003,-24300,cap
2024-07-02,175,72700,415.43,84,67500,804,5200,cap
2024-07-01,196,86100,439.29,79,77700,984,8400,cap
2024-06-28,153,79400,518.95,97,99100,1022,-19700,cap
2024-06-27,264,145400,550.76,127,131400,1035,14000,cap
2024-06-26,194,73500,378.87,100,83300,833,-9800,cap
2024-06-25,297,106300,357.91,144,103800,721,2500,cap
2024-06-24,310,104700,337.74,184,179000,973,-74300,cap
2024-06-21,189,67500,357.14,81,67300,831,200,cap
2024-06-20,202,76400,378.22,107,99100,926,-22700,cap
2024-06-19,128,57300,447.66,131,70900,541,-13600,cap
2024-06-18,149,57900,388.59,86,54300,631,3600,cap
2024-06-17,183,60400,330.05,110,72900,663,-12500,cap
2024-06-14,158,58000,367.09,114,68100,597,-10100,cap
2024-06-13,196,61500,313.78,131,77700,593,-16200,cap
2024-06-12,404,114100,282.43,151,117500,778,-3400,cap
2024-06-11,244,71600,293.44,101,114400,1133,-42800,cap
2024-06-10,159,49400,310.69,93,119700,1287,-70300,cap
2024-06-07,94,69600,740.43,81,69400,857,200,cap
2024-06-06,111,37400,336.94,112,72000,643,-34600,cap
2024-06-05,148,112000,756.76,115,117000,1017,-5000,cap
2024-06-04,122,47600,390.16,133,133900,1007,-86300,cap
2024-06-03,156,66900,428.85,121,61200,506,5700,cap
2024-05-31,199,78100,392.46,104,95400,917,-17300,cap
2024-05-30,317,99000,312.3,151,99100,656,-100,cap
2024-05-29,253,93900,371.15,130,86000,662,7900,cap
2024-05-28,311,141700,455.63,168,120400,717,21300,cap
2024-05-27,224,93700,418.3,192,131300,684,-37600,cap
2024-05-24,250,79400,317.6,135,89800,665,-10400,cap
2024-05-23,282,104600,370.92,161,107800,670,-3200,cap
2024-05-22,562,248500,442.17,263,246400,937,2100,cap
2024-05-21,112,88400,789.29,138,95800,694,-7400,cap
2024-05-20,109,53200,488.07,123,57400,467,-4200,cap
2024-05-17,135,53000,392.59,86,54500,634,-1500,cap
2024-05-16,140,57300,409.29,87,48600,559,8700,cap
2024-05-15,255,105600,414.12,91,81700,898,23900,cap
2024-05-14,90,49100,545.56,81,50500,623,-1400,cap
2024-05-13,95,48900,514.74,72,41700,579,7200,cap
2024-05-10,110,45200,410.91,88,47700,542,-2500,cap
2024-05-09,127,74500,586.61,110,83900,763,-9400,cap
2024-05-08,159,56700,356.6,72,44300,615,12400,cap
2024-05-07,183,84900,463.93,68,83600,1229,1300,cap
2024-05-06,150,81700,544.67,73,61500,842,20200,cap
2024-05-03,112,42200,376.79,66,45400,688,-3200,cap
2024-05-02,133,48200,362.41,80,48600,608,-400,cap
2024-04-26,119,50800,426.89,70,36600,523,14200,cap
2024-04-25,149,68300,458.39,98,80300,819,-12000,cap
2024-04-24,128,40800,318.75,86,43100,501,-2300,cap
2024-04-23,107,40200,375.7,83,62000,747,-21800,cap
2024-04-22,225,89100,396.0,139,83400,600,5700,cap
2024-04-19,213,111400,523.0,106,104500,986,6900,cap
2024-04-17,125,70300,562.4,117,81000,692,-10700,cap
2024-04-16,182,76300,419.23,129,54500,422,21800,cap
2024-04-15,135,72300,535.56,171,70800,414,1500,cap
2024-04-12,106,38500,363.21,90,46900,521,-8400,cap
2024-04-11,145,51400,354.48,116,54700,472,-3300,cap
2024-04-10,174,98900,568.39,263,135300,514,-36400,cap
2024-04-09,282,165600,587.23,266,142700,536,22900,cap
2024-04-08,170,72000,423.53,103,57700,560,14300,cap
2024-04-05,150,58400,389.33,59,43600,739,14800,cap
2024-04-04,316,121200,383.54,136,80600,593,40600,cap
2024-04-03,208,81900,393.75,108,69800,646,12100,cap
2024-04-02,310,91100,293.87,113,65100,576,26000,cap
2024-04-01,208,52800,253.85,89,52500,590,300,cap
2024-03-29,144,59400,412.5,81,44900,554,14500,cap
2024-03-28,232,125600,541.38,119,106700,897,18900,cap
2024-03-27,164,78100,476.22,106,67600,638,10500,cap
2024-03-26,111,66400,598.2,90,44500,494,21900,cap
2024-03-25,161,63300,393.17,151,77100,511,-13800,cap
2024-03-22,236,102500,434.32,154,96800,629,5700,cap
2024-03-21,307,116700,380.13,179,120400,673,-3700,cap
2024-03-20,529,167200,316.07,242,165000,682,2200,cap
2024-03-19,241,87900,364.73,171,106200,621,-18300,cap
2024-03-18,745,306300,411.14,483,303400,628,2900,cap
2024-03-15,336,146000,434.52,211,152400,722,-6400,cap
2024-03-14,271,143300,528.78,234,154900,662,-11600,cap
2024-03-13,331,133300,402.72,237,127000,536,6300,cap
2024-03-12,343,124100,361.81,331,181100,547,-57000,cap
2024-03-11,283,120600,426.15,353,139400,395,-18800,cap
2024-03-08,331,133700,403.93,305,141000,462,-7300,cap
2024-03-07,102,42800,419.61,126,55200,438,-12400,cap
2024-03-06,220,83900,381.36,179,109800,613,-25900,cap
2024-03-05,111,34400,309.91,124,51200,413,-16800,cap
2024-03-04,194,65500,337.63,237,76700,324,-11200,cap
2024-03-01,66,26300,398.48,92,46000,500,-19700,cap
2024-02-29,140,32900,235.0,142,53000,373,-20100,cap
2024-02-28,106,35700,336.79,105,54800,522,-19100,cap
2024-02-27,69,15900,230.43,69,29500,428,-13600,cap
2024-02-26,73,21200,290.41,62,24500,395,-3300,cap
2024-02-23,90,34100,378.89,78,48500,622,-14400,cap
2024-02-22,67,19600,292.54,63,51200,813,-31600,cap
2024-02-21,88,28900,328.41,62,37600,606,-8700,cap
2024-02-20,143,46300,323.78,98,72900,744,-26600,cap
2024-02-19,141,89500,634.75,172,79800,464,9700,cap
2024-02-16,116,46800,403.45,82,47600,580,-800,cap
2024-02-15,151,68900,456.29,99,66200,669,2700,cap
2024-02-07,74,26500,358.11,32,26800,838,-300,cap
2024-02-06,59,23300,394.92,36,22400,622,900,cap
2024-02-05,102,31400,307.84,53,30900,583,500,cap
2024-02-02,76,15600,205.26,51,25100,492,-9500,cap
2024-02-01,68,21900,322.06,50,22500,450,-600,cap
2024-01-31,93,35600,382.8,70,42300,604,-6700,cap
2024-01-30,99,29700,300.0,58,41200,710,-11500,cap
2024-01-29,117,38200,326.5,61,29900,490,8300,cap
2024-01-26,102,31900,312.75,57,38800,681,-6900,cap
2024-01-25,63,16500,261.9,54,23500,435,-7000,cap
2024-01-24,60,23000,383.33,42,18000,429,5000,cap
2024-01-23,79,30000,379.75,44,24500,557,5500,cap
2024-01-22,111,43900,395.5,78,47500,609,-3600,cap
2024-01-19,66,38000,575.76,48,30100,627,7900,cap
2024-01-18,62,31300,504.84,83,47800,576,-16500,cap
2024-01-17,56,24300,433.93,42,23100,550,1200,cap
2024-01-16,70,30300,432.86,51,28800,565,1500,cap
2024-01-15,63,24700,392.06,43,25500,593,-800,cap
2024-01-12,106,29900,282.08,69,22900,332,7000,cap
2024-01-11,89,36600,411.24,74,48700,658,-12100,cap
2024-01-10,60,31600,526.67,60,39500,658,-7900,cap
2024-01-09,72,26700,370.83,59,32500,551,-5800,cap
2024-01-08,64,30100,470.31,89,49800,560,-19700,cap
2024-01-05,84,42100,501.19,59,54200,919,-12100,cap
2024-01-04,117,70100,599.15,72,69800,969,300,cap
2024-01-03,103,47000,456.31,83,71700,864,-24700,cap
2024-01-02,91,37000,406.59,97,59300,611,-22300,cap
